date,geoRegion,certified_icu_beds_target,icu_beds_operational,adhoc_icu_beds_operational,certified_icu_beds_operational,version,type_variant
2020-03-30,AG,54,67,13,54,2022-05-03_11-02-08,fp7d
2020-03-30,AI,0,0,0,0,2022-05-03_11-02-08,fp7d
2020-03-30,AR,6,10,4,6,2022-05-03_11-02-08,fp7d
2020-03-30,BE,98,120,24,96,2022-05-03_11-02-08,fp7d
2020-03-30,BL,20,28,10,18,2022-05-03_11-02-08,fp7d
2020-03-30,BS,54,51,0,51,2022-05-03_11-02-08,fp7d
2020-03-30,FR,24,30,6,24,2022-05-03_11-02-08,fp7d
2020-03-30,GE,32,110,78,32,2022-05-03_11-02-08,fp7d
2020-03-30,GL,6,14,8,6,2022-05-03_11-02-08,fp7d
2020-03-30,GR,17,28,11,17,2022-05-03_11-02-08,fp7d
2020-03-30,JU,6,11,5,6,2022-05-03_11-02-08,fp7d
2020-03-30,LU,42,25,0,25,2022-05-03_11-02-08,fp7d
2020-03-30,NE,10,20,10,10,2022-05-03_11-02-08,fp7d
2020-03-30,NW,6,6,0,6,2022-05-03_11-02-08,fp7d
2020-03-30,OW,0,0,0,0,2022-05-03_11-02-08,fp7d
2020-03-30,SG,54,74,20,54,2022-05-03_11-02-08,fp7d
2020-03-30,SH,8,12,4,8,2022-05-03_11-02-08,fp7d
2020-03-30,SO,17,18,1,17,2022-05-03_11-02-08,fp7d
2020-03-30,SZ,12,9,0,9,2022-05-03_11-02-08,fp7d
2020-03-30,TG,21,42,21,21,2022-05-03_11-02-08,fp7d
2020-03-30,TI,120,106,28,78,2022-05-03_11-02-08,fp7d
2020-03-30,UR,6,6,0,6,2022-05-03_11-02-08,fp7d
2020-03-30,VD,78,156,78,78,2022-05-03_11-02-08,fp7d
2020-03-30,VS,21,42,21,21,2022-05-03_11-02-08,fp7d
2020-03-30,ZG,8,12,4,8,2022-05-03_11-02-08,fp7d
2020-03-30,ZH,96,132,39,93,2022-05-03_11-02-08,fp7d
2020-03-31,AG,54,67,13,54,2022-05-03_11-02-08,fp7d
2020-03-31,AI,0,0,0,0,2022-05-03_11-02-08,fp7d
2020-03-31,AR,6,10,4,6,2022-05-03_11-02-08,fp7d
2020-03-31,BE,98,124,33,91,2022-05-03_11-02-08,fp7d
2020-03-31,BL,20,28,10,18,2022-05-03_11-02-08,fp7d
2020-03-31,BS,54,54,0,54,2022-05-03_11-02-08,fp7d
2020-03-31,FR,24,38,14,24,2022-05-03_11-02-08,fp7d
2020-03-31,GE,32,107,75,32,2022-05-03_11-02-08,fp7d
2020-03-31,GL,6,14,8,6,2022-05-03_11-02-08,fp7d
2020-03-31,GR,17,28,11,17,2022-05-03_11-02-08,fp7d
2020-03-31,JU,6,11,5,6,2022-05-03_11-02-08,fp7d
2020-03-31,LU,48,39,8,31,2022-05-03_11-02-08,fp7d
2020-03-31,NE,10,21,11,10,2022-05-03_11-02-08,fp7d
2020-03-31,NW,6,6,0,6,2022-05-03_11-02-08,fp7d
2020-03-31,OW,0,0,0,0,2022-05-03_11-02-08,fp7d
2020-03-31,SG,54,74,20,54,2022-05-03_11-02-08,fp7d
2020-03-31,SH,8,12,4,8,2022-05-03_11-02-08,fp7d
2020-03-31,SO,17,20,3,17,2022-05-03_11-02-08,fp7d
2020-03-31,SZ,12,9,0,9,2022-05-03_11-02-08,fp7d
2020-03-31,TG,21,42,21,21,2022-05-03_11-02-08,fp7d
2020-03-31,TI,120,108,30,78,2022-05-03_11-02-08,fp7d
2020-03-31,UR,6,6,0,6,2022-05-03_11-02-08,fp7d
2020-03-31,VD,89,169,80,89,2022-05-03_11-02-08,fp7d
2020-03-31,VS,21,42,21,21,2022-05-03_11-02-08,fp7d
2020-03-31,ZG,8,12,4,8,2022-05-03_11-02-08,fp7d
2020-03-31,ZH,97,135,41,94,2022-05-03_11-02-08,fp7d
2020-04-01,AG,52,65,13,52,2022-05-03_11-02-08,fp7d
2020-04-01,AI,0,0,0,0,2022-05-03_11-02-08,fp7d
2020-04-01,AR,6,10,4,6,2022-05-03_11-02-08,fp7d
2020-04-01,BE,98,126,35,91,2022-05-03_11-02-08,fp7d
2020-04-01,BL,20,28,10,18,2022-05-03_11-02-08,fp7d
2020-04-01,BS,54,54,0,54,2022-05-03_11-02-08,fp7d
2020-04-01,FR,24,38,14,24,2022-05-03_11-02-08,fp7d
2020-04-01,GE,40,121,81,40,2022-05-03_11-02-08,fp7d
2020-04-01,GL,6,14,8,6,2022-05-03_11-02-08,fp7d
2020-04-01,GR,17,28,11,17,2022-05-03_11-02-08,fp7d
2020-04-01,JU,6,11,5,6,2022-05-03_11-02-08,fp7d
2020-04-01,LU,54,71,20,51,2022-05-03_11-02-08,fp7d
2020-04-01,NE,10,21,11,10,2022-05-03_11-02-08,fp7d
2020-04-01,NW,6,10,4,6,2022-05-03_11-02-08,fp7d
2020-04-01,OW,0,0,0,0,2022-05-03_11-02-08,fp7d
2020-04-01,SG,54,74,20,54,2022-05-03_11-02-08,fp7d
2020-04-01,SH,8,12,4,8,2022-05-03_11-02-08,fp7d
2020-04-01,SO,17,20,3,17,2022-05-03_11-02-08,fp7d
2020-04-01,SZ,12,12,1,11,2022-05-03_11-02-08,fp7d
2020-04-01,TG,21,42,21,21,2022-05-03_11-02-08,fp7d
2020-04-01,TI,126,110,32,78,2022-05-03_11-02-08,fp7d
2020-04-01,UR,6,6,0,6,2022-05-03_11-02-08,fp7d
2020-04-01,VD,89,169,80,89,2022-05-03_11-02-08,fp7d
2020-04-01,VS,21,42,21,21,2022-05-03_11-02-08,fp7d
2020-04-01,ZG,8,12,4,8,2022-05-03_11-02-08,fp7d
2020-04-01,ZH,111,161,53,108,2022-05-03_11-02-08,fp7d
2020-04-02,AG,54,67,13,54,2022-05-03_11-02-08,fp7d
2020-04-02,AI,0,0,0,0,2022-05-03_11-02-08,fp7d
2020-04-02,AR,6,10,4,6,2022-05-03_11-02-08,fp7d
2020-04-02,BE,159,137,34,103,2022-05-03_11-02-08,fp7d
2020-04-02,BL,20,28,10,18,2022-05-03_11-02-08,fp7d
2020-04-02,BS,54,58,4,54,2022-05-03_11-02-08,fp7d
2020-04-02,FR,24,38,14,24,2022-05-03_11-02-08,fp7d
2020-04-02,GE,40,124,84,40,2022-05-03_11-02-08,fp7d
2020-04-02,GL,6,14,8,6,2022-05-03_11-02-08,fp7d
2020-04-02,GR,20,29,9,20,2022-05-03_11-02-08,fp7d
2020-04-02,JU,6,11,5,6,2022-05-03_11-02-08,fp7d
2020-04-02,LU,54,71,20,51,2022-05-03_11-02-08,fp7d
2020-04-02,NE,10,21,11,10,2022-05-03_11-02-08,fp7d
2020-04-02,NW,6,10,4,6,2022-05-03_11-02-08,fp7d
2020-04-02,OW,0,0,0,0,2022-05-03_11-02-08,fp7d
2020-04-02,SG,54,74,20,54,2022-05-03_11-02-08,fp7d
2020-04-02,SH,8,12,4,8,2022-05-03_11-02-08,fp7d
2020-04-02,SO,17,20,3,17,2022-05-03_11-02-08,fp7d
2020-04-02,SZ,12,12,1,11,2022-05-03_11-02-08,fp7d
2020-04-02,TG,21,42,21,21,2022-05-03_11-02-08,fp7d
2020-04-02,TI,120,110,32,78,2022-05-03_11-02-08,fp7d
2020-04-02,UR,6,6,0,6,2022-05-03_11-02-08,fp7d
2020-04-02,VD,89,169,80,89,2022-05-03_11-02-08,fp7d
2020-04-02,VS,21,42,21,21,2022-05-03_11-02-08,fp7d
2020-04-02,ZG,8,12,4,8,2022-05-03_11-02-08,fp7d
2020-04-02,ZH,118,183,68,115,2022-05-03_11-02-08,fp7d
2020-04-03,AG,54,67,13,54,2022-05-03_11-02-08,fp7d
2020-04-03,AI,0,0,0,0,2022-05-03_11-02-08,fp7d
2020-04-03,AR,6,10,4,6,2022-05-03_11-02-08,fp7d
2020-04-03,BE,163,136,30,106,2022-05-03_11-02-08,fp7d
2020-04-03,BL,20,28,10,18,2022-05-03_11-02-08,fp7d
2020-04-03,BS,54,58,4,54,2022-05-03_11-02-08,fp7d
2020-04-03,FR,24,38,14,24,2022-05-03_11-02-08,fp7d
2020-04-03,GE,40,124,84,40,2022-05-03_11-02-08,fp7d
2020-04-03,GL,6,14,8,6,2022-05-03_11-02-08,fp7d
2020-04-03,GR,20,17,0,17,2022-05-03_11-02-08,fp7d
2020-04-03,JU,6,11,5,6,2022-05-03_11-02-08,fp7d
2020-04-03,LU,54,71,20,51,2022-05-03_11-02-08,fp7d
2020-04-03,NE,10,31,21,10,2022-05-03_11-02-08,fp7d
2020-04-03,NW,6,10,4,6,2022-05-03_11-02-08,fp7d
2020-04-03,OW,0,0,0,0,2022-05-03_11-02-08,fp7d
2020-04-03,SG,54,78,24,54,2022-05-03_11-02-08,fp7d
2020-04-03,SH,8,12,4,8,2022-05-03_11-02-08,fp7d
2020-04-03,SO,17,20,3,17,2022-05-03_11-02-08,fp7d
2020-04-03,SZ,12,12,1,11,2022-05-03_11-02-08,fp7d
2020-04-03,TG,21,42,21,21,2022-05-03_11-02-08,fp7d
2020-04-03,TI,61,110,69,41,2022-05-03_11-02-08,fp7d
2020-04-03,UR,6,6,0,6,2022-05-03_11-02-08,fp7d
2020-04-03,VD,89,173,84,89,2022-05-03_11-02-08,fp7d
2020-04-03,VS,21,42,21,21,2022-05-03_11-02-08,fp7d
2020-04-03,ZG,8,12,4,8,2022-05-03_11-02-08,fp7d
2020-04-03,ZH,118,185,70,115,2022-05-03_11-02-08,fp7d
2020-04-04,AG,54,69,15,54,2022-05-03_11-02-08,fp7d
2020-04-04,AI,0,0,0,0,2022-05-03_11-02-08,fp7d
2020-04-04,AR,6,10,4,6,2022-05-03_11-02-08,fp7d
2020-04-04,BE,163,131,30,101,2022-05-03_11-02-08,fp7d
2020-04-04,BL,20,28,10,18,2022-05-03_11-02-08,fp7d
2020-04-04,BS,54,58,4,54,2022-05-03_11-02-08,fp7d
2020-04-04,FR,24,38,14,24,2022-05-03_11-02-08,fp7d
2020-04-04,GE,40,124,84,40,2022-05-03_11-02-08,fp7d
2020-04-04,GL,6,14,8,6,2022-05-03_11-02-08,fp7d
2020-04-04,GR,20,20,0,20,2022-05-03_11-02-08,fp7d
2020-04-04,JU,6,11,5,6,2022-05-03_11-02-08,fp7d
2020-04-04,LU,54,71,20,51,2022-05-03_11-02-08,fp7d
2020-04-04,NE,10,31,21,10,2022-05-03_11-02-08,fp7d
2020-04-04,NW,6,10,4,6,2022-05-03_11-02-08,fp7d
2020-04-04,OW,0,0,0,0,2022-05-03_11-02-08,fp7d
2020-04-04,SG,54,78,24,54,2022-05-03_11-02-08,fp7d
2020-04-04,SH,8,12,4,8,2022-05-03_11-02-08,fp7d
2020-04-04,SO,17,20,3,17,2022-05-03_11-02-08,fp7d
2020-04-04,SZ,12,12,1,11,2022-05-03_11-02-08,fp7d
2020-04-04,TG,21,42,21,21,2022-05-03_11-02-08,fp7d
2020-04-04,TI,61,110,69,41,2022-05-03_11-02-08,fp7d
2020-04-04,UR,6,6,0,6,2022-05-03_11-02-08,fp7d
2020-04-04,VD,89,173,84,89,2022-05-03_11-02-08,fp7d
2020-04-04,VS,21,42,21,21,2022-05-03_11-02-08,fp7d
2020-04-04,ZG,8,12,4,8,2022-05-03_11-02-08,fp7d
2020-04-04,ZH,118,185,70,115,2022-05-03_11-02-08,fp7d
2020-04-05,AG,54,69,15,54,2022-05-03_11-02-08,fp7d
2020-04-05,AI,0,0,0,0,2022-05-03_11-02-08,fp7d
2020-04-05,AR,6,10,4,6,2022-05-03_11-02-08,fp7d
2020-04-05,BE,163,131,30,101,2022-05-03_11-02-08,fp7d
2020-04-05,BL,20,28,10,18,2022-05-03_11-02-08,fp7d
2020-04-05,BS,54,58,4,54,2022-05-03_11-02-08,fp7d
2020-04-05,FR,24,38,14,24,2022-05-03_11-02-08,fp7d
2020-04-05,GE,40,124,84,40,2022-05-03_11-02-08,fp7d
2020-04-05,GL,6,14,8,6,2022-05-03_11-02-08,fp7d
2020-04-05,GR,20,20,0,20,2022-05-03_11-02-08,fp7d
2020-04-05,JU,6,11,5,6,2022-05-03_11-02-08,fp7d
2020-04-05,LU,54,71,20,51,2022-05-03_11-02-08,fp7d
2020-04-05,NE,10,31,21,10,2022-05-03_11-02-08,fp7d
2020-04-05,NW,6,10,4,6,2022-05-03_11-02-08,fp7d
2020-04-05,OW,0,0,0,0,2022-05-03_11-02-08,fp7d
2020-04-05,SG,54,78,24,54,2022-05-03_11-02-08,fp7d
2020-04-05,SH,8,12,4,8,2022-05-03_11-02-08,fp7d
2020-04-05,SO,17,18,1,17,2022-05-03_11-02-08,fp7d
2020-04-05,SZ,12,12,1,11,2022-05-03_11-02-08,fp7d
2020-04-05,TG,21,42,21,21,2022-05-03_11-02-08,fp7d
2020-04-05,TI,61,110,69,41,2022-05-03_11-02-08,fp7d
2020-04-05,UR,6,6,0,6,2022-05-03_11-02-08,fp7d
2020-04-05,VD,89,173,84,89,2022-05-03_11-02-08,fp7d
2020-04-05,VS,21,42,21,21,2022-05-03_11-02-08,fp7d
2020-04-05,ZG,8,12,4,8,2022-05-03_11-02-08,fp7d
2020-04-05,ZH,118,185,70,115,2022-05-03_11-02-08,fp7d
2020-04-06,AG,54,71,17,54,2022-05-03_11-02-08,fp7d
2020-04-06,AI,0,0,0,0,2022-05-03_11-02-08,fp7d
2020-04-06,AR,6,10,4,6,2022-05-03_11-02-08,fp7d
2020-04-06,BE,159,133,34,99,2022-05-03_11-02-08,fp7d
2020-04-06,BL,20,28,10,18,2022-05-03_11-02-08,fp7d
2020-04-06,BS,54,58,4,54,2022-05-03_11-02-08,fp7d
2020-04-06,FR,24,38,14,24,2022-05-03_11-02-08,fp7d
2020-04-06,GE,40,124,84,40,2022-05-03_11-02-08,fp7d
2020-04-06,GL,6,14,8,6,2022-05-03_11-02-08,fp7d
2020-04-06,GR,20,30,10,20,2022-05-03_11-02-08,fp7d
2020-04-06,JU,6,11,5,6,2022-05-03_11-02-08,fp7d
2020-04-06,LU,53,82,29,53,2022-05-03_11-02-08,fp7d
2020-04-06,NE,10,31,21,10,2022-05-03_11-02-08,fp7d
2020-04-06,NW,6,10,4,6,2022-05-03_11-02-08,fp7d
2020-04-06,OW,0,0,0,0,2022-05-03_11-02-08,fp7d
2020-04-06,SG,54,78,24,54,2022-05-03_11-02-08,fp7d
2020-04-06,SH,8,12,4,8,2022-05-03_11-02-08,fp7d
2020-04-06,SO,17,18,1,17,2022-05-03_11-02-08,fp7d
2020-04-06,SZ,12,12,1,11,2022-05-03_11-02-08,fp7d
2020-04-06,TG,21,58,37,21,2022-05-03_11-02-08,fp7d
2020-04-06,TI,61,110,69,41,2022-05-03_11-02-08,fp7d
2020-04-06,UR,6,6,0,6,2022-05-03_11-02-08,fp7d
2020-04-06,VD,89,185,96,89,2022-05-03_11-02-08,fp7d
2020-04-06,VS,21,42,21,21,2022-05-03_11-02-08,fp7d
2020-04-06,ZG,8,12,4,8,2022-05-03_11-02-08,fp7d
2020-04-06,ZH,182,312,130,182,2022-05-03_11-02-08,fp7d
2020-04-07,AG,54,71,17,54,2022-05-03_11-02-08,fp7d
2020-04-07,AI,0,0,0,0,2022-05-03_11-02-08,fp7d
2020-04-07,AR,6,10,4,6,2022-05-03_11-02-08,fp7d
2020-04-07,BE,159,138,34,104,2022-05-03_11-02-08,fp7d
2020-04-07,BL,20,28,10,18,2022-05-03_11-02-08,fp7d
2020-04-07,BS,54,58,4,54,2022-05-03_11-02-08,fp7d
2020-04-07,FR,24,38,14,24,2022-05-03_11-02-08,fp7d
2020-04-07,GE,40,124,84,40,2022-05-03_11-02-08,fp7d
2020-04-07,GL,6,14,8,6,2022-05-03_11-02-08,fp7d
2020-04-07,GR,20,30,10,20,2022-05-03_11-02-08,fp7d
2020-04-07,JU,6,11,5,6,2022-05-03_11-02-08,fp7d
2020-04-07,LU,53,82,29,53,2022-05-03_11-02-08,fp7d
2020-04-07,NE,10,31,21,10,2022-05-03_11-02-08,fp7d
2020-04-07,NW,6,10,4,6,2022-05-03_11-02-08,fp7d
2020-04-07,OW,0,0,0,0,2022-05-03_11-02-08,fp7d
2020-04-07,SG,54,78,24,54,2022-05-03_11-02-08,fp7d
2020-04-07,SH,8,12,4,8,2022-05-03_11-02-08,fp7d
2020-04-07,SO,17,20,3,17,2022-05-03_11-02-08,fp7d
2020-04-07,SZ,12,12,1,11,2022-05-03_11-02-08,fp7d
2020-04-07,TG,21,58,37,21,2022-05-03_11-02-08,fp7d
2020-04-07,TI,61,110,69,41,2022-05-03_11-02-08,fp7d
2020-04-07,UR,6,6,0,6,2022-05-03_11-02-08,fp7d
2020-04-07,VD,89,174,85,89,2022-05-03_11-02-08,fp7d
2020-04-07,VS,21,47,26,21,2022-05-03_11-02-08,fp7d
2020-04-07,ZG,8,12,4,8,2022-05-03_11-02-08,fp7d
2020-04-07,ZH,190,351,162,189,2022-05-03_11-02-08,fp7d
2020-04-08,AG,54,73,19,54,2022-05-03_11-02-08,fp7d
2020-04-08,AI,0,0,0,0,2022-05-03_11-02-08,fp7d
2020-04-08,AR,6,10,4,6,2022-05-03_11-02-08,fp7d
2020-04-08,BE,159,138,34,104,2022-05-03_11-02-08,fp7d
2020-04-08,BL,20,28,10,18,2022-05-03_11-02-08,fp7d
2020-04-08,BS,54,58,4,54,2022-05-03_11-02-08,fp7d
2020-04-08,FR,24,38,14,24,2022-05-03_11-02-08,fp7d
2020-04-08,GE,40,124,84,40,2022-05-03_11-02-08,fp7d
2020-04-08,GL,6,14,8,6,2022-05-03_11-02-08,fp7d
2020-04-08,GR,20,30,10,20,2022-05-03_11-02-08,fp7d
2020-04-08,JU,6,11,5,6,2022-05-03_11-02-08,fp7d
2020-04-08,LU,54,82,28,54,2022-05-03_11-02-08,fp7d
2020-04-08,NE,10,31,21,10,2022-05-03_11-02-08,fp7d
2020-04-08,NW,6,10,4,6,2022-05-03_11-02-08,fp7d
2020-04-08,OW,0,0,0,0,2022-05-03_11-02-08,fp7d
2020-04-08,SG,54,78,24,54,2022-05-03_11-02-08,fp7d
2020-04-08,SH,8,12,4,8,2022-05-03_11-02-08,fp7d
2020-04-08,SO,17,20,3,17,2022-05-03_11-02-08,fp7d
2020-04-08,SZ,12,12,1,11,2022-05-03_11-02-08,fp7d
2020-04-08,TG,21,62,41,21,2022-05-03_11-02-08,fp7d
2020-04-08,TI,61,110,69,41,2022-05-03_11-02-08,fp7d
2020-04-08,UR,6,6,0,6,2022-05-03_11-02-08,fp7d
2020-04-08,VD,89,174,85,89,2022-05-03_11-02-08,fp7d
2020-04-08,VS,21,47,26,21,2022-05-03_11-02-08,fp7d
2020-04-08,ZG,8,12,4,8,2022-05-03_11-02-08,fp7d
2020-04-08,ZH,152,355,204,151,2022-05-03_11-02-08,fp7d
2020-04-09,AG,54,73,19,54,2022-05-03_11-02-08,fp7d
2020-04-09,AI,0,0,0,0,2022-05-03_11-02-08,fp7d
2020-04-09,AR,6,10,4,6,2022-05-03_11-02-08,fp7d
2020-04-09,BE,104,138,34,104,2022-05-03_11-02-08,fp7d
2020-04-09,BL,20,28,10,18,2022-05-03_11-02-08,fp7d
2020-04-09,BS,54,58,4,54,2022-05-03_11-02-08,fp7d
2020-04-09,FR,24,38,14,24,2022-05-03_11-02-08,fp7d
2020-04-09,GE,40,124,84,40,2022-05-03_11-02-08,fp7d
2020-04-09,GL,6,14,8,6,2022-05-03_11-02-08,fp7d
2020-04-09,GR,17,30,13,17,2022-05-03_11-02-08,fp7d
2020-04-09,JU,6,11,5,6,2022-05-03_11-02-08,fp7d
2020-04-09,LU,54,82,28,54,2022-05-03_11-02-08,fp7d
2020-04-09,NE,10,31,21,10,2022-05-03_11-02-08,fp7d
2020-04-09,NW,6,10,4,6,2022-05-03_11-02-08,fp7d
2020-04-09,OW,0,0,0,0,2022-05-03_11-02-08,fp7d
2020-04-09,SG,54,78,24,54,2022-05-03_11-02-08,fp7d
2020-04-09,SH,8,12,4,8,2022-05-03_11-02-08,fp7d
2020-04-09,SO,17,20,3,17,2022-05-03_11-02-08,fp7d
2020-04-09,SZ,12,12,1,11,2022-05-03_11-02-08,fp7d
2020-04-09,TG,21,62,41,21,2022-05-03_11-02-08,fp7d
2020-04-09,TI,54,115,76,39,2022-05-03_11-02-08,fp7d
2020-04-09,UR,6,6,0,6,2022-05-03_11-02-08,fp7d
2020-04-09,VD,89,174,85,89,2022-05-03_11-02-08,fp7d
2020-04-09,VS,21,47,26,21,2022-05-03_11-02-08,fp7d
2020-04-09,ZG,8,12,4,8,2022-05-03_11-02-08,fp7d
2020-04-09,ZH,152,371,220,151,2022-05-03_11-02-08,fp7d
2020-04-10,AG,54,73,19,54,2022-05-03_11-02-08,fp7d
2020-04-10,AI,0,0,0,0,2022-05-03_11-02-08,fp7d
2020-04-10,AR,6,10,4,6,2022-05-03_11-02-08,fp7d
2020-04-10,BE,104,138,34,104,2022-05-03_11-02-08,fp7d
2020-04-10,BL,20,28,10,18,2022-05-03_11-02-08,fp7d
2020-04-10,BS,54,58,4,54,2022-05-03_11-02-08,fp7d
2020-04-10,FR,24,38,14,24,2022-05-03_11-02-08,fp7d
2020-04-10,GE,40,124,84,40,2022-05-03_11-02-08,fp7d
2020-04-10,GL,6,14,8,6,2022-05-03_11-02-08,fp7d
2020-04-10,GR,17,30,13,17,2022-05-03_11-02-08,fp7d
2020-04-10,JU,6,11,5,6,2022-05-03_11-02-08,fp7d
2020-04-10,LU,54,80,26,54,2022-05-03_11-02-08,fp7d
2020-04-10,NE,10,31,21,10,2022-05-03_11-02-08,fp7d
2020-04-10,NW,6,10,4,6,2022-05-03_11-02-08,fp7d
2020-04-10,OW,0,0,0,0,2022-05-03_11-02-08,fp7d
2020-04-10,SG,54,78,24,54,2022-05-03_11-02-08,fp7d
2020-04-10,SH,8,12,4,8,2022-05-03_11-02-08,fp7d
2020-04-10,SO,17,20,3,17,2022-05-03_11-02-08,fp7d
2020-04-10,SZ,12,12,1,11,2022-05-03_11-02-08,fp7d
2020-04-10,TG,21,62,41,21,2022-05-03_11-02-08,fp7d
2020-04-10,TI,54,107,68,39,2022-05-03_11-02-08,fp7d
2020-04-10,UR,6,6,0,6,2022-05-03_11-02-08,fp7d
2020-04-10,VD,89,174,85,89,2022-05-03_11-02-08,fp7d
2020-04-10,VS,21,47,26,21,2022-05-03_11-02-08,fp7d
2020-04-10,ZG,8,12,4,8,2022-05-03_11-02-08,fp7d
2020-04-10,ZH,152,380,229,151,2022-05-03_11-02-08,fp7d
2020-04-11,AG,54,73,19,54,2022-05-03_11-02-08,fp7d
2020-04-11,AI,0,0,0,0,2022-05-03_11-02-08,fp7d
2020-04-11,AR,6,10,4,6,2022-05-03_11-02-08,fp7d
2020-04-11,BE,104,138,34,104,2022-05-03_11-02-08,fp7d
2020-04-11,BL,20,28,10,18,2022-05-03_11-02-08,fp7d
2020-04-11,BS,54,58,4,54,2022-05-03_11-02-08,fp7d
2020-04-11,FR,24,38,14,24,2022-05-03_11-02-08,fp7d
2020-04-11,GE,40,124,84,40,2022-05-03_11-02-08,fp7d
2020-04-11,GL,6,14,8,6,2022-05-03_11-02-08,fp7d
2020-04-11,GR,17,30,13,17,2022-05-03_11-02-08,fp7d
2020-04-11,JU,6,13,7,6,2022-05-03_11-02-08,fp7d
2020-04-11,LU,54,83,29,54,2022-05-03_11-02-08,fp7d
2020-04-11,NE,10,31,21,10,2022-05-03_11-02-08,fp7d
2020-04-11,NW,6,10,4,6,2022-05-03_11-02-08,fp7d
2020-04-11,OW,0,0,0,0,2022-05-03_11-02-08,fp7d
2020-04-11,SG,54,78,24,54,2022-05-03_11-02-08,fp7d
2020-04-11,SH,8,12,4,8,2022-05-03_11-02-08,fp7d
2020-04-11,SO,17,20,3,17,2022-05-03_11-02-08,fp7d
2020-04-11,SZ,12,12,1,11,2022-05-03_11-02-08,fp7d
2020-04-11,TG,21,62,41,21,2022-05-03_11-02-08,fp7d
2020-04-11,TI,54,107,68,39,2022-05-03_11-02-08,fp7d
2020-04-11,UR,6,6,0,6,2022-05-03_11-02-08,fp7d
2020-04-11,VD,89,172,83,89,2022-05-03_11-02-08,fp7d
2020-04-11,VS,21,47,26,21,2022-05-03_11-02-08,fp7d
2020-04-11,ZG,8,12,4,8,2022-05-03_11-02-08,fp7d
2020-04-11,ZH,172,380,209,171,2022-05-03_11-02-08,fp7d
2020-04-12,AG,54,73,19,54,2022-05-03_11-02-08,fp7d
2020-04-12,AI,0,0,0,0,2022-05-03_11-02-08,fp7d
2020-04-12,AR,6,10,4,6,2022-05-03_11-02-08,fp7d
2020-04-12,BE,104,134,30,104,2022-05-03_11-02-08,fp7d
2020-04-12,BL,20,28,10,18,2022-05-03_11-02-08,fp7d
2020-04-12,BS,54,58,4,54,2022-05-03_11-02-08,fp7d
2020-04-12,FR,24,38,14,24,2022-05-03_11-02-08,fp7d
2020-04-12,GE,40,124,84,40,2022-05-03_11-02-08,fp7d
2020-04-12,GL,6,14,8,6,2022-05-03_11-02-08,fp7d
2020-04-12,GR,17,30,13,17,2022-05-03_11-02-08,fp7d
2020-04-12,JU,6,13,7,6,2022-05-03_11-02-08,fp7d
2020-04-12,LU,54,83,29,54,2022-05-03_11-02-08,fp7d
2020-04-12,NE,10,31,21,10,2022-05-03_11-02-08,fp7d
2020-04-12,NW,6,5,0,5,2022-05-03_11-02-08,fp7d
2020-04-12,OW,0,0,0,0,2022-05-03_11-02-08,fp7d
2020-04-12,SG,54,78,24,54,2022-05-03_11-02-08,fp7d
2020-04-12,SH,8,12,4,8,2022-05-03_11-02-08,fp7d
2020-04-12,SO,17,20,3,17,2022-05-03_11-02-08,fp7d
2020-04-12,SZ,12,12,1,11,2022-05-03_11-02-08,fp7d
2020-04-12,TG,21,62,41,21,2022-05-03_11-02-08,fp7d
2020-04-12,TI,54,107,68,39,2022-05-03_11-02-08,fp7d
2020-04-12,UR,6,6,0,6,2022-05-03_11-02-08,fp7d
2020-04-12,VD,89,174,85,89,2022-05-03_11-02-08,fp7d
2020-04-12,VS,21,47,26,21,2022-05-03_11-02-08,fp7d
2020-04-12,ZG,8,12,4,8,2022-05-03_11-02-08,fp7d
2020-04-12,ZH,172,380,209,171,2022-05-03_11-02-08,fp7d
2020-04-13,AG,54,73,19,54,2022-05-03_11-02-08,fp7d
2020-04-13,AI,0,0,0,0,2022-05-03_11-02-08,fp7d
2020-04-13,AR,6,10,4,6,2022-05-03_11-02-08,fp7d
2020-04-13,BE,104,134,30,104,2022-05-03_11-02-08,fp7d
2020-04-13,BL,20,28,10,18,2022-05-03_11-02-08,fp7d
2020-04-13,BS,54,58,4,54,2022-05-03_11-02-08,fp7d
2020-04-13,FR,24,38,14,24,2022-05-03_11-02-08,fp7d
2020-04-13,GE,40,124,84,40,2022-05-03_11-02-08,fp7d
2020-04-13,GL,6,14,8,6,2022-05-03_11-02-08,fp7d
2020-04-13,GR,17,30,13,17,2022-05-03_11-02-08,fp7d
2020-04-13,JU,6,13,7,6,2022-05-03_11-02-08,fp7d
2020-04-13,LU,54,83,29,54,2022-05-03_11-02-08,fp7d
2020-04-13,NE,10,31,21,10,2022-05-03_11-02-08,fp7d
2020-04-13,NW,6,6,0,6,2022-05-03_11-02-08,fp7d
2020-04-13,OW,0,0,0,0,2022-05-03_11-02-08,fp7d
2020-04-13,SG,54,78,24,54,2022-05-03_11-02-08,fp7d
2020-04-13,SH,8,12,4,8,2022-05-03_11-02-08,fp7d
2020-04-13,SO,17,20,3,17,2022-05-03_11-02-08,fp7d
2020-04-13,SZ,12,12,1,11,2022-05-03_11-02-08,fp7d
2020-04-13,TG,21,62,41,21,2022-05-03_11-02-08,fp7d
2020-04-13,TI,54,102,63,39,2022-05-03_11-02-08,fp7d
2020-04-13,UR,6,6,0,6,2022-05-03_11-02-08,fp7d
2020-04-13,VD,89,174,85,89,2022-05-03_11-02-08,fp7d
2020-04-13,VS,21,47,26,21,2022-05-03_11-02-08,fp7d
2020-04-13,ZG,8,12,4,8,2022-05-03_11-02-08,fp7d
2020-04-13,ZH,172,364,193,171,2022-05-03_11-02-08,fp7d
2020-04-14,AG,54,75,21,54,2022-05-03_11-02-08,fp7d
2020-04-14,AI,0,0,0,0,2022-05-03_11-02-08,fp7d
2020-04-14,AR,6,10,4,6,2022-05-03_11-02-08,fp7d
2020-04-14,BE,104,134,30,104,2022-05-03_11-02-08,fp7d
2020-04-14,BL,20,28,10,18,2022-05-03_11-02-08,fp7d
2020-04-14,BS,54,58,4,54,2022-05-03_11-02-08,fp7d
2020-04-14,FR,24,38,14,24,2022-05-03_11-02-08,fp7d
2020-04-14,GE,40,124,84,40,2022-05-03_11-02-08,fp7d
2020-04-14,GL,6,14,8,6,2022-05-03_11-02-08,fp7d
2020-04-14,GR,17,30,13,17,2022-05-03_11-02-08,fp7d
2020-04-14,JU,6,13,7,6,2022-05-03_11-02-08,fp7d
2020-04-14,LU,54,80,29,51,2022-05-03_11-02-08,fp7d
2020-04-14,NE,10,31,21,10,2022-05-03_11-02-08,fp7d
2020-04-14,NW,6,6,0,6,2022-05-03_11-02-08,fp7d
2020-04-14,OW,0,0,0,0,2022-05-03_11-02-08,fp7d
2020-04-14,SG,54,78,24,54,2022-05-03_11-02-08,fp7d
2020-04-14,SH,8,12,4,8,2022-05-03_11-02-08,fp7d
2020-04-14,SO,17,20,3,17,2022-05-03_11-02-08,fp7d
2020-04-14,SZ,12,12,1,11,2022-05-03_11-02-08,fp7d
2020-04-14,TG,21,62,41,21,2022-05-03_11-02-08,fp7d
2020-04-14,TI,54,93,54,39,2022-05-03_11-02-08,fp7d
2020-04-14,UR,6,6,0,6,2022-05-03_11-02-08,fp7d
2020-04-14,VD,89,174,85,89,2022-05-03_11-02-08,fp7d
2020-04-14,VS,21,47,26,21,2022-05-03_11-02-08,fp7d
2020-04-14,ZG,8,12,4,8,2022-05-03_11-02-08,fp7d
2020-04-14,ZH,172,385,214,171,2022-05-03_11-02-08,fp7d
2020-04-15,AG,54,74,20,54,2022-05-03_11-02-08,fp7d
2020-04-15,AI,0,0,0,0,2022-05-03_11-02-08,fp7d
2020-04-15,AR,6,10,4,6,2022-05-03_11-02-08,fp7d
2020-04-15,BE,104,134,30,104,2022-05-03_11-02-08,fp7d
2020-04-15,BL,20,28,10,18,2022-05-03_11-02-08,fp7d
2020-04-15,BS,54,58,4,54,2022-05-03_11-02-08,fp7d
2020-04-15,FR,24,30,6,24,2022-05-03_11-02-08,fp7d
2020-04-15,GE,40,124,84,40,2022-05-03_11-02-08,fp7d
2020-04-15,GL,6,14,8,6,2022-05-03_11-02-08,fp7d
2020-04-15,GR,17,30,13,17,2022-05-03_11-02-08,fp7d
2020-04-15,JU,6,13,7,6,2022-05-03_11-02-08,fp7d
2020-04-15,LU,54,76,25,51,2022-05-03_11-02-08,fp7d
2020-04-15,NE,10,31,21,10,2022-05-03_11-02-08,fp7d
2020-04-15,NW,6,6,0,6,2022-05-03_11-02-08,fp7d
2020-04-15,OW,0,0,0,0,2022-05-03_11-02-08,fp7d
2020-04-15,SG,54,78,24,54,2022-05-03_11-02-08,fp7d
2020-04-15,SH,8,12,4,8,2022-05-03_11-02-08,fp7d
2020-04-15,SO,17,20,3,17,2022-05-03_11-02-08,fp7d
2020-04-15,SZ,12,12,1,11,2022-05-03_11-02-08,fp7d
2020-04-15,TG,21,60,39,21,2022-05-03_11-02-08,fp7d
2020-04-15,TI,54,93,54,39,2022-05-03_11-02-08,fp7d
2020-04-15,UR,6,6,0,6,2022-05-03_11-02-08,fp7d
2020-04-15,VD,83,166,83,83,2022-05-03_11-02-08,fp7d
2020-04-15,VS,21,47,26,21,2022-05-03_11-02-08,fp7d
2020-04-15,ZG,8,12,4,8,2022-05-03_11-02-08,fp7d
2020-04-15,ZH,172,385,214,171,2022-05-03_11-02-08,fp7d
2020-04-16,AG,54,72,18,54,2022-05-03_11-02-08,fp7d
2020-04-16,AI,0,0,0,0,2022-05-03_11-02-08,fp7d
2020-04-16,AR,6,10,4,6,2022-05-03_11-02-08,fp7d
2020-04-16,BE,104,134,30,104,2022-05-03_11-02-08,fp7d
2020-04-16,BL,20,28,10,18,2022-05-03_11-02-08,fp7d
2020-04-16,BS,54,58,4,54,2022-05-03_11-02-08,fp7d
2020-04-16,FR,24,30,6,24,2022-05-03_11-02-08,fp7d
2020-04-16,GE,40,124,84,40,2022-05-03_11-02-08,fp7d
2020-04-16,GL,6,14,8,6,2022-05-03_11-02-08,fp7d
2020-04-16,GR,17,30,13,17,2022-05-03_11-02-08,fp7d
2020-04-16,JU,6,13,7,6,2022-05-03_11-02-08,fp7d
2020-04-16,LU,54,76,25,51,2022-05-03_11-02-08,fp7d
2020-04-16,NE,10,31,21,10,2022-05-03_11-02-08,fp7d
2020-04-16,NW,6,6,0,6,2022-05-03_11-02-08,fp7d
2020-04-16,OW,0,0,0,0,2022-05-03_11-02-08,fp7d
2020-04-16,SG,54,78,24,54,2022-05-03_11-02-08,fp7d
2020-04-16,SH,8,12,4,8,2022-05-03_11-02-08,fp7d
2020-04-16,SO,17,20,3,17,2022-05-03_11-02-08,fp7d
2020-04-16,SZ,12,12,1,11,2022-05-03_11-02-08,fp7d
2020-04-16,TG,21,58,37,21,2022-05-03_11-02-08,fp7d
2020-04-16,TI,54,93,54,39,2022-05-03_11-02-08,fp7d
2020-04-16,UR,6,6,0,6,2022-05-03_11-02-08,fp7d
2020-04-16,VD,83,156,73,83,2022-05-03_11-02-08,fp7d
2020-04-16,VS,21,47,26,21,2022-05-03_11-02-08,fp7d
2020-04-16,ZG,8,12,4,8,2022-05-03_11-02-08,fp7d
2020-04-16,ZH,172,385,214,171,2022-05-03_11-02-08,fp7d
2020-04-17,AG,54,72,18,54,2022-05-03_11-02-08,fp7d
2020-04-17,AI,0,0,0,0,2022-05-03_11-02-08,fp7d
2020-04-17,AR,6,10,4,6,2022-05-03_11-02-08,fp7d
2020-04-17,BE,104,126,22,104,2022-05-03_11-02-08,fp7d
2020-04-17,BL,20,28,10,18,2022-05-03_11-02-08,fp7d
2020-04-17,BS,54,58,4,54,2022-05-03_11-02-08,fp7d
2020-04-17,FR,24,30,6,24,2022-05-03_11-02-08,fp7d
2020-04-17,GE,40,124,84,40,2022-05-03_11-02-08,fp7d
2020-04-17,GL,6,14,8,6,2022-05-03_11-02-08,fp7d
2020-04-17,GR,17,30,13,17,2022-05-03_11-02-08,fp7d
2020-04-17,JU,6,13,7,6,2022-05-03_11-02-08,fp7d
2020-04-17,LU,54,73,22,51,2022-05-03_11-02-08,fp7d
2020-04-17,NE,10,20,10,10,2022-05-03_11-02-08,fp7d
2020-04-17,NW,6,6,0,6,2022-05-03_11-02-08,fp7d
2020-04-17,OW,0,0,0,0,2022-05-03_11-02-08,fp7d
2020-04-17,SG,54,78,24,54,2022-05-03_11-02-08,fp7d
2020-04-17,SH,8,12,4,8,2022-05-03_11-02-08,fp7d
2020-04-17,SO,17,20,3,17,2022-05-03_11-02-08,fp7d
2020-04-17,SZ,12,12,1,11,2022-05-03_11-02-08,fp7d
2020-04-17,TG,21,58,37,21,2022-05-03_11-02-08,fp7d
2020-04-17,TI,54,93,54,39,2022-05-03_11-02-08,fp7d
2020-04-17,UR,6,6,0,6,2022-05-03_11-02-08,fp7d
2020-04-17,VD,83,156,73,83,2022-05-03_11-02-08,fp7d
2020-04-17,VS,21,47,26,21,2022-05-03_11-02-08,fp7d
2020-04-17,ZG,8,8,0,8,2022-05-03_11-02-08,fp7d
2020-04-17,ZH,172,423,252,171,2022-05-03_11-02-08,fp7d
2020-04-18,AG,54,69,15,54,2022-05-03_11-02-08,fp7d
2020-04-18,AI,0,0,0,0,2022-05-03_11-02-08,fp7d
2020-04-18,AR,6,10,4,6,2022-05-03_11-02-08,fp7d
2020-04-18,BE,104,126,22,104,2022-05-03_11-02-08,fp7d
2020-04-18,BL,20,19,1,18,2022-05-03_11-02-08,fp7d
2020-04-18,BS,54,58,4,54,2022-05-03_11-02-08,fp7d
2020-04-18,FR,24,30,6,24,2022-05-03_11-02-08,fp7d
2020-04-18,GE,40,124,84,40,2022-05-03_11-02-08,fp7d
2020-04-18,GL,6,14,8,6,2022-05-03_11-02-08,fp7d
2020-04-18,GR,17,30,13,17,2022-05-03_11-02-08,fp7d
2020-04-18,JU,6,13,7,6,2022-05-03_11-02-08,fp7d
2020-04-18,LU,54,74,22,52,2022-05-03_11-02-08,fp7d
2020-04-18,NE,10,20,10,10,2022-05-03_11-02-08,fp7d
2020-04-18,NW,6,6,0,6,2022-05-03_11-02-08,fp7d
2020-04-18,OW,0,0,0,0,2022-05-03_11-02-08,fp7d
2020-04-18,SG,54,78,24,54,2022-05-03_11-02-08,fp7d
2020-04-18,SH,8,12,4,8,2022-05-03_11-02-08,fp7d
2020-04-18,SO,17,20,3,17,2022-05-03_11-02-08,fp7d
2020-04-18,SZ,12,12,1,11,2022-05-03_11-02-08,fp7d
2020-04-18,TG,21,56,35,21,2022-05-03_11-02-08,fp7d
2020-04-18,TI,54,93,54,39,2022-05-03_11-02-08,fp7d
2020-04-18,UR,6,6,0,6,2022-05-03_11-02-08,fp7d
2020-04-18,VD,83,140,57,83,2022-05-03_11-02-08,fp7d
2020-04-18,VS,21,47,26,21,2022-05-03_11-02-08,fp7d
2020-04-18,ZG,8,8,0,8,2022-05-03_11-02-08,fp7d
2020-04-18,ZH,192,422,231,191,2022-05-03_11-02-08,fp7d
2020-04-19,AG,54,67,13,54,2022-05-03_11-02-08,fp7d
2020-04-19,AI,0,0,0,0,2022-05-03_11-02-08,fp7d
2020-04-19,AR,6,10,4,6,2022-05-03_11-02-08,fp7d
2020-04-19,BE,104,126,22,104,2022-05-03_11-02-08,fp7d
2020-04-19,BL,20,19,1,18,2022-05-03_11-02-08,fp7d
2020-04-19,BS,54,58,4,54,2022-05-03_11-02-08,fp7d
2020-04-19,FR,24,30,6,24,2022-05-03_11-02-08,fp7d
2020-04-19,GE,40,124,84,40,2022-05-03_11-02-08,fp7d
2020-04-19,GL,6,14,8,6,2022-05-03_11-02-08,fp7d
2020-04-19,GR,17,30,13,17,2022-05-03_11-02-08,fp7d
2020-04-19,JU,6,13,7,6,2022-05-03_11-02-08,fp7d
2020-04-19,LU,54,73,21,52,2022-05-03_11-02-08,fp7d
2020-04-19,NE,10,20,10,10,2022-05-03_11-02-08,fp7d
2020-04-19,NW,6,6,0,6,2022-05-03_11-02-08,fp7d
2020-04-19,OW,0,0,0,0,2022-05-03_11-02-08,fp7d
2020-04-19,SG,54,78,24,54,2022-05-03_11-02-08,fp7d
2020-04-19,SH,8,12,4,8,2022-05-03_11-02-08,fp7d
2020-04-19,SO,17,20,3,17,2022-05-03_11-02-08,fp7d
2020-04-19,SZ,12,12,1,11,2022-05-03_11-02-08,fp7d
2020-04-19,TG,21,54,33,21,2022-05-03_11-02-08,fp7d
2020-04-19,TI,54,93,54,39,2022-05-03_11-02-08,fp7d
2020-04-19,UR,6,6,0,6,2022-05-03_11-02-08,fp7d
2020-04-19,VD,83,140,57,83,2022-05-03_11-02-08,fp7d
2020-04-19,VS,21,47,26,21,2022-05-03_11-02-08,fp7d
2020-04-19,ZG,8,7,0,7,2022-05-03_11-02-08,fp7d
2020-04-19,ZH,192,422,231,191,2022-05-03_11-02-08,fp7d
2020-04-20,AG,54,59,5,54,2022-05-03_11-02-08,fp7d
2020-04-20,AI,0,0,0,0,2022-05-03_11-02-08,fp7d
2020-04-20,AR,6,10,4,6,2022-05-03_11-02-08,fp7d
2020-04-20,BE,104,122,18,104,2022-05-03_11-02-08,fp7d
2020-04-20,BL,20,19,1,18,2022-05-03_11-02-08,fp7d
2020-04-20,BS,54,58,4,54,2022-05-03_11-02-08,fp7d
2020-04-20,FR,24,30,6,24,2022-05-03_11-02-08,fp7d
2020-04-20,GE,40,124,84,40,2022-05-03_11-02-08,fp7d
2020-04-20,GL,6,14,8,6,2022-05-03_11-02-08,fp7d
2020-04-20,GR,17,30,13,17,2022-05-03_11-02-08,fp7d
2020-04-20,JU,6,13,7,6,2022-05-03_11-02-08,fp7d
2020-04-20,LU,54,75,21,54,2022-05-03_11-02-08,fp7d
2020-04-20,NE,10,20,10,10,2022-05-03_11-02-08,fp7d
2020-04-20,NW,6,6,0,6,2022-05-03_11-02-08,fp7d
2020-04-20,OW,0,0,0,0,2022-05-03_11-02-08,fp7d
2020-04-20,SG,54,78,24,54,2022-05-03_11-02-08,fp7d
2020-04-20,SH,8,12,4,8,2022-05-03_11-02-08,fp7d
2020-04-20,SO,17,20,3,17,2022-05-03_11-02-08,fp7d
2020-04-20,SZ,12,12,1,11,2022-05-03_11-02-08,fp7d
2020-04-20,TG,21,54,33,21,2022-05-03_11-02-08,fp7d
2020-04-20,TI,54,93,54,39,2022-05-03_11-02-08,fp7d
2020-04-20,UR,6,6,0,6,2022-05-03_11-02-08,fp7d
2020-04-20,VD,83,140,57,83,2022-05-03_11-02-08,fp7d
2020-04-20,VS,21,47,26,21,2022-05-03_11-02-08,fp7d
2020-04-20,ZG,8,10,2,8,2022-05-03_11-02-08,fp7d
2020-04-20,ZH,192,423,232,191,2022-05-03_11-02-08,fp7d
2020-04-21,AG,54,59,5,54,2022-05-03_11-02-08,fp7d
2020-04-21,AI,0,0,0,0,2022-05-03_11-02-08,fp7d
2020-04-21,AR,6,10,4,6,2022-05-03_11-02-08,fp7d
2020-04-21,BE,104,122,18,104,2022-05-03_11-02-08,fp7d
2020-04-21,BL,20,19,1,18,2022-05-03_11-02-08,fp7d
2020-04-21,BS,54,58,4,54,2022-05-03_11-02-08,fp7d
2020-04-21,FR,24,30,6,24,2022-05-03_11-02-08,fp7d
2020-04-21,GE,40,124,84,40,2022-05-03_11-02-08,fp7d
2020-04-21,GL,6,14,8,6,2022-05-03_11-02-08,fp7d
2020-04-21,GR,17,30,13,17,2022-05-03_11-02-08,fp7d
2020-04-21,JU,6,13,7,6,2022-05-03_11-02-08,fp7d
2020-04-21,LU,54,75,21,54,2022-05-03_11-02-08,fp7d
2020-04-21,NE,10,16,6,10,2022-05-03_11-02-08,fp7d
2020-04-21,NW,6,6,0,6,2022-05-03_11-02-08,fp7d
2020-04-21,OW,0,0,0,0,2022-05-03_11-02-08,fp7d
2020-04-21,SG,54,78,24,54,2022-05-03_11-02-08,fp7d
2020-04-21,SH,8,12,4,8,2022-05-03_11-02-08,fp7d
2020-04-21,SO,17,20,3,17,2022-05-03_11-02-08,fp7d
2020-04-21,SZ,12,12,1,11,2022-05-03_11-02-08,fp7d
2020-04-21,TG,21,52,31,21,2022-05-03_11-02-08,fp7d
2020-04-21,TI,54,93,54,39,2022-05-03_11-02-08,fp7d
2020-04-21,UR,6,6,0,6,2022-05-03_11-02-08,fp7d
2020-04-21,VD,83,136,53,83,2022-05-03_11-02-08,fp7d
2020-04-21,VS,21,47,26,21,2022-05-03_11-02-08,fp7d
2020-04-21,ZG,8,10,2,8,2022-05-03_11-02-08,fp7d
2020-04-21,ZH,192,418,227,191,2022-05-03_11-02-08,fp7d
2020-04-22,AG,54,56,2,54,2022-05-03_11-02-08,fp7d
2020-04-22,AI,0,0,0,0,2022-05-03_11-02-08,fp7d
2020-04-22,AR,6,10,4,6,2022-05-03_11-02-08,fp7d
2020-04-22,BE,104,122,18,104,2022-05-03_11-02-08,fp7d
2020-04-22,BL,20,19,1,18,2022-05-03_11-02-08,fp7d
2020-04-22,BS,54,58,4,54,2022-05-03_11-02-08,fp7d
2020-04-22,FR,24,30,6,24,2022-05-03_11-02-08,fp7d
2020-04-22,GE,40,124,84,40,2022-05-03_11-02-08,fp7d
2020-04-22,GL,6,14,8,6,2022-05-03_11-02-08,fp7d
2020-04-22,GR,17,30,13,17,2022-05-03_11-02-08,fp7d
2020-04-22,JU,6,13,7,6,2022-05-03_11-02-08,fp7d
2020-04-22,LU,54,80,26,54,2022-05-03_11-02-08,fp7d
2020-04-22,NE,10,16,6,10,2022-05-03_11-02-08,fp7d
2020-04-22,NW,6,6,0,6,2022-05-03_11-02-08,fp7d
2020-04-22,OW,0,0,0,0,2022-05-03_11-02-08,fp7d
2020-04-22,SG,54,78,24,54,2022-05-03_11-02-08,fp7d
2020-04-22,SH,8,12,4,8,2022-05-03_11-02-08,fp7d
2020-04-22,SO,17,20,3,17,2022-05-03_11-02-08,fp7d
2020-04-22,SZ,12,12,1,11,2022-05-03_11-02-08,fp7d
2020-04-22,TG,21,52,31,21,2022-05-03_11-02-08,fp7d
2020-04-22,TI,54,93,54,39,2022-05-03_11-02-08,fp7d
2020-04-22,UR,6,6,0,6,2022-05-03_11-02-08,fp7d
2020-04-22,VD,83,134,51,83,2022-05-03_11-02-08,fp7d
2020-04-22,VS,21,47,26,21,2022-05-03_11-02-08,fp7d
2020-04-22,ZG,8,10,2,8,2022-05-03_11-02-08,fp7d
2020-04-22,ZH,192,417,226,191,2022-05-03_11-02-08,fp7d
2020-04-23,AG,54,56,2,54,2022-05-03_11-02-08,fp7d
2020-04-23,AI,0,0,0,0,2022-05-03_11-02-08,fp7d
2020-04-23,AR,6,10,4,6,2022-05-03_11-02-08,fp7d
2020-04-23,BE,104,122,18,104,2022-05-03_11-02-08,fp7d
2020-04-23,BL,20,19,1,18,2022-05-03_11-02-08,fp7d
2020-04-23,BS,54,54,4,50,2022-05-03_11-02-08,fp7d
2020-04-23,FR,24,24,0,24,2022-05-03_11-02-08,fp7d
2020-04-23,GE,40,124,84,40,2022-05-03_11-02-08,fp7d
2020-04-23,GL,6,14,8,6,2022-05-03_11-02-08,fp7d
2020-04-23,GR,17,30,13,17,2022-05-03_11-02-08,fp7d
2020-04-23,JU,6,13,7,6,2022-05-03_11-02-08,fp7d
2020-04-23,LU,54,80,26,54,2022-05-03_11-02-08,fp7d
2020-04-23,NE,10,16,6,10,2022-05-03_11-02-08,fp7d
2020-04-23,NW,6,6,0,6,2022-05-03_11-02-08,fp7d
2020-04-23,OW,0,0,0,0,2022-05-03_11-02-08,fp7d
2020-04-23,SG,54,72,18,54,2022-05-03_11-02-08,fp7d
2020-04-23,SH,8,12,4,8,2022-05-03_11-02-08,fp7d
2020-04-23,SO,17,20,3,17,2022-05-03_11-02-08,fp7d
2020-04-23,SZ,12,12,1,11,2022-05-03_11-02-08,fp7d
2020-04-23,TG,21,52,31,21,2022-05-03_11-02-08,fp7d
2020-04-23,TI,54,93,54,39,2022-05-03_11-02-08,fp7d
2020-04-23,UR,6,6,0,6,2022-05-03_11-02-08,fp7d
2020-04-23,VD,83,134,51,83,2022-05-03_11-02-08,fp7d
2020-04-23,VS,21,47,26,21,2022-05-03_11-02-08,fp7d
2020-04-23,ZG,8,10,2,8,2022-05-03_11-02-08,fp7d
2020-04-23,ZH,192,411,220,191,2022-05-03_11-02-08,fp7d
2020-04-24,AG,54,59,5,54,2022-05-03_11-02-08,fp7d
2020-04-24,AI,0,0,0,0,2022-05-03_11-02-08,fp7d
2020-04-24,AR,6,10,4,6,2022-05-03_11-02-08,fp7d
2020-04-24,BE,104,118,14,104,2022-05-03_11-02-08,fp7d
2020-04-24,BL,20,20,1,19,2022-05-03_11-02-08,fp7d
2020-04-24,BS,54,54,4,50,2022-05-03_11-02-08,fp7d
2020-04-24,FR,24,24,0,24,2022-05-03_11-02-08,fp7d
2020-04-24,GE,40,124,84,40,2022-05-03_11-02-08,fp7d
2020-04-24,GL,6,9,3,6,2022-05-03_11-02-08,fp7d
2020-04-24,GR,17,30,13,17,2022-05-03_11-02-08,fp7d
2020-04-24,JU,6,8,2,6,2022-05-03_11-02-08,fp7d
2020-04-24,LU,54,80,26,54,2022-05-03_11-02-08,fp7d
2020-04-24,NE,10,16,6,10,2022-05-03_11-02-08,fp7d
2020-04-24,NW,6,6,0,6,2022-05-03_11-02-08,fp7d
2020-04-24,OW,0,0,0,0,2022-05-03_11-02-08,fp7d
2020-04-24,SG,54,72,18,54,2022-05-03_11-02-08,fp7d
2020-04-24,SH,8,12,4,8,2022-05-03_11-02-08,fp7d
2020-04-24,SO,17,20,3,17,2022-05-03_11-02-08,fp7d
2020-04-24,SZ,12,12,1,11,2022-05-03_11-02-08,fp7d
2020-04-24,TG,21,50,29,21,2022-05-03_11-02-08,fp7d
2020-04-24,TI,54,93,54,39,2022-05-03_11-02-08,fp7d
2020-04-24,UR,6,6,0,6,2022-05-03_11-02-08,fp7d
2020-04-24,VD,83,134,51,83,2022-05-03_11-02-08,fp7d
2020-04-24,VS,21,47,26,21,2022-05-03_11-02-08,fp7d
2020-04-24,ZG,8,10,2,8,2022-05-03_11-02-08,fp7d
2020-04-24,ZH,192,411,220,191,2022-05-03_11-02-08,fp7d
2020-04-25,AG,54,59,5,54,2022-05-03_11-02-08,fp7d
2020-04-25,AI,0,0,0,0,2022-05-03_11-02-08,fp7d
2020-04-25,AR,6,10,4,6,2022-05-03_11-02-08,fp7d
2020-04-25,BE,104,118,14,104,2022-05-03_11-02-08,fp7d
2020-04-25,BL,20,19,1,18,2022-05-03_11-02-08,fp7d
2020-04-25,BS,54,54,4,50,2022-05-03_11-02-08,fp7d
2020-04-25,FR,24,24,0,24,2022-05-03_11-02-08,fp7d
2020-04-25,GE,40,102,62,40,2022-05-03_11-02-08,fp7d
2020-04-25,GL,6,9,3,6,2022-05-03_11-02-08,fp7d
2020-04-25,GR,17,30,13,17,2022-05-03_11-02-08,fp7d
2020-04-25,JU,6,8,2,6,2022-05-03_11-02-08,fp7d
2020-04-25,LU,54,80,26,54,2022-05-03_11-02-08,fp7d
2020-04-25,NE,10,16,6,10,2022-05-03_11-02-08,fp7d
2020-04-25,NW,6,6,0,6,2022-05-03_11-02-08,fp7d
2020-04-25,OW,0,0,0,0,2022-05-03_11-02-08,fp7d
2020-04-25,SG,54,72,18,54,2022-05-03_11-02-08,fp7d
2020-04-25,SH,8,8,0,8,2022-05-03_11-02-08,fp7d
2020-04-25,SO,17,20,3,17,2022-05-03_11-02-08,fp7d
2020-04-25,SZ,12,12,1,11,2022-05-03_11-02-08,fp7d
2020-04-25,TG,21,50,29,21,2022-05-03_11-02-08,fp7d
2020-04-25,TI,54,93,54,39,2022-05-03_11-02-08,fp7d
2020-04-25,UR,6,6,0,6,2022-05-03_11-02-08,fp7d
2020-04-25,VD,83,134,51,83,2022-05-03_11-02-08,fp7d
2020-04-25,VS,21,39,18,21,2022-05-03_11-02-08,fp7d
2020-04-25,ZG,8,10,2,8,2022-05-03_11-02-08,fp7d
2020-04-25,ZH,192,411,220,191,2022-05-03_11-02-08,fp7d
2020-04-26,AG,54,59,5,54,2022-05-03_11-02-08,fp7d
2020-04-26,AI,0,0,0,0,2022-05-03_11-02-08,fp7d
2020-04-26,AR,6,10,4,6,2022-05-03_11-02-08,fp7d
2020-04-26,BE,104,118,14,104,2022-05-03_11-02-08,fp7d
2020-04-26,BL,20,19,1,18,2022-05-03_11-02-08,fp7d
2020-04-26,BS,54,52,4,48,2022-05-03_11-02-08,fp7d
2020-04-26,FR,24,24,0,24,2022-05-03_11-02-08,fp7d
2020-04-26,GE,40,102,62,40,2022-05-03_11-02-08,fp7d
2020-04-26,GL,6,9,3,6,2022-05-03_11-02-08,fp7d
2020-04-26,GR,17,30,13,17,2022-05-03_11-02-08,fp7d
2020-04-26,JU,6,8,2,6,2022-05-03_11-02-08,fp7d
2020-04-26,LU,54,80,26,54,2022-05-03_11-02-08,fp7d
2020-04-26,NE,10,16,6,10,2022-05-03_11-02-08,fp7d
2020-04-26,NW,6,6,0,6,2022-05-03_11-02-08,fp7d
2020-04-26,OW,0,0,0,0,2022-05-03_11-02-08,fp7d
2020-04-26,SG,54,72,18,54,2022-05-03_11-02-08,fp7d
2020-04-26,SH,8,8,0,8,2022-05-03_11-02-08,fp7d
2020-04-26,SO,17,20,3,17,2022-05-03_11-02-08,fp7d
2020-04-26,SZ,12,12,1,11,2022-05-03_11-02-08,fp7d
2020-04-26,TG,21,50,29,21,2022-05-03_11-02-08,fp7d
2020-04-26,TI,54,93,54,39,2022-05-03_11-02-08,fp7d
2020-04-26,UR,6,6,0,6,2022-05-03_11-02-08,fp7d
2020-04-26,VD,79,130,51,79,2022-05-03_11-02-08,fp7d
2020-04-26,VS,21,39,18,21,2022-05-03_11-02-08,fp7d
2020-04-26,ZG,8,10,2,8,2022-05-03_11-02-08,fp7d
2020-04-26,ZH,192,411,220,191,2022-05-03_11-02-08,fp7d
2020-04-27,AG,54,59,5,54,2022-05-03_11-02-08,fp7d
2020-04-27,AI,0,0,0,0,2022-05-03_11-02-08,fp7d
2020-04-27,AR,6,10,4,6,2022-05-03_11-02-08,fp7d
2020-04-27,BE,104,118,14,104,2022-05-03_11-02-08,fp7d
2020-04-27,BL,20,19,1,18,2022-05-03_11-02-08,fp7d
2020-04-27,BS,54,54,4,50,2022-05-03_11-02-08,fp7d
2020-04-27,FR,24,24,0,24,2022-05-03_11-02-08,fp7d
2020-04-27,GE,40,102,62,40,2022-05-03_11-02-08,fp7d
2020-04-27,GL,6,9,3,6,2022-05-03_11-02-08,fp7d
2020-04-27,GR,17,30,13,17,2022-05-03_11-02-08,fp7d
2020-04-27,JU,6,8,2,6,2022-05-03_11-02-08,fp7d
2020-04-27,LU,54,80,26,54,2022-05-03_11-02-08,fp7d
2020-04-27,NE,10,16,6,10,2022-05-03_11-02-08,fp7d
2020-04-27,NW,6,6,0,6,2022-05-03_11-02-08,fp7d
2020-04-27,OW,0,0,0,0,2022-05-03_11-02-08,fp7d
2020-04-27,SG,54,69,15,54,2022-05-03_11-02-08,fp7d
2020-04-27,SH,8,8,0,8,2022-05-03_11-02-08,fp7d
2020-04-27,SO,17,18,1,17,2022-05-03_11-02-08,fp7d
2020-04-27,SZ,12,12,1,11,2022-05-03_11-02-08,fp7d
2020-04-27,TG,21,50,29,21,2022-05-03_11-02-08,fp7d
2020-04-27,TI,54,93,54,39,2022-05-03_11-02-08,fp7d
2020-04-27,UR,6,6,0,6,2022-05-03_11-02-08,fp7d
2020-04-27,VD,79,125,46,79,2022-05-03_11-02-08,fp7d
2020-04-27,VS,21,31,10,21,2022-05-03_11-02-08,fp7d
2020-04-27,ZG,8,10,2,8,2022-05-03_11-02-08,fp7d
2020-04-27,ZH,192,404,214,190,2022-05-03_11-02-08,fp7d
2020-04-28,AG,54,59,5,54,2022-05-03_11-02-08,fp7d
2020-04-28,AI,0,0,0,0,2022-05-03_11-02-08,fp7d
2020-04-28,AR,6,10,4,6,2022-05-03_11-02-08,fp7d
2020-04-28,BE,104,118,14,104,2022-05-03_11-02-08,fp7d
2020-04-28,BL,20,21,1,20,2022-05-03_11-02-08,fp7d
2020-04-28,BS,54,54,4,50,2022-05-03_11-02-08,fp7d
2020-04-28,FR,24,24,0,24,2022-05-03_11-02-08,fp7d
2020-04-28,GE,40,72,32,40,2022-05-03_11-02-08,fp7d
2020-04-28,GL,6,9,3,6,2022-05-03_11-02-08,fp7d
2020-04-28,GR,17,30,13,17,2022-05-03_11-02-08,fp7d
2020-04-28,JU,6,8,2,6,2022-05-03_11-02-08,fp7d
2020-04-28,LU,54,80,26,54,2022-05-03_11-02-08,fp7d
2020-04-28,NE,10,16,6,10,2022-05-03_11-02-08,fp7d
2020-04-28,NW,6,6,0,6,2022-05-03_11-02-08,fp7d
2020-04-28,OW,0,0,0,0,2022-05-03_11-02-08,fp7d
2020-04-28,SG,54,55,1,54,2022-05-03_11-02-08,fp7d
2020-04-28,SH,8,8,0,8,2022-05-03_11-02-08,fp7d
2020-04-28,SO,17,18,1,17,2022-05-03_11-02-08,fp7d
2020-04-28,SZ,12,12,1,11,2022-05-03_11-02-08,fp7d
2020-04-28,TG,21,50,29,21,2022-05-03_11-02-08,fp7d
2020-04-28,TI,54,93,54,39,2022-05-03_11-02-08,fp7d
2020-04-28,UR,6,6,0,6,2022-05-03_11-02-08,fp7d
2020-04-28,VD,79,125,46,79,2022-05-03_11-02-08,fp7d
2020-04-28,VS,21,31,10,21,2022-05-03_11-02-08,fp7d
2020-04-28,ZG,8,10,2,8,2022-05-03_11-02-08,fp7d
2020-04-28,ZH,192,395,207,188,2022-05-03_11-02-08,fp7d
2020-04-29,AG,54,58,5,53,2022-05-03_11-02-08,fp7d
2020-04-29,AI,0,0,0,0,2022-05-03_11-02-08,fp7d
2020-04-29,AR,6,10,4,6,2022-05-03_11-02-08,fp7d
2020-04-29,BE,104,118,14,104,2022-05-03_11-02-08,fp7d
2020-04-29,BL,20,14,0,14,2022-05-03_11-02-08,fp7d
2020-04-29,BS,54,54,4,50,2022-05-03_11-02-08,fp7d
2020-04-29,FR,24,24,0,24,2022-05-03_11-02-08,fp7d
2020-04-29,GE,40,72,32,40,2022-05-03_11-02-08,fp7d
2020-04-29,GL,6,9,3,6,2022-05-03_11-02-08,fp7d
2020-04-29,GR,17,30,13,17,2022-05-03_11-02-08,fp7d
2020-04-29,JU,6,8,2,6,2022-05-03_11-02-08,fp7d
2020-04-29,LU,54,80,26,54,2022-05-03_11-02-08,fp7d
2020-04-29,NE,10,16,6,10,2022-05-03_11-02-08,fp7d
2020-04-29,NW,6,6,0,6,2022-05-03_11-02-08,fp7d
2020-04-29,OW,0,0,0,0,2022-05-03_11-02-08,fp7d
2020-04-29,SG,54,55,1,54,2022-05-03_11-02-08,fp7d
2020-04-29,SH,8,8,0,8,2022-05-03_11-02-08,fp7d
2020-04-29,SO,17,18,1,17,2022-05-03_11-02-08,fp7d
2020-04-29,SZ,12,12,1,11,2022-05-03_11-02-08,fp7d
2020-04-29,TG,21,50,29,21,2022-05-03_11-02-08,fp7d
2020-04-29,TI,54,93,54,39,2022-05-03_11-02-08,fp7d
2020-04-29,UR,6,6,0,6,2022-05-03_11-02-08,fp7d
2020-04-29,VD,79,125,46,79,2022-05-03_11-02-08,fp7d
2020-04-29,VS,21,31,10,21,2022-05-03_11-02-08,fp7d
2020-04-29,ZG,8,10,2,8,2022-05-03_11-02-08,fp7d
2020-04-29,ZH,192,374,188,186,2022-05-03_11-02-08,fp7d
2020-04-30,AG,54,57,3,54,2022-05-03_11-02-08,fp7d
2020-04-30,AI,0,0,0,0,2022-05-03_11-02-08,fp7d
2020-04-30,AR,6,10,4,6,2022-05-03_11-02-08,fp7d
2020-04-30,BE,104,118,14,104,2022-05-03_11-02-08,fp7d
2020-04-30,BL,20,14,0,14,2022-05-03_11-02-08,fp7d
2020-04-30,BS,54,54,4,50,2022-05-03_11-02-08,fp7d
2020-04-30,FR,24,24,0,24,2022-05-03_11-02-08,fp7d
2020-04-30,GE,40,72,32,40,2022-05-03_11-02-08,fp7d
2020-04-30,GL,6,9,3,6,2022-05-03_11-02-08,fp7d
2020-04-30,GR,17,30,13,17,2022-05-03_11-02-08,fp7d
2020-04-30,JU,6,8,2,6,2022-05-03_11-02-08,fp7d
2020-04-30,LU,54,80,26,54,2022-05-03_11-02-08,fp7d
2020-04-30,NE,10,13,3,10,2022-05-03_11-02-08,fp7d
2020-04-30,NW,6,6,0,6,2022-05-03_11-02-08,fp7d
2020-04-30,OW,0,0,0,0,2022-05-03_11-02-08,fp7d
2020-04-30,SG,54,55,1,54,2022-05-03_11-02-08,fp7d
2020-04-30,SH,8,8,0,8,2022-05-03_11-02-08,fp7d
2020-04-30,SO,17,18,1,17,2022-05-03_11-02-08,fp7d
2020-04-30,SZ,12,11,0,11,2022-05-03_11-02-08,fp7d
2020-04-30,TG,21,42,21,21,2022-05-03_11-02-08,fp7d
2020-04-30,TI,54,93,54,39,2022-05-03_11-02-08,fp7d
2020-04-30,UR,6,6,0,6,2022-05-03_11-02-08,fp7d
2020-04-30,VD,79,115,36,79,2022-05-03_11-02-08,fp7d
2020-04-30,VS,21,31,10,21,2022-05-03_11-02-08,fp7d
2020-04-30,ZG,8,10,2,8,2022-05-03_11-02-08,fp7d
2020-04-30,ZH,192,376,188,188,2022-05-03_11-02-08,fp7d
2020-05-01,AG,54,57,3,54,2022-05-03_11-02-08,fp7d
2020-05-01,AI,0,0,0,0,2022-05-03_11-02-08,fp7d
2020-05-01,AR,6,10,4,6,2022-05-03_11-02-08,fp7d
2020-05-01,BE,104,118,14,104,2022-05-03_11-02-08,fp7d
2020-05-01,BL,20,14,0,14,2022-05-03_11-02-08,fp7d
2020-05-01,BS,54,52,4,48,2022-05-03_11-02-08,fp7d
2020-05-01,FR,24,24,0,24,2022-05-03_11-02-08,fp7d
2020-05-01,GE,40,72,32,40,2022-05-03_11-02-08,fp7d
2020-05-01,GL,6,9,3,6,2022-05-03_11-02-08,fp7d
2020-05-01,GR,17,26,9,17,2022-05-03_11-02-08,fp7d
2020-05-01,JU,6,8,2,6,2022-05-03_11-02-08,fp7d
2020-05-01,LU,54,77,26,51,2022-05-03_11-02-08,fp7d
2020-05-01,NE,10,13,3,10,2022-05-03_11-02-08,fp7d
2020-05-01,NW,6,6,0,6,2022-05-03_11-02-08,fp7d
2020-05-01,OW,0,0,0,0,2022-05-03_11-02-08,fp7d
2020-05-01,SG,54,56,2,54,2022-05-03_11-02-08,fp7d
2020-05-01,SH,8,8,0,8,2022-05-03_11-02-08,fp7d
2020-05-01,SO,17,18,1,17,2022-05-03_11-02-08,fp7d
2020-05-01,SZ,12,11,0,11,2022-05-03_11-02-08,fp7d
2020-05-01,TG,21,42,21,21,2022-05-03_11-02-08,fp7d
2020-05-01,TI,46,53,22,31,2022-05-03_11-02-08,fp7d
2020-05-01,UR,6,6,0,6,2022-05-03_11-02-08,fp7d
2020-05-01,VD,79,113,34,79,2022-05-03_11-02-08,fp7d
2020-05-01,VS,21,31,10,21,2022-05-03_11-02-08,fp7d
2020-05-01,ZG,8,10,2,8,2022-05-03_11-02-08,fp7d
2020-05-01,ZH,192,364,176,188,2022-05-03_11-02-08,fp7d
2020-05-02,AG,54,57,3,54,2022-05-03_11-02-08,fp7d
2020-05-02,AI,0,0,0,0,2022-05-03_11-02-08,fp7d
2020-05-02,AR,6,10,4,6,2022-05-03_11-02-08,fp7d
2020-05-02,BE,104,118,14,104,2022-05-03_11-02-08,fp7d
2020-05-02,BL,20,14,0,14,2022-05-03_11-02-08,fp7d
2020-05-02,BS,54,52,4,48,2022-05-03_11-02-08,fp7d
2020-05-02,FR,24,24,0,24,2022-05-03_11-02-08,fp7d
2020-05-02,GE,40,72,32,40,2022-05-03_11-02-08,fp7d
2020-05-02,GL,6,9,3,6,2022-05-03_11-02-08,fp7d
2020-05-02,GR,17,26,9,17,2022-05-03_11-02-08,fp7d
2020-05-02,JU,6,8,2,6,2022-05-03_11-02-08,fp7d
2020-05-02,LU,54,69,19,50,2022-05-03_11-02-08,fp7d
2020-05-02,NE,10,13,3,10,2022-05-03_11-02-08,fp7d
2020-05-02,NW,6,6,0,6,2022-05-03_11-02-08,fp7d
2020-05-02,OW,0,0,0,0,2022-05-03_11-02-08,fp7d
2020-05-02,SG,54,56,2,54,2022-05-03_11-02-08,fp7d
2020-05-02,SH,8,8,0,8,2022-05-03_11-02-08,fp7d
2020-05-02,SO,17,18,1,17,2022-05-03_11-02-08,fp7d
2020-05-02,SZ,12,11,0,11,2022-05-03_11-02-08,fp7d
2020-05-02,TG,21,42,21,21,2022-05-03_11-02-08,fp7d
2020-05-02,TI,46,53,22,31,2022-05-03_11-02-08,fp7d
2020-05-02,UR,6,6,0,6,2022-05-03_11-02-08,fp7d
2020-05-02,VD,79,113,34,79,2022-05-03_11-02-08,fp7d
2020-05-02,VS,21,31,10,21,2022-05-03_11-02-08,fp7d
2020-05-02,ZG,8,10,2,8,2022-05-03_11-02-08,fp7d
2020-05-02,ZH,192,364,176,188,2022-05-03_11-02-08,fp7d
2020-05-03,AG,54,57,3,54,2022-05-03_11-02-08,fp7d
2020-05-03,AI,0,0,0,0,2022-05-03_11-02-08,fp7d
2020-05-03,AR,6,10,4,6,2022-05-03_11-02-08,fp7d
2020-05-03,BE,104,118,14,104,2022-05-03_11-02-08,fp7d
2020-05-03,BL,20,14,0,14,2022-05-03_11-02-08,fp7d
2020-05-03,BS,54,52,4,48,2022-05-03_11-02-08,fp7d
2020-05-03,FR,24,24,0,24,2022-05-03_11-02-08,fp7d
2020-05-03,GE,40,72,32,40,2022-05-03_11-02-08,fp7d
2020-05-03,GL,6,9,3,6,2022-05-03_11-02-08,fp7d
2020-05-03,GR,17,26,9,17,2022-05-03_11-02-08,fp7d
2020-05-03,JU,6,8,2,6,2022-05-03_11-02-08,fp7d
2020-05-03,LU,54,69,19,50,2022-05-03_11-02-08,fp7d
2020-05-03,NE,10,13,3,10,2022-05-03_11-02-08,fp7d
2020-05-03,NW,6,6,0,6,2022-05-03_11-02-08,fp7d
2020-05-03,OW,0,0,0,0,2022-05-03_11-02-08,fp7d
2020-05-03,SG,54,55,1,54,2022-05-03_11-02-08,fp7d
2020-05-03,SH,8,8,0,8,2022-05-03_11-02-08,fp7d
2020-05-03,SO,17,18,1,17,2022-05-03_11-02-08,fp7d
2020-05-03,SZ,12,11,0,11,2022-05-03_11-02-08,fp7d
2020-05-03,TG,21,42,21,21,2022-05-03_11-02-08,fp7d
2020-05-03,TI,46,53,22,31,2022-05-03_11-02-08,fp7d
2020-05-03,UR,6,6,0,6,2022-05-03_11-02-08,fp7d
2020-05-03,VD,79,113,34,79,2022-05-03_11-02-08,fp7d
2020-05-03,VS,21,31,10,21,2022-05-03_11-02-08,fp7d
2020-05-03,ZG,8,10,2,8,2022-05-03_11-02-08,fp7d
2020-05-03,ZH,192,365,177,188,2022-05-03_11-02-08,fp7d
2020-05-04,AG,54,56,2,54,2022-05-03_11-02-08,fp7d
2020-05-04,AI,0,0,0,0,2022-05-03_11-02-08,fp7d
2020-05-04,AR,6,10,4,6,2022-05-03_11-02-08,fp7d
2020-05-04,BE,104,118,14,104,2022-05-03_11-02-08,fp7d
2020-05-04,BL,20,14,0,14,2022-05-03_11-02-08,fp7d
2020-05-04,BS,54,54,4,50,2022-05-03_11-02-08,fp7d
2020-05-04,FR,24,24,0,24,2022-05-03_11-02-08,fp7d
2020-05-04,GE,40,72,32,40,2022-05-03_11-02-08,fp7d
2020-05-04,GL,6,9,3,6,2022-05-03_11-02-08,fp7d
2020-05-04,GR,17,26,9,17,2022-05-03_11-02-08,fp7d
2020-05-04,JU,6,8,2,6,2022-05-03_11-02-08,fp7d
2020-05-04,LU,54,66,19,47,2022-05-03_11-02-08,fp7d
2020-05-04,NE,10,13,3,10,2022-05-03_11-02-08,fp7d
2020-05-04,NW,6,6,0,6,2022-05-03_11-02-08,fp7d
2020-05-04,OW,0,0,0,0,2022-05-03_11-02-08,fp7d
2020-05-04,SG,54,55,1,54,2022-05-03_11-02-08,fp7d
2020-05-04,SH,8,8,0,8,2022-05-03_11-02-08,fp7d
2020-05-04,SO,17,18,1,17,2022-05-03_11-02-08,fp7d
2020-05-04,SZ,12,11,0,11,2022-05-03_11-02-08,fp7d
2020-05-04,TG,21,38,17,21,2022-05-03_11-02-08,fp7d
2020-05-04,TI,46,53,22,31,2022-05-03_11-02-08,fp7d
2020-05-04,UR,6,6,0,6,2022-05-03_11-02-08,fp7d
2020-05-04,VD,79,113,34,79,2022-05-03_11-02-08,fp7d
2020-05-04,VS,21,31,10,21,2022-05-03_11-02-08,fp7d
2020-05-04,ZG,8,10,2,8,2022-05-03_11-02-08,fp7d
2020-05-04,ZH,192,340,149,191,2022-05-03_11-02-08,fp7d
2020-05-05,AG,54,54,0,54,2022-05-03_11-02-08,fp7d
2020-05-05,AI,0,0,0,0,2022-05-03_11-02-08,fp7d
2020-05-05,AR,6,10,4,6,2022-05-03_11-02-08,fp7d
2020-05-05,BE,104,118,14,104,2022-05-03_11-02-08,fp7d
2020-05-05,BL,20,16,0,16,2022-05-03_11-02-08,fp7d
2020-05-05,BS,54,54,4,50,2022-05-03_11-02-08,fp7d
2020-05-05,FR,24,24,0,24,2022-05-03_11-02-08,fp7d
2020-05-05,GE,40,62,22,40,2022-05-03_11-02-08,fp7d
2020-05-05,GL,6,9,3,6,2022-05-03_11-02-08,fp7d
2020-05-05,GR,17,26,9,17,2022-05-03_11-02-08,fp7d
2020-05-05,JU,6,8,2,6,2022-05-03_11-02-08,fp7d
2020-05-05,LU,54,66,19,47,2022-05-03_11-02-08,fp7d
2020-05-05,NE,10,13,3,10,2022-05-03_11-02-08,fp7d
2020-05-05,NW,6,6,0,6,2022-05-03_11-02-08,fp7d
2020-05-05,OW,0,0,0,0,2022-05-03_11-02-08,fp7d
2020-05-05,SG,54,55,1,54,2022-05-03_11-02-08,fp7d
2020-05-05,SH,8,8,0,8,2022-05-03_11-02-08,fp7d
2020-05-05,SO,17,18,1,17,2022-05-03_11-02-08,fp7d
2020-05-05,SZ,12,11,0,11,2022-05-03_11-02-08,fp7d
2020-05-05,TG,21,38,17,21,2022-05-03_11-02-08,fp7d
2020-05-05,TI,47,53,21,32,2022-05-03_11-02-08,fp7d
2020-05-05,UR,6,6,0,6,2022-05-03_11-02-08,fp7d
2020-05-05,VD,79,102,23,79,2022-05-03_11-02-08,fp7d
2020-05-05,VS,21,31,10,21,2022-05-03_11-02-08,fp7d
2020-05-05,ZG,8,10,2,8,2022-05-03_11-02-08,fp7d
2020-05-05,ZH,192,338,149,189,2022-05-03_11-02-08,fp7d
2020-05-06,AG,54,54,0,54,2022-05-03_11-02-08,fp7d
2020-05-06,AI,0,0,0,0,2022-05-03_11-02-08,fp7d
2020-05-06,AR,6,10,4,6,2022-05-03_11-02-08,fp7d
2020-05-06,BE,104,118,14,104,2022-05-03_11-02-08,fp7d
2020-05-06,BL,20,16,0,16,2022-05-03_11-02-08,fp7d
2020-05-06,BS,54,54,4,50,2022-05-03_11-02-08,fp7d
2020-05-06,FR,24,24,0,24,2022-05-03_11-02-08,fp7d
2020-05-06,GE,40,62,22,40,2022-05-03_11-02-08,fp7d
2020-05-06,GL,6,9,3,6,2022-05-03_11-02-08,fp7d
2020-05-06,GR,17,26,9,17,2022-05-03_11-02-08,fp7d
2020-05-06,JU,6,8,2,6,2022-05-03_11-02-08,fp7d
2020-05-06,LU,54,66,19,47,2022-05-03_11-02-08,fp7d
2020-05-06,NE,10,13,3,10,2022-05-03_11-02-08,fp7d
2020-05-06,NW,6,6,0,6,2022-05-03_11-02-08,fp7d
2020-05-06,OW,0,0,0,0,2022-05-03_11-02-08,fp7d
2020-05-06,SG,54,55,1,54,2022-05-03_11-02-08,fp7d
2020-05-06,SH,8,8,0,8,2022-05-03_11-02-08,fp7d
2020-05-06,SO,17,18,1,17,2022-05-03_11-02-08,fp7d
2020-05-06,SZ,12,11,0,11,2022-05-03_11-02-08,fp7d
2020-05-06,TG,21,38,17,21,2022-05-03_11-02-08,fp7d
2020-05-06,TI,47,45,13,32,2022-05-03_11-02-08,fp7d
2020-05-06,UR,6,6,0,6,2022-05-03_11-02-08,fp7d
2020-05-06,VD,79,102,23,79,2022-05-03_11-02-08,fp7d
2020-05-06,VS,21,31,10,21,2022-05-03_11-02-08,fp7d
2020-05-06,ZG,8,10,2,8,2022-05-03_11-02-08,fp7d
2020-05-06,ZH,192,336,146,190,2022-05-03_11-02-08,fp7d
2020-05-07,AG,54,54,0,54,2022-05-03_11-02-08,fp7d
2020-05-07,AI,0,0,0,0,2022-05-03_11-02-08,fp7d
2020-05-07,AR,6,10,4,6,2022-05-03_11-02-08,fp7d
2020-05-07,BE,104,116,12,104,2022-05-03_11-02-08,fp7d
2020-05-07,BL,20,16,0,16,2022-05-03_11-02-08,fp7d
2020-05-07,BS,54,54,4,50,2022-05-03_11-02-08,fp7d
2020-05-07,FR,24,24,0,24,2022-05-03_11-02-08,fp7d
2020-05-07,GE,40,62,22,40,2022-05-03_11-02-08,fp7d
2020-05-07,GL,6,9,3,6,2022-05-03_11-02-08,fp7d
2020-05-07,GR,17,26,9,17,2022-05-03_11-02-08,fp7d
2020-05-07,JU,6,8,2,6,2022-05-03_11-02-08,fp7d
2020-05-07,LU,54,67,19,48,2022-05-03_11-02-08,fp7d
2020-05-07,NE,10,13,3,10,2022-05-03_11-02-08,fp7d
2020-05-07,NW,6,6,0,6,2022-05-03_11-02-08,fp7d
2020-05-07,OW,0,0,0,0,2022-05-03_11-02-08,fp7d
2020-05-07,SG,54,55,1,54,2022-05-03_11-02-08,fp7d
2020-05-07,SH,8,8,0,8,2022-05-03_11-02-08,fp7d
2020-05-07,SO,17,18,1,17,2022-05-03_11-02-08,fp7d
2020-05-07,SZ,12,11,0,11,2022-05-03_11-02-08,fp7d
2020-05-07,TG,21,38,17,21,2022-05-03_11-02-08,fp7d
2020-05-07,TI,47,45,13,32,2022-05-03_11-02-08,fp7d
2020-05-07,UR,6,6,0,6,2022-05-03_11-02-08,fp7d
2020-05-07,VD,79,102,23,79,2022-05-03_11-02-08,fp7d
2020-05-07,VS,21,31,10,21,2022-05-03_11-02-08,fp7d
2020-05-07,ZG,8,10,2,8,2022-05-03_11-02-08,fp7d
2020-05-07,ZH,192,335,146,189,2022-05-03_11-02-08,fp7d
2020-05-08,AG,54,54,0,54,2022-05-03_11-02-08,fp7d
2020-05-08,AI,0,0,0,0,2022-05-03_11-02-08,fp7d
2020-05-08,AR,6,10,4,6,2022-05-03_11-02-08,fp7d
2020-05-08,BE,104,116,12,104,2022-05-03_11-02-08,fp7d
2020-05-08,BL,20,16,0,16,2022-05-03_11-02-08,fp7d
2020-05-08,BS,54,54,4,50,2022-05-03_11-02-08,fp7d
2020-05-08,FR,24,24,0,24,2022-05-03_11-02-08,fp7d
2020-05-08,GE,40,56,16,40,2022-05-03_11-02-08,fp7d
2020-05-08,GL,6,9,3,6,2022-05-03_11-02-08,fp7d
2020-05-08,GR,17,26,9,17,2022-05-03_11-02-08,fp7d
2020-05-08,JU,6,8,2,6,2022-05-03_11-02-08,fp7d
2020-05-08,LU,54,67,19,48,2022-05-03_11-02-08,fp7d
2020-05-08,NE,10,13,3,10,2022-05-03_11-02-08,fp7d
2020-05-08,NW,6,6,0,6,2022-05-03_11-02-08,fp7d
2020-05-08,OW,0,0,0,0,2022-05-03_11-02-08,fp7d
2020-05-08,SG,54,55,1,54,2022-05-03_11-02-08,fp7d
2020-05-08,SH,8,8,0,8,2022-05-03_11-02-08,fp7d
2020-05-08,SO,17,18,1,17,2022-05-03_11-02-08,fp7d
2020-05-08,SZ,12,12,0,12,2022-05-03_11-02-08,fp7d
2020-05-08,TG,21,38,17,21,2022-05-03_11-02-08,fp7d
2020-05-08,TI,47,45,13,32,2022-05-03_11-02-08,fp7d
2020-05-08,UR,6,6,0,6,2022-05-03_11-02-08,fp7d
2020-05-08,VD,79,102,23,79,2022-05-03_11-02-08,fp7d
2020-05-08,VS,21,31,10,21,2022-05-03_11-02-08,fp7d
2020-05-08,ZG,8,10,2,8,2022-05-03_11-02-08,fp7d
2020-05-08,ZH,192,335,146,189,2022-05-03_11-02-08,fp7d
2020-05-09,AG,54,54,0,54,2022-05-03_11-02-08,fp7d
2020-05-09,AI,0,0,0,0,2022-05-03_11-02-08,fp7d
2020-05-09,AR,6,10,4,6,2022-05-03_11-02-08,fp7d
2020-05-09,BE,104,116,12,104,2022-05-03_11-02-08,fp7d
2020-05-09,BL,20,16,0,16,2022-05-03_11-02-08,fp7d
2020-05-09,BS,54,52,4,48,2022-05-03_11-02-08,fp7d
2020-05-09,FR,24,24,0,24,2022-05-03_11-02-08,fp7d
2020-05-09,GE,40,56,16,40,2022-05-03_11-02-08,fp7d
2020-05-09,GL,6,9,3,6,2022-05-03_11-02-08,fp7d
2020-05-09,GR,17,26,9,17,2022-05-03_11-02-08,fp7d
2020-05-09,JU,6,8,2,6,2022-05-03_11-02-08,fp7d
2020-05-09,LU,54,67,19,48,2022-05-03_11-02-08,fp7d
2020-05-09,NE,10,13,3,10,2022-05-03_11-02-08,fp7d
2020-05-09,NW,6,6,0,6,2022-05-03_11-02-08,fp7d
2020-05-09,OW,0,0,0,0,2022-05-03_11-02-08,fp7d
2020-05-09,SG,54,55,1,54,2022-05-03_11-02-08,fp7d
2020-05-09,SH,8,8,0,8,2022-05-03_11-02-08,fp7d
2020-05-09,SO,17,18,1,17,2022-05-03_11-02-08,fp7d
2020-05-09,SZ,12,11,0,11,2022-05-03_11-02-08,fp7d
2020-05-09,TG,21,38,17,21,2022-05-03_11-02-08,fp7d
2020-05-09,TI,47,45,13,32,2022-05-03_11-02-08,fp7d
2020-05-09,UR,6,6,0,6,2022-05-03_11-02-08,fp7d
2020-05-09,VD,79,102,23,79,2022-05-03_11-02-08,fp7d
2020-05-09,VS,21,31,10,21,2022-05-03_11-02-08,fp7d
2020-05-09,ZG,8,10,2,8,2022-05-03_11-02-08,fp7d
2020-05-09,ZH,192,335,146,189,2022-05-03_11-02-08,fp7d
2020-05-10,AG,54,54,0,54,2022-05-03_11-02-08,fp7d
2020-05-10,AI,0,0,0,0,2022-05-03_11-02-08,fp7d
2020-05-10,AR,6,10,4,6,2022-05-03_11-02-08,fp7d
2020-05-10,BE,104,116,12,104,2022-05-03_11-02-08,fp7d
2020-05-10,BL,20,16,0,16,2022-05-03_11-02-08,fp7d
2020-05-10,BS,54,52,4,48,2022-05-03_11-02-08,fp7d
2020-05-10,FR,24,24,0,24,2022-05-03_11-02-08,fp7d
2020-05-10,GE,40,56,16,40,2022-05-03_11-02-08,fp7d
2020-05-10,GL,6,9,3,6,2022-05-03_11-02-08,fp7d
2020-05-10,GR,17,26,9,17,2022-05-03_11-02-08,fp7d
2020-05-10,JU,6,8,2,6,2022-05-03_11-02-08,fp7d
2020-05-10,LU,54,67,19,48,2022-05-03_11-02-08,fp7d
2020-05-10,NE,10,13,3,10,2022-05-03_11-02-08,fp7d
2020-05-10,NW,6,6,0,6,2022-05-03_11-02-08,fp7d
2020-05-10,OW,0,0,0,0,2022-05-03_11-02-08,fp7d
2020-05-10,SG,54,55,1,54,2022-05-03_11-02-08,fp7d
2020-05-10,SH,8,8,0,8,2022-05-03_11-02-08,fp7d
2020-05-10,SO,17,18,1,17,2022-05-03_11-02-08,fp7d
2020-05-10,SZ,12,11,0,11,2022-05-03_11-02-08,fp7d
2020-05-10,TG,21,38,17,21,2022-05-03_11-02-08,fp7d
2020-05-10,TI,47,45,13,32,2022-05-03_11-02-08,fp7d
2020-05-10,UR,6,6,0,6,2022-05-03_11-02-08,fp7d
2020-05-10,VD,79,102,23,79,2022-05-03_11-02-08,fp7d
2020-05-10,VS,21,31,10,21,2022-05-03_11-02-08,fp7d
2020-05-10,ZG,8,10,2,8,2022-05-03_11-02-08,fp7d
2020-05-10,ZH,192,335,146,189,2022-05-03_11-02-08,fp7d
2020-05-11,AG,54,54,0,54,2022-05-03_11-02-08,fp7d
2020-05-11,AI,0,0,0,0,2022-05-03_11-02-08,fp7d
2020-05-11,AR,6,10,4,6,2022-05-03_11-02-08,fp7d
2020-05-11,BE,104,116,12,104,2022-05-03_11-02-08,fp7d
2020-05-11,BL,20,14,0,14,2022-05-03_11-02-08,fp7d
2020-05-11,BS,54,54,4,50,2022-05-03_11-02-08,fp7d
2020-05-11,FR,24,24,0,24,2022-05-03_11-02-08,fp7d
2020-05-11,GE,40,54,14,40,2022-05-03_11-02-08,fp7d
2020-05-11,GL,6,9,3,6,2022-05-03_11-02-08,fp7d
2020-05-11,GR,17,26,9,17,2022-05-03_11-02-08,fp7d
2020-05-11,JU,6,8,2,6,2022-05-03_11-02-08,fp7d
2020-05-11,LU,54,66,19,47,2022-05-03_11-02-08,fp7d
2020-05-11,NE,10,13,3,10,2022-05-03_11-02-08,fp7d
2020-05-11,NW,6,6,0,6,2022-05-03_11-02-08,fp7d
2020-05-11,OW,0,0,0,0,2022-05-03_11-02-08,fp7d
2020-05-11,SG,54,55,1,54,2022-05-03_11-02-08,fp7d
2020-05-11,SH,8,8,0,8,2022-05-03_11-02-08,fp7d
2020-05-11,SO,17,18,1,17,2022-05-03_11-02-08,fp7d
2020-05-11,SZ,12,11,0,11,2022-05-03_11-02-08,fp7d
2020-05-11,TG,21,38,17,21,2022-05-03_11-02-08,fp7d
2020-05-11,TI,47,45,13,32,2022-05-03_11-02-08,fp7d
2020-05-11,UR,6,6,0,6,2022-05-03_11-02-08,fp7d
2020-05-11,VD,79,102,23,79,2022-05-03_11-02-08,fp7d
2020-05-11,VS,21,31,10,21,2022-05-03_11-02-08,fp7d
2020-05-11,ZG,8,10,2,8,2022-05-03_11-02-08,fp7d
2020-05-11,ZH,192,335,146,189,2022-05-03_11-02-08,fp7d
2020-05-12,AG,54,54,0,54,2022-05-03_11-02-08,fp7d
2020-05-12,AI,0,0,0,0,2022-05-03_11-02-08,fp7d
2020-05-12,AR,6,10,4,6,2022-05-03_11-02-08,fp7d
2020-05-12,BE,104,116,12,104,2022-05-03_11-02-08,fp7d
2020-05-12,BL,20,16,0,16,2022-05-03_11-02-08,fp7d
2020-05-12,BS,54,54,4,50,2022-05-03_11-02-08,fp7d
2020-05-12,FR,24,24,0,24,2022-05-03_11-02-08,fp7d
2020-05-12,GE,40,54,14,40,2022-05-03_11-02-08,fp7d
2020-05-12,GL,6,9,3,6,2022-05-03_11-02-08,fp7d
2020-05-12,GR,17,26,9,17,2022-05-03_11-02-08,fp7d
2020-05-12,JU,6,8,2,6,2022-05-03_11-02-08,fp7d
2020-05-12,LU,54,69,19,50,2022-05-03_11-02-08,fp7d
2020-05-12,NE,10,13,3,10,2022-05-03_11-02-08,fp7d
2020-05-12,NW,6,6,0,6,2022-05-03_11-02-08,fp7d
2020-05-12,OW,0,0,0,0,2022-05-03_11-02-08,fp7d
2020-05-12,SG,54,56,2,54,2022-05-03_11-02-08,fp7d
2020-05-12,SH,8,8,0,8,2022-05-03_11-02-08,fp7d
2020-05-12,SO,17,18,1,17,2022-05-03_11-02-08,fp7d
2020-05-12,SZ,12,11,0,11,2022-05-03_11-02-08,fp7d
2020-05-12,TG,21,38,17,21,2022-05-03_11-02-08,fp7d
2020-05-12,TI,47,45,13,32,2022-05-03_11-02-08,fp7d
2020-05-12,UR,6,6,0,6,2022-05-03_11-02-08,fp7d
2020-05-12,VD,79,102,23,79,2022-05-03_11-02-08,fp7d
2020-05-12,VS,21,31,10,21,2022-05-03_11-02-08,fp7d
2020-05-12,ZG,8,10,2,8,2022-05-03_11-02-08,fp7d
2020-05-12,ZH,192,337,146,191,2022-05-03_11-02-08,fp7d
2020-05-13,AG,54,54,0,54,2022-05-03_11-02-08,fp7d
2020-05-13,AI,0,0,0,0,2022-05-03_11-02-08,fp7d
2020-05-13,AR,6,10,4,6,2022-05-03_11-02-08,fp7d
2020-05-13,BE,104,116,12,104,2022-05-03_11-02-08,fp7d
2020-05-13,BL,20,16,0,16,2022-05-03_11-02-08,fp7d
2020-05-13,BS,54,54,4,50,2022-05-03_11-02-08,fp7d
2020-05-13,FR,24,24,0,24,2022-05-03_11-02-08,fp7d
2020-05-13,GE,40,54,14,40,2022-05-03_11-02-08,fp7d
2020-05-13,GL,6,9,3,6,2022-05-03_11-02-08,fp7d
2020-05-13,GR,17,26,9,17,2022-05-03_11-02-08,fp7d
2020-05-13,JU,6,7,1,6,2022-05-03_11-02-08,fp7d
2020-05-13,LU,54,69,19,50,2022-05-03_11-02-08,fp7d
2020-05-13,NE,10,13,3,10,2022-05-03_11-02-08,fp7d
2020-05-13,NW,6,6,0,6,2022-05-03_11-02-08,fp7d
2020-05-13,OW,0,0,0,0,2022-05-03_11-02-08,fp7d
2020-05-13,SG,54,55,1,54,2022-05-03_11-02-08,fp7d
2020-05-13,SH,8,8,0,8,2022-05-03_11-02-08,fp7d
2020-05-13,SO,17,18,1,17,2022-05-03_11-02-08,fp7d
2020-05-13,SZ,12,11,0,11,2022-05-03_11-02-08,fp7d
2020-05-13,TG,21,38,17,21,2022-05-03_11-02-08,fp7d
2020-05-13,TI,47,45,13,32,2022-05-03_11-02-08,fp7d
2020-05-13,UR,6,6,0,6,2022-05-03_11-02-08,fp7d
2020-05-13,VD,79,102,23,79,2022-05-03_11-02-08,fp7d
2020-05-13,VS,21,31,10,21,2022-05-03_11-02-08,fp7d
2020-05-13,ZG,8,10,2,8,2022-05-03_11-02-08,fp7d
2020-05-13,ZH,192,330,139,191,2022-05-03_11-02-08,fp7d
2020-05-14,AG,54,54,0,54,2022-05-03_11-02-08,fp7d
2020-05-14,AI,0,0,0,0,2022-05-03_11-02-08,fp7d
2020-05-14,AR,6,10,4,6,2022-05-03_11-02-08,fp7d
2020-05-14,BE,104,116,12,104,2022-05-03_11-02-08,fp7d
2020-05-14,BL,20,16,0,16,2022-05-03_11-02-08,fp7d
2020-05-14,BS,54,54,4,50,2022-05-03_11-02-08,fp7d
2020-05-14,FR,24,24,0,24,2022-05-03_11-02-08,fp7d
2020-05-14,GE,40,54,14,40,2022-05-03_11-02-08,fp7d
2020-05-14,GL,6,9,3,6,2022-05-03_11-02-08,fp7d
2020-05-14,GR,17,26,9,17,2022-05-03_11-02-08,fp7d
2020-05-14,JU,6,7,1,6,2022-05-03_11-02-08,fp7d
2020-05-14,LU,54,67,19,48,2022-05-03_11-02-08,fp7d
2020-05-14,NE,10,13,3,10,2022-05-03_11-02-08,fp7d
2020-05-14,NW,6,6,0,6,2022-05-03_11-02-08,fp7d
2020-05-14,OW,0,0,0,0,2022-05-03_11-02-08,fp7d
2020-05-14,SG,54,55,1,54,2022-05-03_11-02-08,fp7d
2020-05-14,SH,8,8,0,8,2022-05-03_11-02-08,fp7d
2020-05-14,SO,17,18,1,17,2022-05-03_11-02-08,fp7d
2020-05-14,SZ,12,11,0,11,2022-05-03_11-02-08,fp7d
2020-05-14,TG,21,38,17,21,2022-05-03_11-02-08,fp7d
2020-05-14,TI,47,45,13,32,2022-05-03_11-02-08,fp7d
2020-05-14,UR,6,6,0,6,2022-05-03_11-02-08,fp7d
2020-05-14,VD,79,102,23,79,2022-05-03_11-02-08,fp7d
2020-05-14,VS,21,31,10,21,2022-05-03_11-02-08,fp7d
2020-05-14,ZG,8,10,2,8,2022-05-03_11-02-08,fp7d
2020-05-14,ZH,192,330,139,191,2022-05-03_11-02-08,fp7d
2020-05-15,AG,54,54,0,54,2022-05-03_11-02-08,fp7d
2020-05-15,AI,0,0,0,0,2022-05-03_11-02-08,fp7d
2020-05-15,AR,6,10,4,6,2022-05-03_11-02-08,fp7d
2020-05-15,BE,104,116,12,104,2022-05-03_11-02-08,fp7d
2020-05-15,BL,20,16,0,16,2022-05-03_11-02-08,fp7d
2020-05-15,BS,54,54,4,50,2022-05-03_11-02-08,fp7d
2020-05-15,FR,24,24,0,24,2022-05-03_11-02-08,fp7d
2020-05-15,GE,40,50,10,40,2022-05-03_11-02-08,fp7d
2020-05-15,GL,6,9,3,6,2022-05-03_11-02-08,fp7d
2020-05-15,GR,17,26,9,17,2022-05-03_11-02-08,fp7d
2020-05-15,JU,6,7,1,6,2022-05-03_11-02-08,fp7d
2020-05-15,LU,54,69,19,50,2022-05-03_11-02-08,fp7d
2020-05-15,NE,10,13,3,10,2022-05-03_11-02-08,fp7d
2020-05-15,NW,6,6,0,6,2022-05-03_11-02-08,fp7d
2020-05-15,OW,0,0,0,0,2022-05-03_11-02-08,fp7d
2020-05-15,SG,54,55,1,54,2022-05-03_11-02-08,fp7d
2020-05-15,SH,8,8,0,8,2022-05-03_11-02-08,fp7d
2020-05-15,SO,17,18,1,17,2022-05-03_11-02-08,fp7d
2020-05-15,SZ,12,11,0,11,2022-05-03_11-02-08,fp7d
2020-05-15,TG,21,38,17,21,2022-05-03_11-02-08,fp7d
2020-05-15,TI,47,45,13,32,2022-05-03_11-02-08,fp7d
2020-05-15,UR,6,6,0,6,2022-05-03_11-02-08,fp7d
2020-05-15,VD,79,102,23,79,2022-05-03_11-02-08,fp7d
2020-05-15,VS,21,31,10,21,2022-05-03_11-02-08,fp7d
2020-05-15,ZG,8,10,2,8,2022-05-03_11-02-08,fp7d
2020-05-15,ZH,192,328,137,191,2022-05-03_11-02-08,fp7d
2020-05-16,AG,54,54,0,54,2022-05-03_11-02-08,fp7d
2020-05-16,AI,0,0,0,0,2022-05-03_11-02-08,fp7d
2020-05-16,AR,6,10,4,6,2022-05-03_11-02-08,fp7d
2020-05-16,BE,104,116,12,104,2022-05-03_11-02-08,fp7d
2020-05-16,BL,20,16,0,16,2022-05-03_11-02-08,fp7d
2020-05-16,BS,54,52,4,48,2022-05-03_11-02-08,fp7d
2020-05-16,FR,24,24,0,24,2022-05-03_11-02-08,fp7d
2020-05-16,GE,40,44,4,40,2022-05-03_11-02-08,fp7d
2020-05-16,GL,6,9,3,6,2022-05-03_11-02-08,fp7d
2020-05-16,GR,17,26,9,17,2022-05-03_11-02-08,fp7d
2020-05-16,JU,6,7,1,6,2022-05-03_11-02-08,fp7d
2020-05-16,LU,54,69,19,50,2022-05-03_11-02-08,fp7d
2020-05-16,NE,10,13,3,10,2022-05-03_11-02-08,fp7d
2020-05-16,NW,6,6,0,6,2022-05-03_11-02-08,fp7d
2020-05-16,OW,0,0,0,0,2022-05-03_11-02-08,fp7d
2020-05-16,SG,54,55,1,54,2022-05-03_11-02-08,fp7d
2020-05-16,SH,8,8,0,8,2022-05-03_11-02-08,fp7d
2020-05-16,SO,17,18,1,17,2022-05-03_11-02-08,fp7d
2020-05-16,SZ,12,11,0,11,2022-05-03_11-02-08,fp7d
2020-05-16,TG,21,38,17,21,2022-05-03_11-02-08,fp7d
2020-05-16,TI,47,45,13,32,2022-05-03_11-02-08,fp7d
2020-05-16,UR,6,6,0,6,2022-05-03_11-02-08,fp7d
2020-05-16,VD,79,102,23,79,2022-05-03_11-02-08,fp7d
2020-05-16,VS,21,31,10,21,2022-05-03_11-02-08,fp7d
2020-05-16,ZG,8,10,2,8,2022-05-03_11-02-08,fp7d
2020-05-16,ZH,192,328,137,191,2022-05-03_11-02-08,fp7d
2020-05-17,AG,54,54,0,54,2022-05-03_11-02-08,fp7d
2020-05-17,AI,0,0,0,0,2022-05-03_11-02-08,fp7d
2020-05-17,AR,6,10,4,6,2022-05-03_11-02-08,fp7d
2020-05-17,BE,104,116,12,104,2022-05-03_11-02-08,fp7d
2020-05-17,BL,20,16,0,16,2022-05-03_11-02-08,fp7d
2020-05-17,BS,54,52,4,48,2022-05-03_11-02-08,fp7d
2020-05-17,FR,24,24,0,24,2022-05-03_11-02-08,fp7d
2020-05-17,GE,40,44,4,40,2022-05-03_11-02-08,fp7d
2020-05-17,GL,6,9,3,6,2022-05-03_11-02-08,fp7d
2020-05-17,GR,17,26,9,17,2022-05-03_11-02-08,fp7d
2020-05-17,JU,6,7,1,6,2022-05-03_11-02-08,fp7d
2020-05-17,LU,54,69,19,50,2022-05-03_11-02-08,fp7d
2020-05-17,NE,10,13,3,10,2022-05-03_11-02-08,fp7d
2020-05-17,NW,6,6,0,6,2022-05-03_11-02-08,fp7d
2020-05-17,OW,0,0,0,0,2022-05-03_11-02-08,fp7d
2020-05-17,SG,54,55,1,54,2022-05-03_11-02-08,fp7d
2020-05-17,SH,8,8,0,8,2022-05-03_11-02-08,fp7d
2020-05-17,SO,17,18,1,17,2022-05-03_11-02-08,fp7d
2020-05-17,SZ,12,11,0,11,2022-05-03_11-02-08,fp7d
2020-05-17,TG,21,38,17,21,2022-05-03_11-02-08,fp7d
2020-05-17,TI,47,45,13,32,2022-05-03_11-02-08,fp7d
2020-05-17,UR,6,6,0,6,2022-05-03_11-02-08,fp7d
2020-05-17,VD,79,102,23,79,2022-05-03_11-02-08,fp7d
2020-05-17,VS,21,31,10,21,2022-05-03_11-02-08,fp7d
2020-05-17,ZG,8,10,2,8,2022-05-03_11-02-08,fp7d
2020-05-17,ZH,192,329,138,191,2022-05-03_11-02-08,fp7d
2020-05-18,AG,52,52,0,52,2022-05-03_11-02-08,fp7d
2020-05-18,AI,0,0,0,0,2022-05-03_11-02-08,fp7d
2020-05-18,AR,6,10,4,6,2022-05-03_11-02-08,fp7d
2020-05-18,BE,104,116,12,104,2022-05-03_11-02-08,fp7d
2020-05-18,BL,20,16,0,16,2022-05-03_11-02-08,fp7d
2020-05-18,BS,54,54,4,50,2022-05-03_11-02-08,fp7d
2020-05-18,FR,24,24,0,24,2022-05-03_11-02-08,fp7d
2020-05-18,GE,40,44,4,40,2022-05-03_11-02-08,fp7d
2020-05-18,GL,6,9,3,6,2022-05-03_11-02-08,fp7d
2020-05-18,GR,17,26,9,17,2022-05-03_11-02-08,fp7d
2020-05-18,JU,6,7,1,6,2022-05-03_11-02-08,fp7d
2020-05-18,LU,54,69,19,50,2022-05-03_11-02-08,fp7d
2020-05-18,NE,10,13,3,10,2022-05-03_11-02-08,fp7d
2020-05-18,NW,6,6,0,6,2022-05-03_11-02-08,fp7d
2020-05-18,OW,0,0,0,0,2022-05-03_11-02-08,fp7d
2020-05-18,SG,54,55,1,54,2022-05-03_11-02-08,fp7d
2020-05-18,SH,8,8,0,8,2022-05-03_11-02-08,fp7d
2020-05-18,SO,17,18,1,17,2022-05-03_11-02-08,fp7d
2020-05-18,SZ,12,11,0,11,2022-05-03_11-02-08,fp7d
2020-05-18,TG,21,38,17,21,2022-05-03_11-02-08,fp7d
2020-05-18,TI,47,45,13,32,2022-05-03_11-02-08,fp7d
2020-05-18,UR,6,6,0,6,2022-05-03_11-02-08,fp7d
2020-05-18,VD,79,102,23,79,2022-05-03_11-02-08,fp7d
2020-05-18,VS,21,31,10,21,2022-05-03_11-02-08,fp7d
2020-05-18,ZG,8,10,2,8,2022-05-03_11-02-08,fp7d
2020-05-18,ZH,192,329,138,191,2022-05-03_11-02-08,fp7d
2020-05-19,AG,52,52,0,52,2022-05-03_11-02-08,fp7d
2020-05-19,AI,0,0,0,0,2022-05-03_11-02-08,fp7d
2020-05-19,AR,6,10,4,6,2022-05-03_11-02-08,fp7d
2020-05-19,BE,104,116,12,104,2022-05-03_11-02-08,fp7d
2020-05-19,BL,20,16,0,16,2022-05-03_11-02-08,fp7d
2020-05-19,BS,54,50,0,50,2022-05-03_11-02-08,fp7d
2020-05-19,FR,24,24,0,24,2022-05-03_11-02-08,fp7d
2020-05-19,GE,40,44,4,40,2022-05-03_11-02-08,fp7d
2020-05-19,GL,6,9,3,6,2022-05-03_11-02-08,fp7d
2020-05-19,GR,17,26,9,17,2022-05-03_11-02-08,fp7d
2020-05-19,JU,6,7,1,6,2022-05-03_11-02-08,fp7d
2020-05-19,LU,54,69,19,50,2022-05-03_11-02-08,fp7d
2020-05-19,NE,10,13,3,10,2022-05-03_11-02-08,fp7d
2020-05-19,NW,6,6,0,6,2022-05-03_11-02-08,fp7d
2020-05-19,OW,0,0,0,0,2022-05-03_11-02-08,fp7d
2020-05-19,SG,54,55,1,54,2022-05-03_11-02-08,fp7d
2020-05-19,SH,8,8,0,8,2022-05-03_11-02-08,fp7d
2020-05-19,SO,17,18,1,17,2022-05-03_11-02-08,fp7d
2020-05-19,SZ,12,11,0,11,2022-05-03_11-02-08,fp7d
2020-05-19,TG,21,38,17,21,2022-05-03_11-02-08,fp7d
2020-05-19,TI,38,45,13,32,2022-05-03_11-02-08,fp7d
2020-05-19,UR,6,6,0,6,2022-05-03_11-02-08,fp7d
2020-05-19,VD,79,102,23,79,2022-05-03_11-02-08,fp7d
2020-05-19,VS,21,31,10,21,2022-05-03_11-02-08,fp7d
2020-05-19,ZG,8,10,2,8,2022-05-03_11-02-08,fp7d
2020-05-19,ZH,192,329,138,191,2022-05-03_11-02-08,fp7d
2020-05-20,AG,52,52,0,52,2022-05-03_11-02-08,fp7d
2020-05-20,AI,0,0,0,0,2022-05-03_11-02-08,fp7d
2020-05-20,AR,6,10,4,6,2022-05-03_11-02-08,fp7d
2020-05-20,BE,92,104,12,92,2022-05-03_11-02-08,fp7d
2020-05-20,BL,20,16,0,16,2022-05-03_11-02-08,fp7d
2020-05-20,BS,54,50,0,50,2022-05-03_11-02-08,fp7d
2020-05-20,FR,24,24,0,24,2022-05-03_11-02-08,fp7d
2020-05-20,GE,40,44,4,40,2022-05-03_11-02-08,fp7d
2020-05-20,GL,6,9,3,6,2022-05-03_11-02-08,fp7d
2020-05-20,GR,17,26,9,17,2022-05-03_11-02-08,fp7d
2020-05-20,JU,6,7,1,6,2022-05-03_11-02-08,fp7d
2020-05-20,LU,54,69,19,50,2022-05-03_11-02-08,fp7d
2020-05-20,NE,10,13,3,10,2022-05-03_11-02-08,fp7d
2020-05-20,NW,6,6,0,6,2022-05-03_11-02-08,fp7d
2020-05-20,OW,0,0,0,0,2022-05-03_11-02-08,fp7d
2020-05-20,SG,54,55,1,54,2022-05-03_11-02-08,fp7d
2020-05-20,SH,8,8,0,8,2022-05-03_11-02-08,fp7d
2020-05-20,SO,17,18,1,17,2022-05-03_11-02-08,fp7d
2020-05-20,SZ,12,11,0,11,2022-05-03_11-02-08,fp7d
2020-05-20,TG,21,38,17,21,2022-05-03_11-02-08,fp7d
2020-05-20,TI,38,45,13,32,2022-05-03_11-02-08,fp7d
2020-05-20,UR,6,6,0,6,2022-05-03_11-02-08,fp7d
2020-05-20,VD,79,102,23,79,2022-05-03_11-02-08,fp7d
2020-05-20,VS,21,31,10,21,2022-05-03_11-02-08,fp7d
2020-05-20,ZG,8,10,2,8,2022-05-03_11-02-08,fp7d
2020-05-20,ZH,192,325,134,191,2022-05-03_11-02-08,fp7d
2020-05-21,AG,52,52,0,52,2022-05-03_11-02-08,fp7d
2020-05-21,AI,0,0,0,0,2022-05-03_11-02-08,fp7d
2020-05-21,AR,6,10,4,6,2022-05-03_11-02-08,fp7d
2020-05-21,BE,92,104,12,92,2022-05-03_11-02-08,fp7d
2020-05-21,BL,20,16,0,16,2022-05-03_11-02-08,fp7d
2020-05-21,BS,54,50,0,50,2022-05-03_11-02-08,fp7d
2020-05-21,FR,24,24,0,24,2022-05-03_11-02-08,fp7d
2020-05-21,GE,40,44,4,40,2022-05-03_11-02-08,fp7d
2020-05-21,GL,6,9,3,6,2022-05-03_11-02-08,fp7d
2020-05-21,GR,17,26,9,17,2022-05-03_11-02-08,fp7d
2020-05-21,JU,6,7,1,6,2022-05-03_11-02-08,fp7d
2020-05-21,LU,54,69,19,50,2022-05-03_11-02-08,fp7d
2020-05-21,NE,10,13,3,10,2022-05-03_11-02-08,fp7d
2020-05-21,NW,6,6,0,6,2022-05-03_11-02-08,fp7d
2020-05-21,OW,0,0,0,0,2022-05-03_11-02-08,fp7d
2020-05-21,SG,54,55,1,54,2022-05-03_11-02-08,fp7d
2020-05-21,SH,8,8,0,8,2022-05-03_11-02-08,fp7d
2020-05-21,SO,17,18,1,17,2022-05-03_11-02-08,fp7d
2020-05-21,SZ,12,11,0,11,2022-05-03_11-02-08,fp7d
2020-05-21,TG,21,38,17,21,2022-05-03_11-02-08,fp7d
2020-05-21,TI,38,45,13,32,2022-05-03_11-02-08,fp7d
2020-05-21,UR,6,6,0,6,2022-05-03_11-02-08,fp7d
2020-05-21,VD,79,98,19,79,2022-05-03_11-02-08,fp7d
2020-05-21,VS,21,31,10,21,2022-05-03_11-02-08,fp7d
2020-05-21,ZG,8,10,2,8,2022-05-03_11-02-08,fp7d
2020-05-21,ZH,192,325,134,191,2022-05-03_11-02-08,fp7d
2020-05-22,AG,52,52,0,52,2022-05-03_11-02-08,fp7d
2020-05-22,AI,0,0,0,0,2022-05-03_11-02-08,fp7d
2020-05-22,AR,6,10,4,6,2022-05-03_11-02-08,fp7d
2020-05-22,BE,92,102,12,90,2022-05-03_11-02-08,fp7d
2020-05-22,BL,20,16,0,16,2022-05-03_11-02-08,fp7d
2020-05-22,BS,54,50,0,50,2022-05-03_11-02-08,fp7d
2020-05-22,FR,24,24,0,24,2022-05-03_11-02-08,fp7d
2020-05-22,GE,40,44,4,40,2022-05-03_11-02-08,fp7d
2020-05-22,GL,6,9,3,6,2022-05-03_11-02-08,fp7d
2020-05-22,GR,17,26,9,17,2022-05-03_11-02-08,fp7d
2020-05-22,JU,6,7,1,6,2022-05-03_11-02-08,fp7d
2020-05-22,LU,54,69,19,50,2022-05-03_11-02-08,fp7d
2020-05-22,NE,10,13,3,10,2022-05-03_11-02-08,fp7d
2020-05-22,NW,6,6,0,6,2022-05-03_11-02-08,fp7d
2020-05-22,OW,0,0,0,0,2022-05-03_11-02-08,fp7d
2020-05-22,SG,54,55,1,54,2022-05-03_11-02-08,fp7d
2020-05-22,SH,8,8,0,8,2022-05-03_11-02-08,fp7d
2020-05-22,SO,17,18,1,17,2022-05-03_11-02-08,fp7d
2020-05-22,SZ,12,11,0,11,2022-05-03_11-02-08,fp7d
2020-05-22,TG,21,38,17,21,2022-05-03_11-02-08,fp7d
2020-05-22,TI,38,45,13,32,2022-05-03_11-02-08,fp7d
2020-05-22,UR,6,6,0,6,2022-05-03_11-02-08,fp7d
2020-05-22,VD,79,98,19,79,2022-05-03_11-02-08,fp7d
2020-05-22,VS,21,31,10,21,2022-05-03_11-02-08,fp7d
2020-05-22,ZG,8,10,2,8,2022-05-03_11-02-08,fp7d
2020-05-22,ZH,192,322,133,189,2022-05-03_11-02-08,fp7d
2020-05-23,AG,52,52,0,52,2022-05-03_11-02-08,fp7d
2020-05-23,AI,0,0,0,0,2022-05-03_11-02-08,fp7d
2020-05-23,AR,6,10,4,6,2022-05-03_11-02-08,fp7d
2020-05-23,BE,92,102,12,90,2022-05-03_11-02-08,fp7d
2020-05-23,BL,20,16,0,16,2022-05-03_11-02-08,fp7d
2020-05-23,BS,54,50,0,50,2022-05-03_11-02-08,fp7d
2020-05-23,FR,24,24,0,24,2022-05-03_11-02-08,fp7d
2020-05-23,GE,40,44,4,40,2022-05-03_11-02-08,fp7d
2020-05-23,GL,6,9,3,6,2022-05-03_11-02-08,fp7d
2020-05-23,GR,17,26,9,17,2022-05-03_11-02-08,fp7d
2020-05-23,JU,6,7,1,6,2022-05-03_11-02-08,fp7d
2020-05-23,LU,54,69,19,50,2022-05-03_11-02-08,fp7d
2020-05-23,NE,10,13,3,10,2022-05-03_11-02-08,fp7d
2020-05-23,NW,6,6,0,6,2022-05-03_11-02-08,fp7d
2020-05-23,OW,0,0,0,0,2022-05-03_11-02-08,fp7d
2020-05-23,SG,54,55,1,54,2022-05-03_11-02-08,fp7d
2020-05-23,SH,8,8,0,8,2022-05-03_11-02-08,fp7d
2020-05-23,SO,17,18,1,17,2022-05-03_11-02-08,fp7d
2020-05-23,SZ,12,11,0,11,2022-05-03_11-02-08,fp7d
2020-05-23,TG,21,38,17,21,2022-05-03_11-02-08,fp7d
2020-05-23,TI,38,45,13,32,2022-05-03_11-02-08,fp7d
2020-05-23,UR,6,6,0,6,2022-05-03_11-02-08,fp7d
2020-05-23,VD,79,98,19,79,2022-05-03_11-02-08,fp7d
2020-05-23,VS,21,31,10,21,2022-05-03_11-02-08,fp7d
2020-05-23,ZG,8,10,2,8,2022-05-03_11-02-08,fp7d
2020-05-23,ZH,192,321,133,188,2022-05-03_11-02-08,fp7d
2020-05-24,AG,52,52,0,52,2022-05-03_11-02-08,fp7d
2020-05-24,AI,0,0,0,0,2022-05-03_11-02-08,fp7d
2020-05-24,AR,6,10,4,6,2022-05-03_11-02-08,fp7d
2020-05-24,BE,92,102,12,90,2022-05-03_11-02-08,fp7d
2020-05-24,BL,20,16,0,16,2022-05-03_11-02-08,fp7d
2020-05-24,BS,54,48,0,48,2022-05-03_11-02-08,fp7d
2020-05-24,FR,24,24,0,24,2022-05-03_11-02-08,fp7d
2020-05-24,GE,40,44,4,40,2022-05-03_11-02-08,fp7d
2020-05-24,GL,6,9,3,6,2022-05-03_11-02-08,fp7d
2020-05-24,GR,17,26,9,17,2022-05-03_11-02-08,fp7d
2020-05-24,JU,6,7,1,6,2022-05-03_11-02-08,fp7d
2020-05-24,LU,54,69,19,50,2022-05-03_11-02-08,fp7d
2020-05-24,NE,10,13,3,10,2022-05-03_11-02-08,fp7d
2020-05-24,NW,6,6,0,6,2022-05-03_11-02-08,fp7d
2020-05-24,OW,0,0,0,0,2022-05-03_11-02-08,fp7d
2020-05-24,SG,54,55,1,54,2022-05-03_11-02-08,fp7d
2020-05-24,SH,8,8,0,8,2022-05-03_11-02-08,fp7d
2020-05-24,SO,17,18,1,17,2022-05-03_11-02-08,fp7d
2020-05-24,SZ,12,11,0,11,2022-05-03_11-02-08,fp7d
2020-05-24,TG,21,38,17,21,2022-05-03_11-02-08,fp7d
2020-05-24,TI,38,45,13,32,2022-05-03_11-02-08,fp7d
2020-05-24,UR,6,6,0,6,2022-05-03_11-02-08,fp7d
2020-05-24,VD,79,102,23,79,2022-05-03_11-02-08,fp7d
2020-05-24,VS,21,31,10,21,2022-05-03_11-02-08,fp7d
2020-05-24,ZG,8,10,2,8,2022-05-03_11-02-08,fp7d
2020-05-24,ZH,192,321,133,188,2022-05-03_11-02-08,fp7d
2020-05-25,AG,52,52,0,52,2022-05-03_11-02-08,fp7d
2020-05-25,AI,0,0,0,0,2022-05-03_11-02-08,fp7d
2020-05-25,AR,6,10,4,6,2022-05-03_11-02-08,fp7d
2020-05-25,BE,92,102,12,90,2022-05-03_11-02-08,fp7d
2020-05-25,BL,20,16,0,16,2022-05-03_11-02-08,fp7d
2020-05-25,BS,54,50,0,50,2022-05-03_11-02-08,fp7d
2020-05-25,FR,24,24,0,24,2022-05-03_11-02-08,fp7d
2020-05-25,GE,40,44,4,40,2022-05-03_11-02-08,fp7d
2020-05-25,GL,6,9,3,6,2022-05-03_11-02-08,fp7d
2020-05-25,GR,17,26,9,17,2022-05-03_11-02-08,fp7d
2020-05-25,JU,6,7,1,6,2022-05-03_11-02-08,fp7d
2020-05-25,LU,54,69,19,50,2022-05-03_11-02-08,fp7d
2020-05-25,NE,10,13,3,10,2022-05-03_11-02-08,fp7d
2020-05-25,NW,6,6,0,6,2022-05-03_11-02-08,fp7d
2020-05-25,OW,0,0,0,0,2022-05-03_11-02-08,fp7d
2020-05-25,SG,54,55,1,54,2022-05-03_11-02-08,fp7d
2020-05-25,SH,8,8,0,8,2022-05-03_11-02-08,fp7d
2020-05-25,SO,17,18,1,17,2022-05-03_11-02-08,fp7d
2020-05-25,SZ,12,11,0,11,2022-05-03_11-02-08,fp7d
2020-05-25,TG,21,38,17,21,2022-05-03_11-02-08,fp7d
2020-05-25,TI,55,59,19,40,2022-05-03_11-02-08,fp7d
2020-05-25,UR,6,6,0,6,2022-05-03_11-02-08,fp7d
2020-05-25,VD,79,102,23,79,2022-05-03_11-02-08,fp7d
2020-05-25,VS,21,27,6,21,2022-05-03_11-02-08,fp7d
2020-05-25,ZG,8,10,2,8,2022-05-03_11-02-08,fp7d
2020-05-25,ZH,192,321,133,188,2022-05-03_11-02-08,fp7d
2020-05-26,AG,52,52,0,52,2022-05-03_11-02-08,fp7d
2020-05-26,AI,0,0,0,0,2022-05-03_11-02-08,fp7d
2020-05-26,AR,6,10,4,6,2022-05-03_11-02-08,fp7d
2020-05-26,BE,92,102,12,90,2022-05-03_11-02-08,fp7d
2020-05-26,BL,20,16,0,16,2022-05-03_11-02-08,fp7d
2020-05-26,BS,54,50,0,50,2022-05-03_11-02-08,fp7d
2020-05-26,FR,24,24,0,24,2022-05-03_11-02-08,fp7d
2020-05-26,GE,40,44,4,40,2022-05-03_11-02-08,fp7d
2020-05-26,GL,6,9,3,6,2022-05-03_11-02-08,fp7d
2020-05-26,GR,17,26,9,17,2022-05-03_11-02-08,fp7d
2020-05-26,JU,6,7,1,6,2022-05-03_11-02-08,fp7d
2020-05-26,LU,40,53,17,36,2022-05-03_11-02-08,fp7d
2020-05-26,NE,10,13,3,10,2022-05-03_11-02-08,fp7d
2020-05-26,NW,6,6,0,6,2022-05-03_11-02-08,fp7d
2020-05-26,OW,0,0,0,0,2022-05-03_11-02-08,fp7d
2020-05-26,SG,54,55,1,54,2022-05-03_11-02-08,fp7d
2020-05-26,SH,8,8,0,8,2022-05-03_11-02-08,fp7d
2020-05-26,SO,17,18,1,17,2022-05-03_11-02-08,fp7d
2020-05-26,SZ,12,11,0,11,2022-05-03_11-02-08,fp7d
2020-05-26,TG,21,38,17,21,2022-05-03_11-02-08,fp7d
2020-05-26,TI,55,59,19,40,2022-05-03_11-02-08,fp7d
2020-05-26,UR,6,6,0,6,2022-05-03_11-02-08,fp7d
2020-05-26,VD,79,98,19,79,2022-05-03_11-02-08,fp7d
2020-05-26,VS,21,27,6,21,2022-05-03_11-02-08,fp7d
2020-05-26,ZG,8,10,2,8,2022-05-03_11-02-08,fp7d
2020-05-26,ZH,192,321,133,188,2022-05-03_11-02-08,fp7d
2020-05-27,AG,52,52,0,52,2022-05-03_11-02-08,fp7d
2020-05-27,AI,0,0,0,0,2022-05-03_11-02-08,fp7d
2020-05-27,AR,6,10,4,6,2022-05-03_11-02-08,fp7d
2020-05-27,BE,92,104,12,92,2022-05-03_11-02-08,fp7d
2020-05-27,BL,20,16,0,16,2022-05-03_11-02-08,fp7d
2020-05-27,BS,54,50,0,50,2022-05-03_11-02-08,fp7d
2020-05-27,FR,24,24,0,24,2022-05-03_11-02-08,fp7d
2020-05-27,GE,40,42,2,40,2022-05-03_11-02-08,fp7d
2020-05-27,GL,6,9,3,6,2022-05-03_11-02-08,fp7d
2020-05-27,GR,17,26,9,17,2022-05-03_11-02-08,fp7d
2020-05-27,JU,6,7,1,6,2022-05-03_11-02-08,fp7d
2020-05-27,LU,54,69,19,50,2022-05-03_11-02-08,fp7d
2020-05-27,NE,10,13,3,10,2022-05-03_11-02-08,fp7d
2020-05-27,NW,6,6,0,6,2022-05-03_11-02-08,fp7d
2020-05-27,OW,0,0,0,0,2022-05-03_11-02-08,fp7d
2020-05-27,SG,54,55,1,54,2022-05-03_11-02-08,fp7d
2020-05-27,SH,8,8,0,8,2022-05-03_11-02-08,fp7d
2020-05-27,SO,17,18,1,17,2022-05-03_11-02-08,fp7d
2020-05-27,SZ,12,11,0,11,2022-05-03_11-02-08,fp7d
2020-05-27,TG,21,38,17,21,2022-05-03_11-02-08,fp7d
2020-05-27,TI,55,59,19,40,2022-05-03_11-02-08,fp7d
2020-05-27,UR,6,6,0,6,2022-05-03_11-02-08,fp7d
2020-05-27,VD,79,98,19,79,2022-05-03_11-02-08,fp7d
2020-05-27,VS,21,27,6,21,2022-05-03_11-02-08,fp7d
2020-05-27,ZG,8,10,2,8,2022-05-03_11-02-08,fp7d
2020-05-27,ZH,192,321,133,188,2022-05-03_11-02-08,fp7d
2020-05-28,AG,52,52,0,52,2022-05-03_11-02-08,fp7d
2020-05-28,AI,0,0,0,0,2022-05-03_11-02-08,fp7d
2020-05-28,AR,6,10,4,6,2022-05-03_11-02-08,fp7d
2020-05-28,BE,104,116,12,104,2022-05-03_11-02-08,fp7d
2020-05-28,BL,20,16,0,16,2022-05-03_11-02-08,fp7d
2020-05-28,BS,54,50,0,50,2022-05-03_11-02-08,fp7d
2020-05-28,FR,24,24,0,24,2022-05-03_11-02-08,fp7d
2020-05-28,GE,40,42,2,40,2022-05-03_11-02-08,fp7d
2020-05-28,GL,6,9,3,6,2022-05-03_11-02-08,fp7d
2020-05-28,GR,17,26,9,17,2022-05-03_11-02-08,fp7d
2020-05-28,JU,6,7,1,6,2022-05-03_11-02-08,fp7d
2020-05-28,LU,54,69,19,50,2022-05-03_11-02-08,fp7d
2020-05-28,NE,10,13,3,10,2022-05-03_11-02-08,fp7d
2020-05-28,NW,6,6,0,6,2022-05-03_11-02-08,fp7d
2020-05-28,OW,0,0,0,0,2022-05-03_11-02-08,fp7d
2020-05-28,SG,54,55,1,54,2022-05-03_11-02-08,fp7d
2020-05-28,SH,8,8,0,8,2022-05-03_11-02-08,fp7d
2020-05-28,SO,17,18,1,17,2022-05-03_11-02-08,fp7d
2020-05-28,SZ,12,11,0,11,2022-05-03_11-02-08,fp7d
2020-05-28,TG,21,38,17,21,2022-05-03_11-02-08,fp7d
2020-05-28,TI,55,59,19,40,2022-05-03_11-02-08,fp7d
2020-05-28,UR,6,6,0,6,2022-05-03_11-02-08,fp7d
2020-05-28,VD,79,98,19,79,2022-05-03_11-02-08,fp7d
2020-05-28,VS,21,27,6,21,2022-05-03_11-02-08,fp7d
2020-05-28,ZG,8,10,2,8,2022-05-03_11-02-08,fp7d
2020-05-28,ZH,192,311,121,190,2022-05-03_11-02-08,fp7d
2020-05-29,AG,52,52,0,52,2022-05-03_11-02-08,fp7d
2020-05-29,AI,0,0,0,0,2022-05-03_11-02-08,fp7d
2020-05-29,AR,6,10,4,6,2022-05-03_11-02-08,fp7d
2020-05-29,BE,104,116,12,104,2022-05-03_11-02-08,fp7d
2020-05-29,BL,20,16,0,16,2022-05-03_11-02-08,fp7d
2020-05-29,BS,54,50,0,50,2022-05-03_11-02-08,fp7d
2020-05-29,FR,24,24,0,24,2022-05-03_11-02-08,fp7d
2020-05-29,GE,40,42,2,40,2022-05-03_11-02-08,fp7d
2020-05-29,GL,6,9,3,6,2022-05-03_11-02-08,fp7d
2020-05-29,GR,17,26,9,17,2022-05-03_11-02-08,fp7d
2020-05-29,JU,6,7,1,6,2022-05-03_11-02-08,fp7d
2020-05-29,LU,54,70,19,51,2022-05-03_11-02-08,fp7d
2020-05-29,NE,10,13,3,10,2022-05-03_11-02-08,fp7d
2020-05-29,NW,6,6,0,6,2022-05-03_11-02-08,fp7d
2020-05-29,OW,0,0,0,0,2022-05-03_11-02-08,fp7d
2020-05-29,SG,54,55,1,54,2022-05-03_11-02-08,fp7d
2020-05-29,SH,8,8,0,8,2022-05-03_11-02-08,fp7d
2020-05-29,SO,17,18,1,17,2022-05-03_11-02-08,fp7d
2020-05-29,SZ,12,11,0,11,2022-05-03_11-02-08,fp7d
2020-05-29,TG,21,38,17,21,2022-05-03_11-02-08,fp7d
2020-05-29,TI,55,59,19,40,2022-05-03_11-02-08,fp7d
2020-05-29,UR,6,6,0,6,2022-05-03_11-02-08,fp7d
2020-05-29,VD,79,98,19,79,2022-05-03_11-02-08,fp7d
2020-05-29,VS,21,27,6,21,2022-05-03_11-02-08,fp7d
2020-05-29,ZG,8,10,2,8,2022-05-03_11-02-08,fp7d
2020-05-29,ZH,192,315,125,190,2022-05-03_11-02-08,fp7d
2020-05-30,AG,52,52,0,52,2022-05-03_11-02-08,fp7d
2020-05-30,AI,0,0,0,0,2022-05-03_11-02-08,fp7d
2020-05-30,AR,6,10,4,6,2022-05-03_11-02-08,fp7d
2020-05-30,BE,104,116,12,104,2022-05-03_11-02-08,fp7d
2020-05-30,BL,20,16,0,16,2022-05-03_11-02-08,fp7d
2020-05-30,BS,54,50,0,50,2022-05-03_11-02-08,fp7d
2020-05-30,FR,24,24,0,24,2022-05-03_11-02-08,fp7d
2020-05-30,GE,40,42,2,40,2022-05-03_11-02-08,fp7d
2020-05-30,GL,6,9,3,6,2022-05-03_11-02-08,fp7d
2020-05-30,GR,17,26,9,17,2022-05-03_11-02-08,fp7d
2020-05-30,JU,6,7,1,6,2022-05-03_11-02-08,fp7d
2020-05-30,LU,54,70,19,51,2022-05-03_11-02-08,fp7d
2020-05-30,NE,10,13,3,10,2022-05-03_11-02-08,fp7d
2020-05-30,NW,6,6,0,6,2022-05-03_11-02-08,fp7d
2020-05-30,OW,0,0,0,0,2022-05-03_11-02-08,fp7d
2020-05-30,SG,54,55,1,54,2022-05-03_11-02-08,fp7d
2020-05-30,SH,8,8,0,8,2022-05-03_11-02-08,fp7d
2020-05-30,SO,17,18,1,17,2022-05-03_11-02-08,fp7d
2020-05-30,SZ,12,11,0,11,2022-05-03_11-02-08,fp7d
2020-05-30,TG,21,38,17,21,2022-05-03_11-02-08,fp7d
2020-05-30,TI,55,59,19,40,2022-05-03_11-02-08,fp7d
2020-05-30,UR,6,6,0,6,2022-05-03_11-02-08,fp7d
2020-05-30,VD,79,98,19,79,2022-05-03_11-02-08,fp7d
2020-05-30,VS,21,27,6,21,2022-05-03_11-02-08,fp7d
2020-05-30,ZG,8,10,2,8,2022-05-03_11-02-08,fp7d
2020-05-30,ZH,192,312,125,187,2022-05-03_11-02-08,fp7d
2020-05-31,AG,52,52,0,52,2022-05-03_11-02-08,fp7d
2020-05-31,AI,0,0,0,0,2022-05-03_11-02-08,fp7d
2020-05-31,AR,6,10,4,6,2022-05-03_11-02-08,fp7d
2020-05-31,BE,104,116,12,104,2022-05-03_11-02-08,fp7d
2020-05-31,BL,20,16,0,16,2022-05-03_11-02-08,fp7d
2020-05-31,BS,54,50,0,50,2022-05-03_11-02-08,fp7d
2020-05-31,FR,24,24,0,24,2022-05-03_11-02-08,fp7d
2020-05-31,GE,40,42,2,40,2022-05-03_11-02-08,fp7d
2020-05-31,GL,6,9,3,6,2022-05-03_11-02-08,fp7d
2020-05-31,GR,17,26,9,17,2022-05-03_11-02-08,fp7d
2020-05-31,JU,6,7,1,6,2022-05-03_11-02-08,fp7d
2020-05-31,LU,54,70,19,51,2022-05-03_11-02-08,fp7d
2020-05-31,NE,10,13,3,10,2022-05-03_11-02-08,fp7d
2020-05-31,NW,6,6,0,6,2022-05-03_11-02-08,fp7d
2020-05-31,OW,0,0,0,0,2022-05-03_11-02-08,fp7d
2020-05-31,SG,54,55,1,54,2022-05-03_11-02-08,fp7d
2020-05-31,SH,8,8,0,8,2022-05-03_11-02-08,fp7d
2020-05-31,SO,17,18,1,17,2022-05-03_11-02-08,fp7d
2020-05-31,SZ,12,11,0,11,2022-05-03_11-02-08,fp7d
2020-05-31,TG,21,38,17,21,2022-05-03_11-02-08,fp7d
2020-05-31,TI,55,59,19,40,2022-05-03_11-02-08,fp7d
2020-05-31,UR,6,6,0,6,2022-05-03_11-02-08,fp7d
2020-05-31,VD,79,98,19,79,2022-05-03_11-02-08,fp7d
2020-05-31,VS,21,27,6,21,2022-05-03_11-02-08,fp7d
2020-05-31,ZG,8,10,2,8,2022-05-03_11-02-08,fp7d
2020-05-31,ZH,192,312,125,187,2022-05-03_11-02-08,fp7d
2020-06-01,AG,52,48,0,48,2022-05-03_11-02-08,fp7d
2020-06-01,AI,0,0,0,0,2022-05-03_11-02-08,fp7d
2020-06-01,AR,6,10,4,6,2022-05-03_11-02-08,fp7d
2020-06-01,BE,104,114,12,102,2022-05-03_11-02-08,fp7d
2020-06-01,BL,20,16,0,16,2022-05-03_11-02-08,fp7d
2020-06-01,BS,54,48,0,48,2022-05-03_11-02-08,fp7d
2020-06-01,FR,24,24,0,24,2022-05-03_11-02-08,fp7d
2020-06-01,GE,40,42,2,40,2022-05-03_11-02-08,fp7d
2020-06-01,GL,6,9,3,6,2022-05-03_11-02-08,fp7d
2020-06-01,GR,17,26,9,17,2022-05-03_11-02-08,fp7d
2020-06-01,JU,6,7,1,6,2022-05-03_11-02-08,fp7d
2020-06-01,LU,54,69,19,50,2022-05-03_11-02-08,fp7d
2020-06-01,NE,10,13,3,10,2022-05-03_11-02-08,fp7d
2020-06-01,NW,6,6,0,6,2022-05-03_11-02-08,fp7d
2020-06-01,OW,0,0,0,0,2022-05-03_11-02-08,fp7d
2020-06-01,SG,54,55,1,54,2022-05-03_11-02-08,fp7d
2020-06-01,SH,8,8,0,8,2022-05-03_11-02-08,fp7d
2020-06-01,SO,17,18,1,17,2022-05-03_11-02-08,fp7d
2020-06-01,SZ,12,11,0,11,2022-05-03_11-02-08,fp7d
2020-06-01,TG,21,38,17,21,2022-05-03_11-02-08,fp7d
2020-06-01,TI,38,45,13,32,2022-05-03_11-02-08,fp7d
2020-06-01,UR,6,6,0,6,2022-05-03_11-02-08,fp7d
2020-06-01,VD,79,98,19,79,2022-05-03_11-02-08,fp7d
2020-06-01,VS,21,27,6,21,2022-05-03_11-02-08,fp7d
2020-06-01,ZG,8,10,2,8,2022-05-03_11-02-08,fp7d
2020-06-01,ZH,192,314,125,189,2022-05-03_11-02-08,fp7d
2020-06-02,AG,52,48,0,48,2022-05-03_11-02-08,fp7d
2020-06-02,AI,0,0,0,0,2022-05-03_11-02-08,fp7d
2020-06-02,AR,6,10,4,6,2022-05-03_11-02-08,fp7d
2020-06-02,BE,104,116,12,104,2022-05-03_11-02-08,fp7d
2020-06-02,BL,20,16,0,16,2022-05-03_11-02-08,fp7d
2020-06-02,BS,54,48,0,48,2022-05-03_11-02-08,fp7d
2020-06-02,FR,24,24,0,24,2022-05-03_11-02-08,fp7d
2020-06-02,GE,40,42,2,40,2022-05-03_11-02-08,fp7d
2020-06-02,GL,6,9,3,6,2022-05-03_11-02-08,fp7d
2020-06-02,GR,17,26,9,17,2022-05-03_11-02-08,fp7d
2020-06-02,JU,6,7,1,6,2022-05-03_11-02-08,fp7d
2020-06-02,LU,54,69,19,50,2022-05-03_11-02-08,fp7d
2020-06-02,NE,10,13,3,10,2022-05-03_11-02-08,fp7d
2020-06-02,NW,6,6,0,6,2022-05-03_11-02-08,fp7d
2020-06-02,OW,0,0,0,0,2022-05-03_11-02-08,fp7d
2020-06-02,SG,54,55,1,54,2022-05-03_11-02-08,fp7d
2020-06-02,SH,8,8,0,8,2022-05-03_11-02-08,fp7d
2020-06-02,SO,17,18,1,17,2022-05-03_11-02-08,fp7d
2020-06-02,SZ,12,11,0,11,2022-05-03_11-02-08,fp7d
2020-06-02,TG,21,38,17,21,2022-05-03_11-02-08,fp7d
2020-06-02,TI,38,45,13,32,2022-05-03_11-02-08,fp7d
2020-06-02,UR,6,6,0,6,2022-05-03_11-02-08,fp7d
2020-06-02,VD,79,93,14,79,2022-05-03_11-02-08,fp7d
2020-06-02,VS,21,27,6,21,2022-05-03_11-02-08,fp7d
2020-06-02,ZG,8,10,2,8,2022-05-03_11-02-08,fp7d
2020-06-02,ZH,192,314,125,189,2022-05-03_11-02-08,fp7d
2020-06-03,AG,52,48,0,48,2022-05-03_11-02-08,fp7d
2020-06-03,AI,0,0,0,0,2022-05-03_11-02-08,fp7d
2020-06-03,AR,6,10,4,6,2022-05-03_11-02-08,fp7d
2020-06-03,BE,104,116,12,104,2022-05-03_11-02-08,fp7d
2020-06-03,BL,20,16,0,16,2022-05-03_11-02-08,fp7d
2020-06-03,BS,54,48,0,48,2022-05-03_11-02-08,fp7d
2020-06-03,FR,24,24,0,24,2022-05-03_11-02-08,fp7d
2020-06-03,GE,40,42,2,40,2022-05-03_11-02-08,fp7d
2020-06-03,GL,6,9,3,6,2022-05-03_11-02-08,fp7d
2020-06-03,GR,17,26,9,17,2022-05-03_11-02-08,fp7d
2020-06-03,JU,6,7,1,6,2022-05-03_11-02-08,fp7d
2020-06-03,LU,54,69,19,50,2022-05-03_11-02-08,fp7d
2020-06-03,NE,10,13,3,10,2022-05-03_11-02-08,fp7d
2020-06-03,NW,6,6,0,6,2022-05-03_11-02-08,fp7d
2020-06-03,OW,0,0,0,0,2022-05-03_11-02-08,fp7d
2020-06-03,SG,54,55,1,54,2022-05-03_11-02-08,fp7d
2020-06-03,SH,8,8,0,8,2022-05-03_11-02-08,fp7d
2020-06-03,SO,17,18,1,17,2022-05-03_11-02-08,fp7d
2020-06-03,SZ,12,11,0,11,2022-05-03_11-02-08,fp7d
2020-06-03,TG,21,38,17,21,2022-05-03_11-02-08,fp7d
2020-06-03,TI,38,45,13,32,2022-05-03_11-02-08,fp7d
2020-06-03,UR,6,6,0,6,2022-05-03_11-02-08,fp7d
2020-06-03,VD,79,93,14,79,2022-05-03_11-02-08,fp7d
2020-06-03,VS,21,27,6,21,2022-05-03_11-02-08,fp7d
2020-06-03,ZG,8,10,2,8,2022-05-03_11-02-08,fp7d
2020-06-03,ZH,192,322,133,189,2022-05-03_11-02-08,fp7d
2020-06-04,AG,52,48,0,48,2022-05-03_11-02-08,fp7d
2020-06-04,AI,0,0,0,0,2022-05-03_11-02-08,fp7d
2020-06-04,AR,6,10,4,6,2022-05-03_11-02-08,fp7d
2020-06-04,BE,104,116,12,104,2022-05-03_11-02-08,fp7d
2020-06-04,BL,20,16,0,16,2022-05-03_11-02-08,fp7d
2020-06-04,BS,54,48,0,48,2022-05-03_11-02-08,fp7d
2020-06-04,FR,24,24,0,24,2022-05-03_11-02-08,fp7d
2020-06-04,GE,40,42,2,40,2022-05-03_11-02-08,fp7d
2020-06-04,GL,6,9,3,6,2022-05-03_11-02-08,fp7d
2020-06-04,GR,17,20,3,17,2022-05-03_11-02-08,fp7d
2020-06-04,JU,6,7,1,6,2022-05-03_11-02-08,fp7d
2020-06-04,LU,54,69,19,50,2022-05-03_11-02-08,fp7d
2020-06-04,NE,10,13,3,10,2022-05-03_11-02-08,fp7d
2020-06-04,NW,6,6,0,6,2022-05-03_11-02-08,fp7d
2020-06-04,OW,0,0,0,0,2022-05-03_11-02-08,fp7d
2020-06-04,SG,54,55,1,54,2022-05-03_11-02-08,fp7d
2020-06-04,SH,8,8,0,8,2022-05-03_11-02-08,fp7d
2020-06-04,SO,17,18,1,17,2022-05-03_11-02-08,fp7d
2020-06-04,SZ,12,11,0,11,2022-05-03_11-02-08,fp7d
2020-06-04,TG,21,38,17,21,2022-05-03_11-02-08,fp7d
2020-06-04,TI,38,45,13,32,2022-05-03_11-02-08,fp7d
2020-06-04,UR,6,6,0,6,2022-05-03_11-02-08,fp7d
2020-06-04,VD,64,70,6,64,2022-05-03_11-02-08,fp7d
2020-06-04,VS,21,27,6,21,2022-05-03_11-02-08,fp7d
2020-06-04,ZG,8,10,2,8,2022-05-03_11-02-08,fp7d
2020-06-04,ZH,192,322,133,189,2022-05-03_11-02-08,fp7d
2020-06-05,AG,52,48,0,48,2022-05-03_11-02-08,fp7d
2020-06-05,AI,0,0,0,0,2022-05-03_11-02-08,fp7d
2020-06-05,AR,6,10,4,6,2022-05-03_11-02-08,fp7d
2020-06-05,BE,104,116,12,104,2022-05-03_11-02-08,fp7d
2020-06-05,BL,20,16,0,16,2022-05-03_11-02-08,fp7d
2020-06-05,BS,54,48,0,48,2022-05-03_11-02-08,fp7d
2020-06-05,FR,24,24,0,24,2022-05-03_11-02-08,fp7d
2020-06-05,GE,40,42,2,40,2022-05-03_11-02-08,fp7d
2020-06-05,GL,NA,NA,NA,NA,2022-05-03_11-02-08,fp7d
2020-06-05,GR,17,20,3,17,2022-05-03_11-02-08,fp7d
2020-06-05,JU,6,7,1,6,2022-05-03_11-02-08,fp7d
2020-06-05,LU,54,69,19,50,2022-05-03_11-02-08,fp7d
2020-06-05,NE,10,13,3,10,2022-05-03_11-02-08,fp7d
2020-06-05,NW,6,6,0,6,2022-05-03_11-02-08,fp7d
2020-06-05,OW,0,0,0,0,2022-05-03_11-02-08,fp7d
2020-06-05,SG,54,55,1,54,2022-05-03_11-02-08,fp7d
2020-06-05,SH,8,8,0,8,2022-05-03_11-02-08,fp7d
2020-06-05,SO,17,18,1,17,2022-05-03_11-02-08,fp7d
2020-06-05,SZ,12,11,0,11,2022-05-03_11-02-08,fp7d
2020-06-05,TG,21,38,17,21,2022-05-03_11-02-08,fp7d
2020-06-05,TI,38,45,13,32,2022-05-03_11-02-08,fp7d
2020-06-05,UR,6,6,0,6,2022-05-03_11-02-08,fp7d
2020-06-05,VD,64,70,6,64,2022-05-03_11-02-08,fp7d
2020-06-05,VS,21,27,6,21,2022-05-03_11-02-08,fp7d
2020-06-05,ZG,8,10,2,8,2022-05-03_11-02-08,fp7d
2020-06-05,ZH,192,322,133,189,2022-05-03_11-02-08,fp7d
2020-06-06,AG,52,48,0,48,2022-05-03_11-02-08,fp7d
2020-06-06,AI,0,0,0,0,2022-05-03_11-02-08,fp7d
2020-06-06,AR,6,10,4,6,2022-05-03_11-02-08,fp7d
2020-06-06,BE,104,116,12,104,2022-05-03_11-02-08,fp7d
2020-06-06,BL,20,16,0,16,2022-05-03_11-02-08,fp7d
2020-06-06,BS,54,48,0,48,2022-05-03_11-02-08,fp7d
2020-06-06,FR,24,24,0,24,2022-05-03_11-02-08,fp7d
2020-06-06,GE,40,42,2,40,2022-05-03_11-02-08,fp7d
2020-06-06,GL,NA,NA,NA,NA,2022-05-03_11-02-08,fp7d
2020-06-06,GR,17,20,3,17,2022-05-03_11-02-08,fp7d
2020-06-06,JU,6,7,1,6,2022-05-03_11-02-08,fp7d
2020-06-06,LU,54,69,19,50,2022-05-03_11-02-08,fp7d
2020-06-06,NE,10,13,3,10,2022-05-03_11-02-08,fp7d
2020-06-06,NW,6,6,0,6,2022-05-03_11-02-08,fp7d
2020-06-06,OW,0,0,0,0,2022-05-03_11-02-08,fp7d
2020-06-06,SG,54,55,1,54,2022-05-03_11-02-08,fp7d
2020-06-06,SH,8,8,0,8,2022-05-03_11-02-08,fp7d
2020-06-06,SO,17,18,1,17,2022-05-03_11-02-08,fp7d
2020-06-06,SZ,12,11,0,11,2022-05-03_11-02-08,fp7d
2020-06-06,TG,21,38,17,21,2022-05-03_11-02-08,fp7d
2020-06-06,TI,38,45,13,32,2022-05-03_11-02-08,fp7d
2020-06-06,UR,6,6,0,6,2022-05-03_11-02-08,fp7d
2020-06-06,VD,64,70,6,64,2022-05-03_11-02-08,fp7d
2020-06-06,VS,21,27,6,21,2022-05-03_11-02-08,fp7d
2020-06-06,ZG,8,10,2,8,2022-05-03_11-02-08,fp7d
2020-06-06,ZH,192,324,133,191,2022-05-03_11-02-08,fp7d
2020-06-07,AG,52,48,0,48,2022-05-03_11-02-08,fp7d
2020-06-07,AI,0,0,0,0,2022-05-03_11-02-08,fp7d
2020-06-07,AR,6,10,4,6,2022-05-03_11-02-08,fp7d
2020-06-07,BE,104,116,12,104,2022-05-03_11-02-08,fp7d
2020-06-07,BL,20,16,0,16,2022-05-03_11-02-08,fp7d
2020-06-07,BS,54,48,0,48,2022-05-03_11-02-08,fp7d
2020-06-07,FR,24,24,0,24,2022-05-03_11-02-08,fp7d
2020-06-07,GE,40,42,2,40,2022-05-03_11-02-08,fp7d
2020-06-07,GL,NA,NA,NA,NA,2022-05-03_11-02-08,fp7d
2020-06-07,GR,17,20,3,17,2022-05-03_11-02-08,fp7d
2020-06-07,JU,6,7,1,6,2022-05-03_11-02-08,fp7d
2020-06-07,LU,54,69,19,50,2022-05-03_11-02-08,fp7d
2020-06-07,NE,10,13,3,10,2022-05-03_11-02-08,fp7d
2020-06-07,NW,6,6,0,6,2022-05-03_11-02-08,fp7d
2020-06-07,OW,0,0,0,0,2022-05-03_11-02-08,fp7d
2020-06-07,SG,54,55,1,54,2022-05-03_11-02-08,fp7d
2020-06-07,SH,8,8,0,8,2022-05-03_11-02-08,fp7d
2020-06-07,SO,17,18,1,17,2022-05-03_11-02-08,fp7d
2020-06-07,SZ,12,11,0,11,2022-05-03_11-02-08,fp7d
2020-06-07,TG,21,38,17,21,2022-05-03_11-02-08,fp7d
2020-06-07,TI,38,45,13,32,2022-05-03_11-02-08,fp7d
2020-06-07,UR,6,6,0,6,2022-05-03_11-02-08,fp7d
2020-06-07,VD,64,70,6,64,2022-05-03_11-02-08,fp7d
2020-06-07,VS,21,27,6,21,2022-05-03_11-02-08,fp7d
2020-06-07,ZG,8,10,2,8,2022-05-03_11-02-08,fp7d
2020-06-07,ZH,192,324,133,191,2022-05-03_11-02-08,fp7d
2020-06-08,AG,52,52,0,52,2022-05-03_11-02-08,fp7d
2020-06-08,AI,0,0,0,0,2022-05-03_11-02-08,fp7d
2020-06-08,AR,6,10,4,6,2022-05-03_11-02-08,fp7d
2020-06-08,BE,104,116,12,104,2022-05-03_11-02-08,fp7d
2020-06-08,BL,20,16,0,16,2022-05-03_11-02-08,fp7d
2020-06-08,BS,54,50,0,50,2022-05-03_11-02-08,fp7d
2020-06-08,FR,24,24,0,24,2022-05-03_11-02-08,fp7d
2020-06-08,GE,40,42,2,40,2022-05-03_11-02-08,fp7d
2020-06-08,GL,NA,NA,NA,NA,2022-05-03_11-02-08,fp7d
2020-06-08,GR,17,20,3,17,2022-05-03_11-02-08,fp7d
2020-06-08,JU,6,7,1,6,2022-05-03_11-02-08,fp7d
2020-06-08,LU,54,69,19,50,2022-05-03_11-02-08,fp7d
2020-06-08,NE,10,13,3,10,2022-05-03_11-02-08,fp7d
2020-06-08,NW,6,6,0,6,2022-05-03_11-02-08,fp7d
2020-06-08,OW,0,0,0,0,2022-05-03_11-02-08,fp7d
2020-06-08,SG,54,55,1,54,2022-05-03_11-02-08,fp7d
2020-06-08,SH,8,8,0,8,2022-05-03_11-02-08,fp7d
2020-06-08,SO,17,18,1,17,2022-05-03_11-02-08,fp7d
2020-06-08,SZ,12,11,0,11,2022-05-03_11-02-08,fp7d
2020-06-08,TG,21,38,17,21,2022-05-03_11-02-08,fp7d
2020-06-08,TI,38,45,13,32,2022-05-03_11-02-08,fp7d
2020-06-08,UR,6,6,0,6,2022-05-03_11-02-08,fp7d
2020-06-08,VD,64,70,6,64,2022-05-03_11-02-08,fp7d
2020-06-08,VS,21,27,6,21,2022-05-03_11-02-08,fp7d
2020-06-08,ZG,8,10,2,8,2022-05-03_11-02-08,fp7d
2020-06-08,ZH,192,324,133,191,2022-05-03_11-02-08,fp7d
2020-06-09,AG,52,52,0,52,2022-05-03_11-02-08,fp7d
2020-06-09,AI,0,0,0,0,2022-05-03_11-02-08,fp7d
2020-06-09,AR,6,10,4,6,2022-05-03_11-02-08,fp7d
2020-06-09,BE,104,116,12,104,2022-05-03_11-02-08,fp7d
2020-06-09,BL,20,16,0,16,2022-05-03_11-02-08,fp7d
2020-06-09,BS,54,50,0,50,2022-05-03_11-02-08,fp7d
2020-06-09,FR,24,24,0,24,2022-05-03_11-02-08,fp7d
2020-06-09,GE,40,42,2,40,2022-05-03_11-02-08,fp7d
2020-06-09,GL,NA,NA,NA,NA,2022-05-03_11-02-08,fp7d
2020-06-09,GR,17,20,3,17,2022-05-03_11-02-08,fp7d
2020-06-09,JU,6,7,1,6,2022-05-03_11-02-08,fp7d
2020-06-09,LU,54,69,19,50,2022-05-03_11-02-08,fp7d
2020-06-09,NE,10,13,3,10,2022-05-03_11-02-08,fp7d
2020-06-09,NW,6,6,0,6,2022-05-03_11-02-08,fp7d
2020-06-09,OW,0,0,0,0,2022-05-03_11-02-08,fp7d
2020-06-09,SG,54,55,1,54,2022-05-03_11-02-08,fp7d
2020-06-09,SH,8,8,0,8,2022-05-03_11-02-08,fp7d
2020-06-09,SO,17,18,1,17,2022-05-03_11-02-08,fp7d
2020-06-09,SZ,12,11,0,11,2022-05-03_11-02-08,fp7d
2020-06-09,TG,21,38,17,21,2022-05-03_11-02-08,fp7d
2020-06-09,TI,38,45,13,32,2022-05-03_11-02-08,fp7d
2020-06-09,UR,6,6,0,6,2022-05-03_11-02-08,fp7d
2020-06-09,VD,64,70,6,64,2022-05-03_11-02-08,fp7d
2020-06-09,VS,21,27,6,21,2022-05-03_11-02-08,fp7d
2020-06-09,ZG,8,10,2,8,2022-05-03_11-02-08,fp7d
2020-06-09,ZH,192,326,135,191,2022-05-03_11-02-08,fp7d
2020-06-10,AG,52,52,0,52,2022-05-03_11-02-08,fp7d
2020-06-10,AI,0,0,0,0,2022-05-03_11-02-08,fp7d
2020-06-10,AR,6,10,4,6,2022-05-03_11-02-08,fp7d
2020-06-10,BE,104,116,12,104,2022-05-03_11-02-08,fp7d
2020-06-10,BL,20,16,0,16,2022-05-03_11-02-08,fp7d
2020-06-10,BS,54,50,0,50,2022-05-03_11-02-08,fp7d
2020-06-10,FR,24,24,0,24,2022-05-03_11-02-08,fp7d
2020-06-10,GE,40,42,2,40,2022-05-03_11-02-08,fp7d
2020-06-10,GL,NA,NA,NA,NA,2022-05-03_11-02-08,fp7d
2020-06-10,GR,17,20,3,17,2022-05-03_11-02-08,fp7d
2020-06-10,JU,6,7,1,6,2022-05-03_11-02-08,fp7d
2020-06-10,LU,54,69,19,50,2022-05-03_11-02-08,fp7d
2020-06-10,NE,10,13,3,10,2022-05-03_11-02-08,fp7d
2020-06-10,NW,6,6,0,6,2022-05-03_11-02-08,fp7d
2020-06-10,OW,0,0,0,0,2022-05-03_11-02-08,fp7d
2020-06-10,SG,54,55,1,54,2022-05-03_11-02-08,fp7d
2020-06-10,SH,8,8,0,8,2022-05-03_11-02-08,fp7d
2020-06-10,SO,17,18,1,17,2022-05-03_11-02-08,fp7d
2020-06-10,SZ,12,12,0,12,2022-05-03_11-02-08,fp7d
2020-06-10,TG,21,38,17,21,2022-05-03_11-02-08,fp7d
2020-06-10,TI,38,45,13,32,2022-05-03_11-02-08,fp7d
2020-06-10,UR,6,6,0,6,2022-05-03_11-02-08,fp7d
2020-06-10,VD,64,75,11,64,2022-05-03_11-02-08,fp7d
2020-06-10,VS,21,27,6,21,2022-05-03_11-02-08,fp7d
2020-06-10,ZG,8,10,2,8,2022-05-03_11-02-08,fp7d
2020-06-10,ZH,192,326,135,191,2022-05-03_11-02-08,fp7d
2020-06-11,AG,52,52,0,52,2022-05-03_11-02-08,fp7d
2020-06-11,AI,0,0,0,0,2022-05-03_11-02-08,fp7d
2020-06-11,AR,6,10,4,6,2022-05-03_11-02-08,fp7d
2020-06-11,BE,104,116,12,104,2022-05-03_11-02-08,fp7d
2020-06-11,BL,20,16,0,16,2022-05-03_11-02-08,fp7d
2020-06-11,BS,46,42,0,42,2022-05-03_11-02-08,fp7d
2020-06-11,FR,24,24,0,24,2022-05-03_11-02-08,fp7d
2020-06-11,GE,40,42,2,40,2022-05-03_11-02-08,fp7d
2020-06-11,GL,NA,NA,NA,NA,2022-05-03_11-02-08,fp7d
2020-06-11,GR,17,20,3,17,2022-05-03_11-02-08,fp7d
2020-06-11,JU,6,6,0,6,2022-05-03_11-02-08,fp7d
2020-06-11,LU,40,53,17,36,2022-05-03_11-02-08,fp7d
2020-06-11,NE,10,13,3,10,2022-05-03_11-02-08,fp7d
2020-06-11,NW,6,6,0,6,2022-05-03_11-02-08,fp7d
2020-06-11,OW,0,0,0,0,2022-05-03_11-02-08,fp7d
2020-06-11,SG,54,55,1,54,2022-05-03_11-02-08,fp7d
2020-06-11,SH,8,8,0,8,2022-05-03_11-02-08,fp7d
2020-06-11,SO,17,18,1,17,2022-05-03_11-02-08,fp7d
2020-06-11,SZ,12,11,0,11,2022-05-03_11-02-08,fp7d
2020-06-11,TG,21,38,17,21,2022-05-03_11-02-08,fp7d
2020-06-11,TI,38,45,13,32,2022-05-03_11-02-08,fp7d
2020-06-11,UR,6,6,0,6,2022-05-03_11-02-08,fp7d
2020-06-11,VD,64,70,6,64,2022-05-03_11-02-08,fp7d
2020-06-11,VS,21,27,6,21,2022-05-03_11-02-08,fp7d
2020-06-11,ZG,8,10,2,8,2022-05-03_11-02-08,fp7d
2020-06-11,ZH,192,324,135,189,2022-05-03_11-02-08,fp7d
2020-06-12,AG,52,52,0,52,2022-05-03_11-02-08,fp7d
2020-06-12,AI,0,0,0,0,2022-05-03_11-02-08,fp7d
2020-06-12,AR,6,10,4,6,2022-05-03_11-02-08,fp7d
2020-06-12,BE,104,116,12,104,2022-05-03_11-02-08,fp7d
2020-06-12,BL,20,16,0,16,2022-05-03_11-02-08,fp7d
2020-06-12,BS,46,42,0,42,2022-05-03_11-02-08,fp7d
2020-06-12,FR,24,24,0,24,2022-05-03_11-02-08,fp7d
2020-06-12,GE,40,42,2,40,2022-05-03_11-02-08,fp7d
2020-06-12,GL,NA,NA,NA,NA,2022-05-03_11-02-08,fp7d
2020-06-12,GR,17,20,3,17,2022-05-03_11-02-08,fp7d
2020-06-12,JU,6,6,0,6,2022-05-03_11-02-08,fp7d
2020-06-12,LU,40,53,17,36,2022-05-03_11-02-08,fp7d
2020-06-12,NE,10,13,3,10,2022-05-03_11-02-08,fp7d
2020-06-12,NW,6,6,0,6,2022-05-03_11-02-08,fp7d
2020-06-12,OW,0,0,0,0,2022-05-03_11-02-08,fp7d
2020-06-12,SG,54,55,1,54,2022-05-03_11-02-08,fp7d
2020-06-12,SH,8,8,0,8,2022-05-03_11-02-08,fp7d
2020-06-12,SO,17,18,1,17,2022-05-03_11-02-08,fp7d
2020-06-12,SZ,12,11,0,11,2022-05-03_11-02-08,fp7d
2020-06-12,TG,21,38,17,21,2022-05-03_11-02-08,fp7d
2020-06-12,TI,38,45,13,32,2022-05-03_11-02-08,fp7d
2020-06-12,UR,6,6,0,6,2022-05-03_11-02-08,fp7d
2020-06-12,VD,64,71,7,64,2022-05-03_11-02-08,fp7d
2020-06-12,VS,21,27,6,21,2022-05-03_11-02-08,fp7d
2020-06-12,ZG,8,10,2,8,2022-05-03_11-02-08,fp7d
2020-06-12,ZH,192,324,135,189,2022-05-03_11-02-08,fp7d
2020-06-13,AG,52,52,0,52,2022-05-03_11-02-08,fp7d
2020-06-13,AI,0,0,0,0,2022-05-03_11-02-08,fp7d
2020-06-13,AR,6,10,4,6,2022-05-03_11-02-08,fp7d
2020-06-13,BE,104,116,12,104,2022-05-03_11-02-08,fp7d
2020-06-13,BL,20,16,0,16,2022-05-03_11-02-08,fp7d
2020-06-13,BS,46,42,0,42,2022-05-03_11-02-08,fp7d
2020-06-13,FR,24,24,0,24,2022-05-03_11-02-08,fp7d
2020-06-13,GE,40,42,2,40,2022-05-03_11-02-08,fp7d
2020-06-13,GL,NA,NA,NA,NA,2022-05-03_11-02-08,fp7d
2020-06-13,GR,17,20,3,17,2022-05-03_11-02-08,fp7d
2020-06-13,JU,6,6,0,6,2022-05-03_11-02-08,fp7d
2020-06-13,LU,40,53,17,36,2022-05-03_11-02-08,fp7d
2020-06-13,NE,10,13,3,10,2022-05-03_11-02-08,fp7d
2020-06-13,NW,6,6,0,6,2022-05-03_11-02-08,fp7d
2020-06-13,OW,0,0,0,0,2022-05-03_11-02-08,fp7d
2020-06-13,SG,54,55,1,54,2022-05-03_11-02-08,fp7d
2020-06-13,SH,8,8,0,8,2022-05-03_11-02-08,fp7d
2020-06-13,SO,17,18,1,17,2022-05-03_11-02-08,fp7d
2020-06-13,SZ,12,11,0,11,2022-05-03_11-02-08,fp7d
2020-06-13,TG,21,38,17,21,2022-05-03_11-02-08,fp7d
2020-06-13,TI,38,45,13,32,2022-05-03_11-02-08,fp7d
2020-06-13,UR,6,6,0,6,2022-05-03_11-02-08,fp7d
2020-06-13,VD,64,71,7,64,2022-05-03_11-02-08,fp7d
2020-06-13,VS,21,27,6,21,2022-05-03_11-02-08,fp7d
2020-06-13,ZG,8,10,2,8,2022-05-03_11-02-08,fp7d
2020-06-13,ZH,192,324,135,189,2022-05-03_11-02-08,fp7d
2020-06-14,AG,52,52,0,52,2022-05-03_11-02-08,fp7d
2020-06-14,AI,0,0,0,0,2022-05-03_11-02-08,fp7d
2020-06-14,AR,6,10,4,6,2022-05-03_11-02-08,fp7d
2020-06-14,BE,104,116,12,104,2022-05-03_11-02-08,fp7d
2020-06-14,BL,20,16,0,16,2022-05-03_11-02-08,fp7d
2020-06-14,BS,46,42,0,42,2022-05-03_11-02-08,fp7d
2020-06-14,FR,24,24,0,24,2022-05-03_11-02-08,fp7d
2020-06-14,GE,40,42,2,40,2022-05-03_11-02-08,fp7d
2020-06-14,GL,NA,NA,NA,NA,2022-05-03_11-02-08,fp7d
2020-06-14,GR,17,20,3,17,2022-05-03_11-02-08,fp7d
2020-06-14,JU,6,6,0,6,2022-05-03_11-02-08,fp7d
2020-06-14,LU,40,53,17,36,2022-05-03_11-02-08,fp7d
2020-06-14,NE,10,13,3,10,2022-05-03_11-02-08,fp7d
2020-06-14,NW,6,6,0,6,2022-05-03_11-02-08,fp7d
2020-06-14,OW,0,0,0,0,2022-05-03_11-02-08,fp7d
2020-06-14,SG,54,55,1,54,2022-05-03_11-02-08,fp7d
2020-06-14,SH,8,8,0,8,2022-05-03_11-02-08,fp7d
2020-06-14,SO,17,18,1,17,2022-05-03_11-02-08,fp7d
2020-06-14,SZ,12,11,0,11,2022-05-03_11-02-08,fp7d
2020-06-14,TG,21,38,17,21,2022-05-03_11-02-08,fp7d
2020-06-14,TI,38,45,13,32,2022-05-03_11-02-08,fp7d
2020-06-14,UR,6,6,0,6,2022-05-03_11-02-08,fp7d
2020-06-14,VD,64,71,7,64,2022-05-03_11-02-08,fp7d
2020-06-14,VS,21,27,6,21,2022-05-03_11-02-08,fp7d
2020-06-14,ZG,8,10,2,8,2022-05-03_11-02-08,fp7d
2020-06-14,ZH,192,324,135,189,2022-05-03_11-02-08,fp7d
2020-06-15,AG,52,52,0,52,2022-05-03_11-02-08,fp7d
2020-06-15,AI,0,0,0,0,2022-05-03_11-02-08,fp7d
2020-06-15,AR,6,10,4,6,2022-05-03_11-02-08,fp7d
2020-06-15,BE,104,116,12,104,2022-05-03_11-02-08,fp7d
2020-06-15,BL,20,16,0,16,2022-05-03_11-02-08,fp7d
2020-06-15,BS,46,42,0,42,2022-05-03_11-02-08,fp7d
2020-06-15,FR,24,24,0,24,2022-05-03_11-02-08,fp7d
2020-06-15,GE,40,42,2,40,2022-05-03_11-02-08,fp7d
2020-06-15,GL,NA,NA,NA,NA,2022-05-03_11-02-08,fp7d
2020-06-15,GR,17,20,3,17,2022-05-03_11-02-08,fp7d
2020-06-15,JU,6,6,0,6,2022-05-03_11-02-08,fp7d
2020-06-15,LU,40,49,17,32,2022-05-03_11-02-08,fp7d
2020-06-15,NE,10,13,3,10,2022-05-03_11-02-08,fp7d
2020-06-15,NW,6,6,0,6,2022-05-03_11-02-08,fp7d
2020-06-15,OW,0,0,0,0,2022-05-03_11-02-08,fp7d
2020-06-15,SG,48,49,1,48,2022-05-03_11-02-08,fp7d
2020-06-15,SH,8,8,0,8,2022-05-03_11-02-08,fp7d
2020-06-15,SO,17,18,1,17,2022-05-03_11-02-08,fp7d
2020-06-15,SZ,12,11,0,11,2022-05-03_11-02-08,fp7d
2020-06-15,TG,21,38,17,21,2022-05-03_11-02-08,fp7d
2020-06-15,TI,38,50,13,37,2022-05-03_11-02-08,fp7d
2020-06-15,UR,6,6,0,6,2022-05-03_11-02-08,fp7d
2020-06-15,VD,64,71,7,64,2022-05-03_11-02-08,fp7d
2020-06-15,VS,21,27,6,21,2022-05-03_11-02-08,fp7d
2020-06-15,ZG,8,10,2,8,2022-05-03_11-02-08,fp7d
2020-06-15,ZH,192,324,135,189,2022-05-03_11-02-08,fp7d
2020-06-16,AG,52,52,0,52,2022-05-03_11-02-08,fp7d
2020-06-16,AI,0,0,0,0,2022-05-03_11-02-08,fp7d
2020-06-16,AR,6,10,4,6,2022-05-03_11-02-08,fp7d
2020-06-16,BE,104,116,12,104,2022-05-03_11-02-08,fp7d
2020-06-16,BL,20,16,0,16,2022-05-03_11-02-08,fp7d
2020-06-16,BS,46,42,0,42,2022-05-03_11-02-08,fp7d
2020-06-16,FR,24,24,0,24,2022-05-03_11-02-08,fp7d
2020-06-16,GE,40,42,2,40,2022-05-03_11-02-08,fp7d
2020-06-16,GL,NA,NA,NA,NA,2022-05-03_11-02-08,fp7d
2020-06-16,GR,17,20,3,17,2022-05-03_11-02-08,fp7d
2020-06-16,JU,6,6,0,6,2022-05-03_11-02-08,fp7d
2020-06-16,LU,40,49,17,32,2022-05-03_11-02-08,fp7d
2020-06-16,NE,10,10,0,10,2022-05-03_11-02-08,fp7d
2020-06-16,NW,6,6,0,6,2022-05-03_11-02-08,fp7d
2020-06-16,OW,0,0,0,0,2022-05-03_11-02-08,fp7d
2020-06-16,SG,48,49,1,48,2022-05-03_11-02-08,fp7d
2020-06-16,SH,8,8,0,8,2022-05-03_11-02-08,fp7d
2020-06-16,SO,17,18,1,17,2022-05-03_11-02-08,fp7d
2020-06-16,SZ,12,11,0,11,2022-05-03_11-02-08,fp7d
2020-06-16,TG,21,38,17,21,2022-05-03_11-02-08,fp7d
2020-06-16,TI,38,50,13,37,2022-05-03_11-02-08,fp7d
2020-06-16,UR,6,6,0,6,2022-05-03_11-02-08,fp7d
2020-06-16,VD,64,71,7,64,2022-05-03_11-02-08,fp7d
2020-06-16,VS,21,27,6,21,2022-05-03_11-02-08,fp7d
2020-06-16,ZG,8,10,2,8,2022-05-03_11-02-08,fp7d
2020-06-16,ZH,192,323,135,188,2022-05-03_11-02-08,fp7d
2020-06-17,AG,52,52,0,52,2022-05-03_11-02-08,fp7d
2020-06-17,AI,0,0,0,0,2022-05-03_11-02-08,fp7d
2020-06-17,AR,6,10,4,6,2022-05-03_11-02-08,fp7d
2020-06-17,BE,104,116,12,104,2022-05-03_11-02-08,fp7d
2020-06-17,BL,20,16,0,16,2022-05-03_11-02-08,fp7d
2020-06-17,BS,46,42,0,42,2022-05-03_11-02-08,fp7d
2020-06-17,FR,24,24,0,24,2022-05-03_11-02-08,fp7d
2020-06-17,GE,40,42,2,40,2022-05-03_11-02-08,fp7d
2020-06-17,GL,NA,NA,NA,NA,2022-05-03_11-02-08,fp7d
2020-06-17,GR,17,20,3,17,2022-05-03_11-02-08,fp7d
2020-06-17,JU,6,6,0,6,2022-05-03_11-02-08,fp7d
2020-06-17,LU,40,49,17,32,2022-05-03_11-02-08,fp7d
2020-06-17,NE,10,10,0,10,2022-05-03_11-02-08,fp7d
2020-06-17,NW,6,6,0,6,2022-05-03_11-02-08,fp7d
2020-06-17,OW,0,0,0,0,2022-05-03_11-02-08,fp7d
2020-06-17,SG,48,49,1,48,2022-05-03_11-02-08,fp7d
2020-06-17,SH,8,8,0,8,2022-05-03_11-02-08,fp7d
2020-06-17,SO,17,18,1,17,2022-05-03_11-02-08,fp7d
2020-06-17,SZ,12,11,0,11,2022-05-03_11-02-08,fp7d
2020-06-17,TG,21,38,17,21,2022-05-03_11-02-08,fp7d
2020-06-17,TI,38,50,13,37,2022-05-03_11-02-08,fp7d
2020-06-17,UR,6,6,0,6,2022-05-03_11-02-08,fp7d
2020-06-17,VD,64,71,7,64,2022-05-03_11-02-08,fp7d
2020-06-17,VS,21,27,6,21,2022-05-03_11-02-08,fp7d
2020-06-17,ZG,8,10,2,8,2022-05-03_11-02-08,fp7d
2020-06-17,ZH,192,323,135,188,2022-05-03_11-02-08,fp7d
2020-06-18,AG,52,52,0,52,2022-05-03_11-02-08,fp7d
2020-06-18,AI,0,0,0,0,2022-05-03_11-02-08,fp7d
2020-06-18,AR,6,10,4,6,2022-05-03_11-02-08,fp7d
2020-06-18,BE,92,104,12,92,2022-05-03_11-02-08,fp7d
2020-06-18,BL,20,16,0,16,2022-05-03_11-02-08,fp7d
2020-06-18,BS,54,50,0,50,2022-05-03_11-02-08,fp7d
2020-06-18,FR,24,24,0,24,2022-05-03_11-02-08,fp7d
2020-06-18,GE,40,42,2,40,2022-05-03_11-02-08,fp7d
2020-06-18,GL,NA,NA,NA,NA,2022-05-03_11-02-08,fp7d
2020-06-18,GR,17,20,3,17,2022-05-03_11-02-08,fp7d
2020-06-18,JU,6,6,0,6,2022-05-03_11-02-08,fp7d
2020-06-18,LU,40,40,5,35,2022-05-03_11-02-08,fp7d
2020-06-18,NE,10,10,0,10,2022-05-03_11-02-08,fp7d
2020-06-18,NW,6,6,0,6,2022-05-03_11-02-08,fp7d
2020-06-18,OW,0,0,0,0,2022-05-03_11-02-08,fp7d
2020-06-18,SG,48,49,1,48,2022-05-03_11-02-08,fp7d
2020-06-18,SH,8,8,0,8,2022-05-03_11-02-08,fp7d
2020-06-18,SO,17,18,1,17,2022-05-03_11-02-08,fp7d
2020-06-18,SZ,12,11,0,11,2022-05-03_11-02-08,fp7d
2020-06-18,TG,21,38,17,21,2022-05-03_11-02-08,fp7d
2020-06-18,TI,38,50,13,37,2022-05-03_11-02-08,fp7d
2020-06-18,UR,6,6,0,6,2022-05-03_11-02-08,fp7d
2020-06-18,VD,64,71,7,64,2022-05-03_11-02-08,fp7d
2020-06-18,VS,21,27,6,21,2022-05-03_11-02-08,fp7d
2020-06-18,ZG,8,8,0,8,2022-05-03_11-02-08,fp7d
2020-06-18,ZH,192,323,135,188,2022-05-03_11-02-08,fp7d
2020-06-19,AG,52,52,0,52,2022-05-03_11-02-08,fp7d
2020-06-19,AI,0,0,0,0,2022-05-03_11-02-08,fp7d
2020-06-19,AR,6,10,4,6,2022-05-03_11-02-08,fp7d
2020-06-19,BE,92,104,12,92,2022-05-03_11-02-08,fp7d
2020-06-19,BL,20,16,0,16,2022-05-03_11-02-08,fp7d
2020-06-19,BS,54,50,0,50,2022-05-03_11-02-08,fp7d
2020-06-19,FR,24,24,0,24,2022-05-03_11-02-08,fp7d
2020-06-19,GE,40,42,2,40,2022-05-03_11-02-08,fp7d
2020-06-19,GL,NA,NA,NA,NA,2022-05-03_11-02-08,fp7d
2020-06-19,GR,17,20,3,17,2022-05-03_11-02-08,fp7d
2020-06-19,JU,6,6,0,6,2022-05-03_11-02-08,fp7d
2020-06-19,LU,40,40,5,35,2022-05-03_11-02-08,fp7d
2020-06-19,NE,10,10,0,10,2022-05-03_11-02-08,fp7d
2020-06-19,NW,6,6,0,6,2022-05-03_11-02-08,fp7d
2020-06-19,OW,0,0,0,0,2022-05-03_11-02-08,fp7d
2020-06-19,SG,48,49,1,48,2022-05-03_11-02-08,fp7d
2020-06-19,SH,8,8,0,8,2022-05-03_11-02-08,fp7d
2020-06-19,SO,17,18,1,17,2022-05-03_11-02-08,fp7d
2020-06-19,SZ,12,11,0,11,2022-05-03_11-02-08,fp7d
2020-06-19,TG,21,38,17,21,2022-05-03_11-02-08,fp7d
2020-06-19,TI,38,50,13,37,2022-05-03_11-02-08,fp7d
2020-06-19,UR,6,6,0,6,2022-05-03_11-02-08,fp7d
2020-06-19,VD,64,71,7,64,2022-05-03_11-02-08,fp7d
2020-06-19,VS,21,27,6,21,2022-05-03_11-02-08,fp7d
2020-06-19,ZG,8,8,0,8,2022-05-03_11-02-08,fp7d
2020-06-19,ZH,192,314,125,189,2022-05-03_11-02-08,fp7d
2020-06-20,AG,52,52,0,52,2022-05-03_11-02-08,fp7d
2020-06-20,AI,0,0,0,0,2022-05-03_11-02-08,fp7d
2020-06-20,AR,6,10,4,6,2022-05-03_11-02-08,fp7d
2020-06-20,BE,92,104,12,92,2022-05-03_11-02-08,fp7d
2020-06-20,BL,20,16,0,16,2022-05-03_11-02-08,fp7d
2020-06-20,BS,54,50,0,50,2022-05-03_11-02-08,fp7d
2020-06-20,FR,24,24,0,24,2022-05-03_11-02-08,fp7d
2020-06-20,GE,40,42,2,40,2022-05-03_11-02-08,fp7d
2020-06-20,GL,NA,NA,NA,NA,2022-05-03_11-02-08,fp7d
2020-06-20,GR,17,20,3,17,2022-05-03_11-02-08,fp7d
2020-06-20,JU,6,6,0,6,2022-05-03_11-02-08,fp7d
2020-06-20,LU,40,40,5,35,2022-05-03_11-02-08,fp7d
2020-06-20,NE,10,10,0,10,2022-05-03_11-02-08,fp7d
2020-06-20,NW,6,6,0,6,2022-05-03_11-02-08,fp7d
2020-06-20,OW,0,0,0,0,2022-05-03_11-02-08,fp7d
2020-06-20,SG,48,49,1,48,2022-05-03_11-02-08,fp7d
2020-06-20,SH,8,8,0,8,2022-05-03_11-02-08,fp7d
2020-06-20,SO,17,18,1,17,2022-05-03_11-02-08,fp7d
2020-06-20,SZ,12,11,0,11,2022-05-03_11-02-08,fp7d
2020-06-20,TG,21,38,17,21,2022-05-03_11-02-08,fp7d
2020-06-20,TI,38,50,13,37,2022-05-03_11-02-08,fp7d
2020-06-20,UR,6,6,0,6,2022-05-03_11-02-08,fp7d
2020-06-20,VD,64,71,7,64,2022-05-03_11-02-08,fp7d
2020-06-20,VS,21,27,6,21,2022-05-03_11-02-08,fp7d
2020-06-20,ZG,8,8,0,8,2022-05-03_11-02-08,fp7d
2020-06-20,ZH,192,314,125,189,2022-05-03_11-02-08,fp7d
2020-06-21,AG,52,52,0,52,2022-05-03_11-02-08,fp7d
2020-06-21,AI,0,0,0,0,2022-05-03_11-02-08,fp7d
2020-06-21,AR,6,10,4,6,2022-05-03_11-02-08,fp7d
2020-06-21,BE,92,104,12,92,2022-05-03_11-02-08,fp7d
2020-06-21,BL,20,16,0,16,2022-05-03_11-02-08,fp7d
2020-06-21,BS,54,50,0,50,2022-05-03_11-02-08,fp7d
2020-06-21,FR,24,24,0,24,2022-05-03_11-02-08,fp7d
2020-06-21,GE,40,42,2,40,2022-05-03_11-02-08,fp7d
2020-06-21,GL,NA,NA,NA,NA,2022-05-03_11-02-08,fp7d
2020-06-21,GR,17,20,3,17,2022-05-03_11-02-08,fp7d
2020-06-21,JU,6,6,0,6,2022-05-03_11-02-08,fp7d
2020-06-21,LU,40,40,5,35,2022-05-03_11-02-08,fp7d
2020-06-21,NE,10,10,0,10,2022-05-03_11-02-08,fp7d
2020-06-21,NW,6,6,0,6,2022-05-03_11-02-08,fp7d
2020-06-21,OW,0,0,0,0,2022-05-03_11-02-08,fp7d
2020-06-21,SG,48,49,1,48,2022-05-03_11-02-08,fp7d
2020-06-21,SH,8,8,0,8,2022-05-03_11-02-08,fp7d
2020-06-21,SO,17,18,1,17,2022-05-03_11-02-08,fp7d
2020-06-21,SZ,12,11,0,11,2022-05-03_11-02-08,fp7d
2020-06-21,TG,21,38,17,21,2022-05-03_11-02-08,fp7d
2020-06-21,TI,38,50,13,37,2022-05-03_11-02-08,fp7d
2020-06-21,UR,6,6,0,6,2022-05-03_11-02-08,fp7d
2020-06-21,VD,64,71,7,64,2022-05-03_11-02-08,fp7d
2020-06-21,VS,21,27,6,21,2022-05-03_11-02-08,fp7d
2020-06-21,ZG,8,8,0,8,2022-05-03_11-02-08,fp7d
2020-06-21,ZH,192,314,125,189,2022-05-03_11-02-08,fp7d
2020-06-22,AG,52,52,0,52,2022-05-03_11-02-08,fp7d
2020-06-22,AI,0,0,0,0,2022-05-03_11-02-08,fp7d
2020-06-22,AR,6,10,4,6,2022-05-03_11-02-08,fp7d
2020-06-22,BE,92,104,12,92,2022-05-03_11-02-08,fp7d
2020-06-22,BL,20,16,0,16,2022-05-03_11-02-08,fp7d
2020-06-22,BS,54,50,0,50,2022-05-03_11-02-08,fp7d
2020-06-22,FR,24,24,0,24,2022-05-03_11-02-08,fp7d
2020-06-22,GE,40,40,2,38,2022-05-03_11-02-08,fp7d
2020-06-22,GL,NA,NA,NA,NA,2022-05-03_11-02-08,fp7d
2020-06-22,GR,17,20,3,17,2022-05-03_11-02-08,fp7d
2020-06-22,JU,6,6,0,6,2022-05-03_11-02-08,fp7d
2020-06-22,LU,54,55,7,48,2022-05-03_11-02-08,fp7d
2020-06-22,NE,10,10,0,10,2022-05-03_11-02-08,fp7d
2020-06-22,NW,6,6,0,6,2022-05-03_11-02-08,fp7d
2020-06-22,OW,0,0,0,0,2022-05-03_11-02-08,fp7d
2020-06-22,SG,48,49,1,48,2022-05-03_11-02-08,fp7d
2020-06-22,SH,8,8,0,8,2022-05-03_11-02-08,fp7d
2020-06-22,SO,17,18,1,17,2022-05-03_11-02-08,fp7d
2020-06-22,SZ,12,11,0,11,2022-05-03_11-02-08,fp7d
2020-06-22,TG,21,38,17,21,2022-05-03_11-02-08,fp7d
2020-06-22,TI,38,50,13,37,2022-05-03_11-02-08,fp7d
2020-06-22,UR,6,6,0,6,2022-05-03_11-02-08,fp7d
2020-06-22,VD,64,71,7,64,2022-05-03_11-02-08,fp7d
2020-06-22,VS,21,27,6,21,2022-05-03_11-02-08,fp7d
2020-06-22,ZG,8,8,0,8,2022-05-03_11-02-08,fp7d
2020-06-22,ZH,192,314,125,189,2022-05-03_11-02-08,fp7d
2020-06-23,AG,52,52,0,52,2022-05-03_11-02-08,fp7d
2020-06-23,AI,0,0,0,0,2022-05-03_11-02-08,fp7d
2020-06-23,AR,6,10,4,6,2022-05-03_11-02-08,fp7d
2020-06-23,BE,92,104,12,92,2022-05-03_11-02-08,fp7d
2020-06-23,BL,20,16,0,16,2022-05-03_11-02-08,fp7d
2020-06-23,BS,54,50,0,50,2022-05-03_11-02-08,fp7d
2020-06-23,FR,24,24,0,24,2022-05-03_11-02-08,fp7d
2020-06-23,GE,40,40,2,38,2022-05-03_11-02-08,fp7d
2020-06-23,GL,NA,NA,NA,NA,2022-05-03_11-02-08,fp7d
2020-06-23,GR,17,20,3,17,2022-05-03_11-02-08,fp7d
2020-06-23,JU,6,6,0,6,2022-05-03_11-02-08,fp7d
2020-06-23,LU,54,55,7,48,2022-05-03_11-02-08,fp7d
2020-06-23,NE,10,10,0,10,2022-05-03_11-02-08,fp7d
2020-06-23,NW,6,6,0,6,2022-05-03_11-02-08,fp7d
2020-06-23,OW,0,0,0,0,2022-05-03_11-02-08,fp7d
2020-06-23,SG,48,49,1,48,2022-05-03_11-02-08,fp7d
2020-06-23,SH,8,8,0,8,2022-05-03_11-02-08,fp7d
2020-06-23,SO,17,18,1,17,2022-05-03_11-02-08,fp7d
2020-06-23,SZ,12,11,0,11,2022-05-03_11-02-08,fp7d
2020-06-23,TG,21,38,17,21,2022-05-03_11-02-08,fp7d
2020-06-23,TI,38,50,13,37,2022-05-03_11-02-08,fp7d
2020-06-23,UR,6,6,0,6,2022-05-03_11-02-08,fp7d
2020-06-23,VD,64,71,7,64,2022-05-03_11-02-08,fp7d
2020-06-23,VS,21,27,6,21,2022-05-03_11-02-08,fp7d
2020-06-23,ZG,8,8,0,8,2022-05-03_11-02-08,fp7d
2020-06-23,ZH,192,315,125,190,2022-05-03_11-02-08,fp7d
2020-06-24,AG,52,52,0,52,2022-05-03_11-02-08,fp7d
2020-06-24,AI,0,0,0,0,2022-05-03_11-02-08,fp7d
2020-06-24,AR,6,10,4,6,2022-05-03_11-02-08,fp7d
2020-06-24,BE,104,116,12,104,2022-05-03_11-02-08,fp7d
2020-06-24,BL,20,16,0,16,2022-05-03_11-02-08,fp7d
2020-06-24,BS,54,50,0,50,2022-05-03_11-02-08,fp7d
2020-06-24,FR,24,24,0,24,2022-05-03_11-02-08,fp7d
2020-06-24,GE,40,40,2,38,2022-05-03_11-02-08,fp7d
2020-06-24,GL,NA,NA,NA,NA,2022-05-03_11-02-08,fp7d
2020-06-24,GR,17,20,3,17,2022-05-03_11-02-08,fp7d
2020-06-24,JU,6,6,0,6,2022-05-03_11-02-08,fp7d
2020-06-24,LU,54,55,7,48,2022-05-03_11-02-08,fp7d
2020-06-24,NE,10,10,0,10,2022-05-03_11-02-08,fp7d
2020-06-24,NW,6,6,0,6,2022-05-03_11-02-08,fp7d
2020-06-24,OW,0,0,0,0,2022-05-03_11-02-08,fp7d
2020-06-24,SG,48,49,1,48,2022-05-03_11-02-08,fp7d
2020-06-24,SH,8,8,0,8,2022-05-03_11-02-08,fp7d
2020-06-24,SO,17,18,1,17,2022-05-03_11-02-08,fp7d
2020-06-24,SZ,12,11,0,11,2022-05-03_11-02-08,fp7d
2020-06-24,TG,21,38,17,21,2022-05-03_11-02-08,fp7d
2020-06-24,TI,38,50,13,37,2022-05-03_11-02-08,fp7d
2020-06-24,UR,6,6,0,6,2022-05-03_11-02-08,fp7d
2020-06-24,VD,64,71,7,64,2022-05-03_11-02-08,fp7d
2020-06-24,VS,21,27,6,21,2022-05-03_11-02-08,fp7d
2020-06-24,ZG,8,8,0,8,2022-05-03_11-02-08,fp7d
2020-06-24,ZH,192,315,125,190,2022-05-03_11-02-08,fp7d
2020-06-25,AG,52,52,0,52,2022-05-03_11-02-08,fp7d
2020-06-25,AI,0,0,0,0,2022-05-03_11-02-08,fp7d
2020-06-25,AR,6,10,4,6,2022-05-03_11-02-08,fp7d
2020-06-25,BE,104,116,12,104,2022-05-03_11-02-08,fp7d
2020-06-25,BL,20,16,0,16,2022-05-03_11-02-08,fp7d
2020-06-25,BS,54,50,0,50,2022-05-03_11-02-08,fp7d
2020-06-25,FR,24,24,0,24,2022-05-03_11-02-08,fp7d
2020-06-25,GE,40,40,2,38,2022-05-03_11-02-08,fp7d
2020-06-25,GL,NA,NA,NA,NA,2022-05-03_11-02-08,fp7d
2020-06-25,GR,17,20,3,17,2022-05-03_11-02-08,fp7d
2020-06-25,JU,6,6,0,6,2022-05-03_11-02-08,fp7d
2020-06-25,LU,54,55,7,48,2022-05-03_11-02-08,fp7d
2020-06-25,NE,10,10,0,10,2022-05-03_11-02-08,fp7d
2020-06-25,NW,6,6,0,6,2022-05-03_11-02-08,fp7d
2020-06-25,OW,0,0,0,0,2022-05-03_11-02-08,fp7d
2020-06-25,SG,48,49,1,48,2022-05-03_11-02-08,fp7d
2020-06-25,SH,8,8,0,8,2022-05-03_11-02-08,fp7d
2020-06-25,SO,17,18,1,17,2022-05-03_11-02-08,fp7d
2020-06-25,SZ,12,11,0,11,2022-05-03_11-02-08,fp7d
2020-06-25,TG,21,38,17,21,2022-05-03_11-02-08,fp7d
2020-06-25,TI,38,50,13,37,2022-05-03_11-02-08,fp7d
2020-06-25,UR,6,6,0,6,2022-05-03_11-02-08,fp7d
2020-06-25,VD,64,71,7,64,2022-05-03_11-02-08,fp7d
2020-06-25,VS,21,27,6,21,2022-05-03_11-02-08,fp7d
2020-06-25,ZG,8,8,0,8,2022-05-03_11-02-08,fp7d
2020-06-25,ZH,192,315,125,190,2022-05-03_11-02-08,fp7d
2020-06-26,AG,52,52,0,52,2022-05-03_11-02-08,fp7d
2020-06-26,AI,0,0,0,0,2022-05-03_11-02-08,fp7d
2020-06-26,AR,6,10,4,6,2022-05-03_11-02-08,fp7d
2020-06-26,BE,104,116,12,104,2022-05-03_11-02-08,fp7d
2020-06-26,BL,20,16,0,16,2022-05-03_11-02-08,fp7d
2020-06-26,BS,54,50,0,50,2022-05-03_11-02-08,fp7d
2020-06-26,FR,24,24,0,24,2022-05-03_11-02-08,fp7d
2020-06-26,GE,40,40,2,38,2022-05-03_11-02-08,fp7d
2020-06-26,GL,NA,NA,NA,NA,2022-05-03_11-02-08,fp7d
2020-06-26,GR,17,20,3,17,2022-05-03_11-02-08,fp7d
2020-06-26,JU,6,6,0,6,2022-05-03_11-02-08,fp7d
2020-06-26,LU,54,55,7,48,2022-05-03_11-02-08,fp7d
2020-06-26,NE,10,10,0,10,2022-05-03_11-02-08,fp7d
2020-06-26,NW,6,6,0,6,2022-05-03_11-02-08,fp7d
2020-06-26,OW,0,0,0,0,2022-05-03_11-02-08,fp7d
2020-06-26,SG,48,49,1,48,2022-05-03_11-02-08,fp7d
2020-06-26,SH,8,8,0,8,2022-05-03_11-02-08,fp7d
2020-06-26,SO,17,18,1,17,2022-05-03_11-02-08,fp7d
2020-06-26,SZ,12,11,0,11,2022-05-03_11-02-08,fp7d
2020-06-26,TG,21,38,17,21,2022-05-03_11-02-08,fp7d
2020-06-26,TI,38,50,13,37,2022-05-03_11-02-08,fp7d
2020-06-26,UR,6,6,0,6,2022-05-03_11-02-08,fp7d
2020-06-26,VD,64,71,7,64,2022-05-03_11-02-08,fp7d
2020-06-26,VS,21,27,6,21,2022-05-03_11-02-08,fp7d
2020-06-26,ZG,8,8,0,8,2022-05-03_11-02-08,fp7d
2020-06-26,ZH,192,315,125,190,2022-05-03_11-02-08,fp7d
2020-06-27,AG,52,52,0,52,2022-05-03_11-02-08,fp7d
2020-06-27,AI,0,0,0,0,2022-05-03_11-02-08,fp7d
2020-06-27,AR,6,10,4,6,2022-05-03_11-02-08,fp7d
2020-06-27,BE,104,116,12,104,2022-05-03_11-02-08,fp7d
2020-06-27,BL,20,16,0,16,2022-05-03_11-02-08,fp7d
2020-06-27,BS,54,50,0,50,2022-05-03_11-02-08,fp7d
2020-06-27,FR,24,24,0,24,2022-05-03_11-02-08,fp7d
2020-06-27,GE,40,40,2,38,2022-05-03_11-02-08,fp7d
2020-06-27,GL,NA,NA,NA,NA,2022-05-03_11-02-08,fp7d
2020-06-27,GR,17,20,3,17,2022-05-03_11-02-08,fp7d
2020-06-27,JU,6,6,0,6,2022-05-03_11-02-08,fp7d
2020-06-27,LU,54,55,7,48,2022-05-03_11-02-08,fp7d
2020-06-27,NE,10,10,0,10,2022-05-03_11-02-08,fp7d
2020-06-27,NW,6,6,0,6,2022-05-03_11-02-08,fp7d
2020-06-27,OW,0,0,0,0,2022-05-03_11-02-08,fp7d
2020-06-27,SG,48,49,1,48,2022-05-03_11-02-08,fp7d
2020-06-27,SH,8,8,0,8,2022-05-03_11-02-08,fp7d
2020-06-27,SO,17,18,1,17,2022-05-03_11-02-08,fp7d
2020-06-27,SZ,12,11,0,11,2022-05-03_11-02-08,fp7d
2020-06-27,TG,21,38,17,21,2022-05-03_11-02-08,fp7d
2020-06-27,TI,38,50,13,37,2022-05-03_11-02-08,fp7d
2020-06-27,UR,6,6,0,6,2022-05-03_11-02-08,fp7d
2020-06-27,VD,64,71,7,64,2022-05-03_11-02-08,fp7d
2020-06-27,VS,21,27,6,21,2022-05-03_11-02-08,fp7d
2020-06-27,ZG,8,8,0,8,2022-05-03_11-02-08,fp7d
2020-06-27,ZH,192,315,125,190,2022-05-03_11-02-08,fp7d
2020-06-28,AG,52,52,0,52,2022-05-03_11-02-08,fp7d
2020-06-28,AI,0,0,0,0,2022-05-03_11-02-08,fp7d
2020-06-28,AR,6,10,4,6,2022-05-03_11-02-08,fp7d
2020-06-28,BE,104,116,12,104,2022-05-03_11-02-08,fp7d
2020-06-28,BL,20,16,0,16,2022-05-03_11-02-08,fp7d
2020-06-28,BS,54,50,0,50,2022-05-03_11-02-08,fp7d
2020-06-28,FR,24,24,0,24,2022-05-03_11-02-08,fp7d
2020-06-28,GE,40,40,2,38,2022-05-03_11-02-08,fp7d
2020-06-28,GL,NA,NA,NA,NA,2022-05-03_11-02-08,fp7d
2020-06-28,GR,17,20,3,17,2022-05-03_11-02-08,fp7d
2020-06-28,JU,6,6,0,6,2022-05-03_11-02-08,fp7d
2020-06-28,LU,54,55,7,48,2022-05-03_11-02-08,fp7d
2020-06-28,NE,10,10,0,10,2022-05-03_11-02-08,fp7d
2020-06-28,NW,6,6,0,6,2022-05-03_11-02-08,fp7d
2020-06-28,OW,0,0,0,0,2022-05-03_11-02-08,fp7d
2020-06-28,SG,48,49,1,48,2022-05-03_11-02-08,fp7d
2020-06-28,SH,8,8,0,8,2022-05-03_11-02-08,fp7d
2020-06-28,SO,17,18,1,17,2022-05-03_11-02-08,fp7d
2020-06-28,SZ,12,11,0,11,2022-05-03_11-02-08,fp7d
2020-06-28,TG,21,38,17,21,2022-05-03_11-02-08,fp7d
2020-06-28,TI,38,50,13,37,2022-05-03_11-02-08,fp7d
2020-06-28,UR,6,6,0,6,2022-05-03_11-02-08,fp7d
2020-06-28,VD,64,71,7,64,2022-05-03_11-02-08,fp7d
2020-06-28,VS,21,27,6,21,2022-05-03_11-02-08,fp7d
2020-06-28,ZG,8,8,0,8,2022-05-03_11-02-08,fp7d
2020-06-28,ZH,192,315,125,190,2022-05-03_11-02-08,fp7d
2020-06-29,AG,52,52,0,52,2022-05-03_11-02-08,fp7d
2020-06-29,AI,0,0,0,0,2022-05-03_11-02-08,fp7d
2020-06-29,AR,6,10,4,6,2022-05-03_11-02-08,fp7d
2020-06-29,BE,104,116,12,104,2022-05-03_11-02-08,fp7d
2020-06-29,BL,20,16,0,16,2022-05-03_11-02-08,fp7d
2020-06-29,BS,54,48,0,48,2022-05-03_11-02-08,fp7d
2020-06-29,FR,24,24,0,24,2022-05-03_11-02-08,fp7d
2020-06-29,GE,40,40,2,38,2022-05-03_11-02-08,fp7d
2020-06-29,GL,NA,NA,NA,NA,2022-05-03_11-02-08,fp7d
2020-06-29,GR,17,20,3,17,2022-05-03_11-02-08,fp7d
2020-06-29,JU,6,6,0,6,2022-05-03_11-02-08,fp7d
2020-06-29,LU,54,56,7,49,2022-05-03_11-02-08,fp7d
2020-06-29,NE,10,10,0,10,2022-05-03_11-02-08,fp7d
2020-06-29,NW,6,3,0,3,2022-05-03_11-02-08,fp7d
2020-06-29,OW,0,0,0,0,2022-05-03_11-02-08,fp7d
2020-06-29,SG,48,49,1,48,2022-05-03_11-02-08,fp7d
2020-06-29,SH,8,8,0,8,2022-05-03_11-02-08,fp7d
2020-06-29,SO,17,18,1,17,2022-05-03_11-02-08,fp7d
2020-06-29,SZ,12,11,0,11,2022-05-03_11-02-08,fp7d
2020-06-29,TG,21,38,17,21,2022-05-03_11-02-08,fp7d
2020-06-29,TI,38,51,13,38,2022-05-03_11-02-08,fp7d
2020-06-29,UR,6,6,0,6,2022-05-03_11-02-08,fp7d
2020-06-29,VD,64,71,7,64,2022-05-03_11-02-08,fp7d
2020-06-29,VS,21,27,6,21,2022-05-03_11-02-08,fp7d
2020-06-29,ZG,8,8,0,8,2022-05-03_11-02-08,fp7d
2020-06-29,ZH,192,314,125,189,2022-05-03_11-02-08,fp7d
2020-06-30,AG,52,52,0,52,2022-05-03_11-02-08,fp7d
2020-06-30,AI,0,0,0,0,2022-05-03_11-02-08,fp7d
2020-06-30,AR,6,10,4,6,2022-05-03_11-02-08,fp7d
2020-06-30,BE,104,116,12,104,2022-05-03_11-02-08,fp7d
2020-06-30,BL,20,16,0,16,2022-05-03_11-02-08,fp7d
2020-06-30,BS,54,48,0,48,2022-05-03_11-02-08,fp7d
2020-06-30,FR,24,24,0,24,2022-05-03_11-02-08,fp7d
2020-06-30,GE,40,40,2,38,2022-05-03_11-02-08,fp7d
2020-06-30,GL,NA,NA,NA,NA,2022-05-03_11-02-08,fp7d
2020-06-30,GR,17,20,3,17,2022-05-03_11-02-08,fp7d
2020-06-30,JU,6,6,0,6,2022-05-03_11-02-08,fp7d
2020-06-30,LU,54,56,7,49,2022-05-03_11-02-08,fp7d
2020-06-30,NE,10,10,0,10,2022-05-03_11-02-08,fp7d
2020-06-30,NW,6,3,0,3,2022-05-03_11-02-08,fp7d
2020-06-30,OW,0,0,0,0,2022-05-03_11-02-08,fp7d
2020-06-30,SG,48,49,1,48,2022-05-03_11-02-08,fp7d
2020-06-30,SH,8,8,0,8,2022-05-03_11-02-08,fp7d
2020-06-30,SO,17,18,1,17,2022-05-03_11-02-08,fp7d
2020-06-30,SZ,12,11,0,11,2022-05-03_11-02-08,fp7d
2020-06-30,TG,21,38,17,21,2022-05-03_11-02-08,fp7d
2020-06-30,TI,38,51,13,38,2022-05-03_11-02-08,fp7d
2020-06-30,UR,6,6,0,6,2022-05-03_11-02-08,fp7d
2020-06-30,VD,64,71,7,64,2022-05-03_11-02-08,fp7d
2020-06-30,VS,21,27,6,21,2022-05-03_11-02-08,fp7d
2020-06-30,ZG,8,8,0,8,2022-05-03_11-02-08,fp7d
2020-06-30,ZH,192,314,125,189,2022-05-03_11-02-08,fp7d
2020-07-01,AG,52,52,0,52,2022-05-03_11-02-08,fp7d
2020-07-01,AI,0,0,0,0,2022-05-03_11-02-08,fp7d
2020-07-01,AR,6,10,4,6,2022-05-03_11-02-08,fp7d
2020-07-01,BE,104,116,12,104,2022-05-03_11-02-08,fp7d
2020-07-01,BL,20,16,0,16,2022-05-03_11-02-08,fp7d
2020-07-01,BS,54,48,0,48,2022-05-03_11-02-08,fp7d
2020-07-01,FR,24,24,0,24,2022-05-03_11-02-08,fp7d
2020-07-01,GE,40,40,2,38,2022-05-03_11-02-08,fp7d
2020-07-01,GL,NA,NA,NA,NA,2022-05-03_11-02-08,fp7d
2020-07-01,GR,17,20,3,17,2022-05-03_11-02-08,fp7d
2020-07-01,JU,6,6,0,6,2022-05-03_11-02-08,fp7d
2020-07-01,LU,54,56,7,49,2022-05-03_11-02-08,fp7d
2020-07-01,NE,10,10,0,10,2022-05-03_11-02-08,fp7d
2020-07-01,NW,6,3,0,3,2022-05-03_11-02-08,fp7d
2020-07-01,OW,0,0,0,0,2022-05-03_11-02-08,fp7d
2020-07-01,SG,48,49,1,48,2022-05-03_11-02-08,fp7d
2020-07-01,SH,8,8,0,8,2022-05-03_11-02-08,fp7d
2020-07-01,SO,17,18,1,17,2022-05-03_11-02-08,fp7d
2020-07-01,SZ,12,11,0,11,2022-05-03_11-02-08,fp7d
2020-07-01,TG,21,38,17,21,2022-05-03_11-02-08,fp7d
2020-07-01,TI,38,51,13,38,2022-05-03_11-02-08,fp7d
2020-07-01,UR,6,6,0,6,2022-05-03_11-02-08,fp7d
2020-07-01,VD,64,71,7,64,2022-05-03_11-02-08,fp7d
2020-07-01,VS,21,27,6,21,2022-05-03_11-02-08,fp7d
2020-07-01,ZG,8,8,0,8,2022-05-03_11-02-08,fp7d
2020-07-01,ZH,192,314,125,189,2022-05-03_11-02-08,fp7d
2020-07-02,AG,52,52,0,52,2022-05-03_11-02-08,fp7d
2020-07-02,AI,0,0,0,0,2022-05-03_11-02-08,fp7d
2020-07-02,AR,6,10,4,6,2022-05-03_11-02-08,fp7d
2020-07-02,BE,104,116,12,104,2022-05-03_11-02-08,fp7d
2020-07-02,BL,20,16,0,16,2022-05-03_11-02-08,fp7d
2020-07-02,BS,54,50,0,50,2022-05-03_11-02-08,fp7d
2020-07-02,FR,24,24,0,24,2022-05-03_11-02-08,fp7d
2020-07-02,GE,40,40,2,38,2022-05-03_11-02-08,fp7d
2020-07-02,GL,NA,NA,NA,NA,2022-05-03_11-02-08,fp7d
2020-07-02,GR,17,20,3,17,2022-05-03_11-02-08,fp7d
2020-07-02,JU,6,6,0,6,2022-05-03_11-02-08,fp7d
2020-07-02,LU,54,55,7,48,2022-05-03_11-02-08,fp7d
2020-07-02,NE,10,10,0,10,2022-05-03_11-02-08,fp7d
2020-07-02,NW,6,4,0,4,2022-05-03_11-02-08,fp7d
2020-07-02,OW,0,0,0,0,2022-05-03_11-02-08,fp7d
2020-07-02,SG,48,49,1,48,2022-05-03_11-02-08,fp7d
2020-07-02,SH,8,8,0,8,2022-05-03_11-02-08,fp7d
2020-07-02,SO,17,18,1,17,2022-05-03_11-02-08,fp7d
2020-07-02,SZ,12,11,0,11,2022-05-03_11-02-08,fp7d
2020-07-02,TG,21,38,17,21,2022-05-03_11-02-08,fp7d
2020-07-02,TI,47,51,13,38,2022-05-03_11-02-08,fp7d
2020-07-02,UR,6,6,0,6,2022-05-03_11-02-08,fp7d
2020-07-02,VD,64,69,5,64,2022-05-03_11-02-08,fp7d
2020-07-02,VS,21,27,6,21,2022-05-03_11-02-08,fp7d
2020-07-02,ZG,8,8,0,8,2022-05-03_11-02-08,fp7d
2020-07-02,ZH,192,314,125,189,2022-05-03_11-02-08,fp7d
2020-07-03,AG,52,52,0,52,2022-05-03_11-02-08,fp7d
2020-07-03,AI,0,0,0,0,2022-05-03_11-02-08,fp7d
2020-07-03,AR,6,10,4,6,2022-05-03_11-02-08,fp7d
2020-07-03,BE,95,107,12,95,2022-05-03_11-02-08,fp7d
2020-07-03,BL,20,16,0,16,2022-05-03_11-02-08,fp7d
2020-07-03,BS,54,50,0,50,2022-05-03_11-02-08,fp7d
2020-07-03,FR,24,24,0,24,2022-05-03_11-02-08,fp7d
2020-07-03,GE,40,40,2,38,2022-05-03_11-02-08,fp7d
2020-07-03,GL,NA,NA,NA,NA,2022-05-03_11-02-08,fp7d
2020-07-03,GR,17,20,3,17,2022-05-03_11-02-08,fp7d
2020-07-03,JU,6,6,0,6,2022-05-03_11-02-08,fp7d
2020-07-03,LU,54,55,7,48,2022-05-03_11-02-08,fp7d
2020-07-03,NE,10,10,0,10,2022-05-03_11-02-08,fp7d
2020-07-03,NW,6,4,0,4,2022-05-03_11-02-08,fp7d
2020-07-03,OW,0,0,0,0,2022-05-03_11-02-08,fp7d
2020-07-03,SG,48,49,1,48,2022-05-03_11-02-08,fp7d
2020-07-03,SH,8,8,0,8,2022-05-03_11-02-08,fp7d
2020-07-03,SO,17,18,1,17,2022-05-03_11-02-08,fp7d
2020-07-03,SZ,12,11,0,11,2022-05-03_11-02-08,fp7d
2020-07-03,TG,21,38,17,21,2022-05-03_11-02-08,fp7d
2020-07-03,TI,47,51,13,38,2022-05-03_11-02-08,fp7d
2020-07-03,UR,6,6,0,6,2022-05-03_11-02-08,fp7d
2020-07-03,VD,64,69,5,64,2022-05-03_11-02-08,fp7d
2020-07-03,VS,21,27,6,21,2022-05-03_11-02-08,fp7d
2020-07-03,ZG,8,8,0,8,2022-05-03_11-02-08,fp7d
2020-07-03,ZH,192,314,125,189,2022-05-03_11-02-08,fp7d
2020-07-04,AG,52,52,0,52,2022-05-03_11-02-08,fp7d
2020-07-04,AI,0,0,0,0,2022-05-03_11-02-08,fp7d
2020-07-04,AR,6,10,4,6,2022-05-03_11-02-08,fp7d
2020-07-04,BE,95,107,12,95,2022-05-03_11-02-08,fp7d
2020-07-04,BL,20,16,0,16,2022-05-03_11-02-08,fp7d
2020-07-04,BS,54,50,0,50,2022-05-03_11-02-08,fp7d
2020-07-04,FR,24,24,0,24,2022-05-03_11-02-08,fp7d
2020-07-04,GE,40,40,2,38,2022-05-03_11-02-08,fp7d
2020-07-04,GL,NA,NA,NA,NA,2022-05-03_11-02-08,fp7d
2020-07-04,GR,17,20,3,17,2022-05-03_11-02-08,fp7d
2020-07-04,JU,6,6,0,6,2022-05-03_11-02-08,fp7d
2020-07-04,LU,54,55,7,48,2022-05-03_11-02-08,fp7d
2020-07-04,NE,10,10,0,10,2022-05-03_11-02-08,fp7d
2020-07-04,NW,6,4,0,4,2022-05-03_11-02-08,fp7d
2020-07-04,OW,0,0,0,0,2022-05-03_11-02-08,fp7d
2020-07-04,SG,48,49,1,48,2022-05-03_11-02-08,fp7d
2020-07-04,SH,8,8,0,8,2022-05-03_11-02-08,fp7d
2020-07-04,SO,17,18,1,17,2022-05-03_11-02-08,fp7d
2020-07-04,SZ,12,11,0,11,2022-05-03_11-02-08,fp7d
2020-07-04,TG,21,38,17,21,2022-05-03_11-02-08,fp7d
2020-07-04,TI,47,51,13,38,2022-05-03_11-02-08,fp7d
2020-07-04,UR,6,6,0,6,2022-05-03_11-02-08,fp7d
2020-07-04,VD,64,69,5,64,2022-05-03_11-02-08,fp7d
2020-07-04,VS,21,27,6,21,2022-05-03_11-02-08,fp7d
2020-07-04,ZG,8,8,0,8,2022-05-03_11-02-08,fp7d
2020-07-04,ZH,192,314,125,189,2022-05-03_11-02-08,fp7d
2020-07-05,AG,52,52,0,52,2022-05-03_11-02-08,fp7d
2020-07-05,AI,0,0,0,0,2022-05-03_11-02-08,fp7d
2020-07-05,AR,6,10,4,6,2022-05-03_11-02-08,fp7d
2020-07-05,BE,95,107,12,95,2022-05-03_11-02-08,fp7d
2020-07-05,BL,20,16,0,16,2022-05-03_11-02-08,fp7d
2020-07-05,BS,54,50,0,50,2022-05-03_11-02-08,fp7d
2020-07-05,FR,24,24,0,24,2022-05-03_11-02-08,fp7d
2020-07-05,GE,40,40,2,38,2022-05-03_11-02-08,fp7d
2020-07-05,GL,NA,NA,NA,NA,2022-05-03_11-02-08,fp7d
2020-07-05,GR,17,20,3,17,2022-05-03_11-02-08,fp7d
2020-07-05,JU,6,6,0,6,2022-05-03_11-02-08,fp7d
2020-07-05,LU,54,55,7,48,2022-05-03_11-02-08,fp7d
2020-07-05,NE,10,10,0,10,2022-05-03_11-02-08,fp7d
2020-07-05,NW,6,4,0,4,2022-05-03_11-02-08,fp7d
2020-07-05,OW,0,0,0,0,2022-05-03_11-02-08,fp7d
2020-07-05,SG,48,49,1,48,2022-05-03_11-02-08,fp7d
2020-07-05,SH,8,8,0,8,2022-05-03_11-02-08,fp7d
2020-07-05,SO,17,18,1,17,2022-05-03_11-02-08,fp7d
2020-07-05,SZ,12,11,0,11,2022-05-03_11-02-08,fp7d
2020-07-05,TG,21,38,17,21,2022-05-03_11-02-08,fp7d
2020-07-05,TI,47,51,13,38,2022-05-03_11-02-08,fp7d
2020-07-05,UR,6,6,0,6,2022-05-03_11-02-08,fp7d
2020-07-05,VD,64,69,5,64,2022-05-03_11-02-08,fp7d
2020-07-05,VS,21,27,6,21,2022-05-03_11-02-08,fp7d
2020-07-05,ZG,8,8,0,8,2022-05-03_11-02-08,fp7d
2020-07-05,ZH,192,314,125,189,2022-05-03_11-02-08,fp7d
2020-07-06,AG,52,52,0,52,2022-05-03_11-02-08,fp7d
2020-07-06,AI,0,0,0,0,2022-05-03_11-02-08,fp7d
2020-07-06,AR,6,10,4,6,2022-05-03_11-02-08,fp7d
2020-07-06,BE,92,102,12,90,2022-05-03_11-02-08,fp7d
2020-07-06,BL,20,16,0,16,2022-05-03_11-02-08,fp7d
2020-07-06,BS,54,50,0,50,2022-05-03_11-02-08,fp7d
2020-07-06,FR,24,24,0,24,2022-05-03_11-02-08,fp7d
2020-07-06,GE,40,40,2,38,2022-05-03_11-02-08,fp7d
2020-07-06,GL,NA,NA,NA,NA,2022-05-03_11-02-08,fp7d
2020-07-06,GR,17,20,3,17,2022-05-03_11-02-08,fp7d
2020-07-06,JU,6,6,0,6,2022-05-03_11-02-08,fp7d
2020-07-06,LU,54,55,7,48,2022-05-03_11-02-08,fp7d
2020-07-06,NE,10,10,0,10,2022-05-03_11-02-08,fp7d
2020-07-06,NW,6,4,0,4,2022-05-03_11-02-08,fp7d
2020-07-06,OW,0,0,0,0,2022-05-03_11-02-08,fp7d
2020-07-06,SG,48,49,1,48,2022-05-03_11-02-08,fp7d
2020-07-06,SH,8,8,0,8,2022-05-03_11-02-08,fp7d
2020-07-06,SO,17,18,1,17,2022-05-03_11-02-08,fp7d
2020-07-06,SZ,12,11,0,11,2022-05-03_11-02-08,fp7d
2020-07-06,TG,21,38,17,21,2022-05-03_11-02-08,fp7d
2020-07-06,TI,47,51,13,38,2022-05-03_11-02-08,fp7d
2020-07-06,UR,6,6,0,6,2022-05-03_11-02-08,fp7d
2020-07-06,VD,64,69,5,64,2022-05-03_11-02-08,fp7d
2020-07-06,VS,21,27,6,21,2022-05-03_11-02-08,fp7d
2020-07-06,ZG,8,8,0,8,2022-05-03_11-02-08,fp7d
2020-07-06,ZH,192,313,124,189,2022-05-03_11-02-08,fp7d
2020-07-07,AG,52,52,0,52,2022-05-03_11-02-08,fp7d
2020-07-07,AI,0,0,0,0,2022-05-03_11-02-08,fp7d
2020-07-07,AR,6,10,4,6,2022-05-03_11-02-08,fp7d
2020-07-07,BE,92,102,12,90,2022-05-03_11-02-08,fp7d
2020-07-07,BL,20,16,0,16,2022-05-03_11-02-08,fp7d
2020-07-07,BS,54,50,0,50,2022-05-03_11-02-08,fp7d
2020-07-07,FR,24,24,0,24,2022-05-03_11-02-08,fp7d
2020-07-07,GE,40,40,2,38,2022-05-03_11-02-08,fp7d
2020-07-07,GL,NA,NA,NA,NA,2022-05-03_11-02-08,fp7d
2020-07-07,GR,17,20,3,17,2022-05-03_11-02-08,fp7d
2020-07-07,JU,6,6,0,6,2022-05-03_11-02-08,fp7d
2020-07-07,LU,54,55,7,48,2022-05-03_11-02-08,fp7d
2020-07-07,NE,10,10,0,10,2022-05-03_11-02-08,fp7d
2020-07-07,NW,6,4,0,4,2022-05-03_11-02-08,fp7d
2020-07-07,OW,0,0,0,0,2022-05-03_11-02-08,fp7d
2020-07-07,SG,48,49,1,48,2022-05-03_11-02-08,fp7d
2020-07-07,SH,8,8,0,8,2022-05-03_11-02-08,fp7d
2020-07-07,SO,17,18,1,17,2022-05-03_11-02-08,fp7d
2020-07-07,SZ,12,11,0,11,2022-05-03_11-02-08,fp7d
2020-07-07,TG,21,38,17,21,2022-05-03_11-02-08,fp7d
2020-07-07,TI,47,51,13,38,2022-05-03_11-02-08,fp7d
2020-07-07,UR,6,6,0,6,2022-05-03_11-02-08,fp7d
2020-07-07,VD,64,69,5,64,2022-05-03_11-02-08,fp7d
2020-07-07,VS,21,27,6,21,2022-05-03_11-02-08,fp7d
2020-07-07,ZG,8,8,0,8,2022-05-03_11-02-08,fp7d
2020-07-07,ZH,192,313,124,189,2022-05-03_11-02-08,fp7d
2020-07-08,AG,52,50,0,50,2022-05-03_11-02-08,fp7d
2020-07-08,AI,0,0,0,0,2022-05-03_11-02-08,fp7d
2020-07-08,AR,6,10,4,6,2022-05-03_11-02-08,fp7d
2020-07-08,BE,92,102,12,90,2022-05-03_11-02-08,fp7d
2020-07-08,BL,20,14,0,14,2022-05-03_11-02-08,fp7d
2020-07-08,BS,54,50,0,50,2022-05-03_11-02-08,fp7d
2020-07-08,FR,24,24,0,24,2022-05-03_11-02-08,fp7d
2020-07-08,GE,40,40,2,38,2022-05-03_11-02-08,fp7d
2020-07-08,GL,NA,NA,NA,NA,2022-05-03_11-02-08,fp7d
2020-07-08,GR,17,20,3,17,2022-05-03_11-02-08,fp7d
2020-07-08,JU,6,6,0,6,2022-05-03_11-02-08,fp7d
2020-07-08,LU,40,39,5,34,2022-05-03_11-02-08,fp7d
2020-07-08,NE,10,10,0,10,2022-05-03_11-02-08,fp7d
2020-07-08,NW,6,4,0,4,2022-05-03_11-02-08,fp7d
2020-07-08,OW,0,0,0,0,2022-05-03_11-02-08,fp7d
2020-07-08,SG,48,49,1,48,2022-05-03_11-02-08,fp7d
2020-07-08,SH,8,8,0,8,2022-05-03_11-02-08,fp7d
2020-07-08,SO,17,18,1,17,2022-05-03_11-02-08,fp7d
2020-07-08,SZ,12,11,0,11,2022-05-03_11-02-08,fp7d
2020-07-08,TG,21,38,17,21,2022-05-03_11-02-08,fp7d
2020-07-08,TI,47,51,13,38,2022-05-03_11-02-08,fp7d
2020-07-08,UR,6,6,0,6,2022-05-03_11-02-08,fp7d
2020-07-08,VD,64,69,5,64,2022-05-03_11-02-08,fp7d
2020-07-08,VS,21,27,6,21,2022-05-03_11-02-08,fp7d
2020-07-08,ZG,8,8,0,8,2022-05-03_11-02-08,fp7d
2020-07-08,ZH,192,313,124,189,2022-05-03_11-02-08,fp7d
2020-07-09,AG,52,52,0,52,2022-05-03_11-02-08,fp7d
2020-07-09,AI,0,0,0,0,2022-05-03_11-02-08,fp7d
2020-07-09,AR,6,10,4,6,2022-05-03_11-02-08,fp7d
2020-07-09,BE,92,102,12,90,2022-05-03_11-02-08,fp7d
2020-07-09,BL,20,14,0,14,2022-05-03_11-02-08,fp7d
2020-07-09,BS,54,50,0,50,2022-05-03_11-02-08,fp7d
2020-07-09,FR,24,24,0,24,2022-05-03_11-02-08,fp7d
2020-07-09,GE,40,40,2,38,2022-05-03_11-02-08,fp7d
2020-07-09,GL,NA,NA,NA,NA,2022-05-03_11-02-08,fp7d
2020-07-09,GR,17,20,3,17,2022-05-03_11-02-08,fp7d
2020-07-09,JU,6,6,0,6,2022-05-03_11-02-08,fp7d
2020-07-09,LU,54,55,7,48,2022-05-03_11-02-08,fp7d
2020-07-09,NE,10,10,0,10,2022-05-03_11-02-08,fp7d
2020-07-09,NW,6,3,0,3,2022-05-03_11-02-08,fp7d
2020-07-09,OW,0,0,0,0,2022-05-03_11-02-08,fp7d
2020-07-09,SG,48,49,1,48,2022-05-03_11-02-08,fp7d
2020-07-09,SH,8,8,0,8,2022-05-03_11-02-08,fp7d
2020-07-09,SO,17,17,0,17,2022-05-03_11-02-08,fp7d
2020-07-09,SZ,12,13,1,12,2022-05-03_11-02-08,fp7d
2020-07-09,TG,21,38,17,21,2022-05-03_11-02-08,fp7d
2020-07-09,TI,47,51,13,38,2022-05-03_11-02-08,fp7d
2020-07-09,UR,6,6,0,6,2022-05-03_11-02-08,fp7d
2020-07-09,VD,64,69,5,64,2022-05-03_11-02-08,fp7d
2020-07-09,VS,15,15,0,15,2022-05-03_11-02-08,fp7d
2020-07-09,ZG,8,8,0,8,2022-05-03_11-02-08,fp7d
2020-07-09,ZH,192,312,124,188,2022-05-03_11-02-08,fp7d
2020-07-10,AG,52,50,0,50,2022-05-03_11-02-08,fp7d
2020-07-10,AI,0,0,0,0,2022-05-03_11-02-08,fp7d
2020-07-10,AR,6,10,4,6,2022-05-03_11-02-08,fp7d
2020-07-10,BE,92,102,12,90,2022-05-03_11-02-08,fp7d
2020-07-10,BL,20,14,0,14,2022-05-03_11-02-08,fp7d
2020-07-10,BS,54,50,0,50,2022-05-03_11-02-08,fp7d
2020-07-10,FR,24,24,0,24,2022-05-03_11-02-08,fp7d
2020-07-10,GE,40,40,2,38,2022-05-03_11-02-08,fp7d
2020-07-10,GL,NA,NA,NA,NA,2022-05-03_11-02-08,fp7d
2020-07-10,GR,17,20,3,17,2022-05-03_11-02-08,fp7d
2020-07-10,JU,6,6,0,6,2022-05-03_11-02-08,fp7d
2020-07-10,LU,54,50,2,48,2022-05-03_11-02-08,fp7d
2020-07-10,NE,10,10,0,10,2022-05-03_11-02-08,fp7d
2020-07-10,NW,6,2,0,2,2022-05-03_11-02-08,fp7d
2020-07-10,OW,0,0,0,0,2022-05-03_11-02-08,fp7d
2020-07-10,SG,54,55,1,54,2022-05-03_11-02-08,fp7d
2020-07-10,SH,8,8,0,8,2022-05-03_11-02-08,fp7d
2020-07-10,SO,17,17,0,17,2022-05-03_11-02-08,fp7d
2020-07-10,SZ,12,11,0,11,2022-05-03_11-02-08,fp7d
2020-07-10,TG,21,38,17,21,2022-05-03_11-02-08,fp7d
2020-07-10,TI,38,51,13,38,2022-05-03_11-02-08,fp7d
2020-07-10,UR,6,6,0,6,2022-05-03_11-02-08,fp7d
2020-07-10,VD,64,69,5,64,2022-05-03_11-02-08,fp7d
2020-07-10,VS,21,27,6,21,2022-05-03_11-02-08,fp7d
2020-07-10,ZG,8,8,0,8,2022-05-03_11-02-08,fp7d
2020-07-10,ZH,192,314,125,189,2022-05-03_11-02-08,fp7d
2020-07-11,AG,52,52,0,52,2022-05-03_11-02-08,fp7d
2020-07-11,AI,0,0,0,0,2022-05-03_11-02-08,fp7d
2020-07-11,AR,6,10,4,6,2022-05-03_11-02-08,fp7d
2020-07-11,BE,92,102,12,90,2022-05-03_11-02-08,fp7d
2020-07-11,BL,20,14,0,14,2022-05-03_11-02-08,fp7d
2020-07-11,BS,54,50,0,50,2022-05-03_11-02-08,fp7d
2020-07-11,FR,24,24,0,24,2022-05-03_11-02-08,fp7d
2020-07-11,GE,40,40,2,38,2022-05-03_11-02-08,fp7d
2020-07-11,GL,NA,NA,NA,NA,2022-05-03_11-02-08,fp7d
2020-07-11,GR,17,20,3,17,2022-05-03_11-02-08,fp7d
2020-07-11,JU,6,6,0,6,2022-05-03_11-02-08,fp7d
2020-07-11,LU,54,50,2,48,2022-05-03_11-02-08,fp7d
2020-07-11,NE,10,10,0,10,2022-05-03_11-02-08,fp7d
2020-07-11,NW,6,2,0,2,2022-05-03_11-02-08,fp7d
2020-07-11,OW,0,0,0,0,2022-05-03_11-02-08,fp7d
2020-07-11,SG,54,55,1,54,2022-05-03_11-02-08,fp7d
2020-07-11,SH,8,8,0,8,2022-05-03_11-02-08,fp7d
2020-07-11,SO,17,17,0,17,2022-05-03_11-02-08,fp7d
2020-07-11,SZ,12,11,0,11,2022-05-03_11-02-08,fp7d
2020-07-11,TG,21,38,17,21,2022-05-03_11-02-08,fp7d
2020-07-11,TI,38,51,13,38,2022-05-03_11-02-08,fp7d
2020-07-11,UR,6,6,0,6,2022-05-03_11-02-08,fp7d
2020-07-11,VD,64,69,5,64,2022-05-03_11-02-08,fp7d
2020-07-11,VS,21,27,6,21,2022-05-03_11-02-08,fp7d
2020-07-11,ZG,8,8,0,8,2022-05-03_11-02-08,fp7d
2020-07-11,ZH,192,314,125,189,2022-05-03_11-02-08,fp7d
2020-07-12,AG,52,52,0,52,2022-05-03_11-02-08,fp7d
2020-07-12,AI,0,0,0,0,2022-05-03_11-02-08,fp7d
2020-07-12,AR,6,10,4,6,2022-05-03_11-02-08,fp7d
2020-07-12,BE,92,102,12,90,2022-05-03_11-02-08,fp7d
2020-07-12,BL,20,14,0,14,2022-05-03_11-02-08,fp7d
2020-07-12,BS,54,50,0,50,2022-05-03_11-02-08,fp7d
2020-07-12,FR,24,24,0,24,2022-05-03_11-02-08,fp7d
2020-07-12,GE,40,40,2,38,2022-05-03_11-02-08,fp7d
2020-07-12,GL,NA,NA,NA,NA,2022-05-03_11-02-08,fp7d
2020-07-12,GR,17,20,3,17,2022-05-03_11-02-08,fp7d
2020-07-12,JU,6,6,0,6,2022-05-03_11-02-08,fp7d
2020-07-12,LU,54,50,2,48,2022-05-03_11-02-08,fp7d
2020-07-12,NE,10,10,0,10,2022-05-03_11-02-08,fp7d
2020-07-12,NW,6,2,0,2,2022-05-03_11-02-08,fp7d
2020-07-12,OW,0,0,0,0,2022-05-03_11-02-08,fp7d
2020-07-12,SG,54,55,1,54,2022-05-03_11-02-08,fp7d
2020-07-12,SH,8,8,0,8,2022-05-03_11-02-08,fp7d
2020-07-12,SO,17,17,0,17,2022-05-03_11-02-08,fp7d
2020-07-12,SZ,12,11,0,11,2022-05-03_11-02-08,fp7d
2020-07-12,TG,21,38,17,21,2022-05-03_11-02-08,fp7d
2020-07-12,TI,38,51,13,38,2022-05-03_11-02-08,fp7d
2020-07-12,UR,6,6,0,6,2022-05-03_11-02-08,fp7d
2020-07-12,VD,64,69,5,64,2022-05-03_11-02-08,fp7d
2020-07-12,VS,21,27,6,21,2022-05-03_11-02-08,fp7d
2020-07-12,ZG,8,8,0,8,2022-05-03_11-02-08,fp7d
2020-07-12,ZH,192,314,125,189,2022-05-03_11-02-08,fp7d
2020-07-13,AG,52,52,0,52,2022-05-03_11-02-08,fp7d
2020-07-13,AI,0,0,0,0,2022-05-03_11-02-08,fp7d
2020-07-13,AR,6,10,4,6,2022-05-03_11-02-08,fp7d
2020-07-13,BE,92,102,12,90,2022-05-03_11-02-08,fp7d
2020-07-13,BL,20,15,1,14,2022-05-03_11-02-08,fp7d
2020-07-13,BS,54,50,0,50,2022-05-03_11-02-08,fp7d
2020-07-13,FR,24,24,0,24,2022-05-03_11-02-08,fp7d
2020-07-13,GE,40,40,2,38,2022-05-03_11-02-08,fp7d
2020-07-13,GL,NA,NA,NA,NA,2022-05-03_11-02-08,fp7d
2020-07-13,GR,17,20,3,17,2022-05-03_11-02-08,fp7d
2020-07-13,JU,6,6,0,6,2022-05-03_11-02-08,fp7d
2020-07-13,LU,54,52,2,50,2022-05-03_11-02-08,fp7d
2020-07-13,NE,10,10,0,10,2022-05-03_11-02-08,fp7d
2020-07-13,NW,6,2,0,2,2022-05-03_11-02-08,fp7d
2020-07-13,OW,0,0,0,0,2022-05-03_11-02-08,fp7d
2020-07-13,SG,54,55,1,54,2022-05-03_11-02-08,fp7d
2020-07-13,SH,8,8,0,8,2022-05-03_11-02-08,fp7d
2020-07-13,SO,17,17,0,17,2022-05-03_11-02-08,fp7d
2020-07-13,SZ,12,11,0,11,2022-05-03_11-02-08,fp7d
2020-07-13,TG,21,38,17,21,2022-05-03_11-02-08,fp7d
2020-07-13,TI,38,51,13,38,2022-05-03_11-02-08,fp7d
2020-07-13,UR,6,6,0,6,2022-05-03_11-02-08,fp7d
2020-07-13,VD,71,76,5,71,2022-05-03_11-02-08,fp7d
2020-07-13,VS,21,27,6,21,2022-05-03_11-02-08,fp7d
2020-07-13,ZG,8,8,0,8,2022-05-03_11-02-08,fp7d
2020-07-13,ZH,192,314,125,189,2022-05-03_11-02-08,fp7d
2020-07-14,AG,52,50,0,50,2022-05-03_11-02-08,fp7d
2020-07-14,AI,0,0,0,0,2022-05-03_11-02-08,fp7d
2020-07-14,AR,6,10,4,6,2022-05-03_11-02-08,fp7d
2020-07-14,BE,92,102,12,90,2022-05-03_11-02-08,fp7d
2020-07-14,BL,20,17,1,16,2022-05-03_11-02-08,fp7d
2020-07-14,BS,54,50,0,50,2022-05-03_11-02-08,fp7d
2020-07-14,FR,24,24,0,24,2022-05-03_11-02-08,fp7d
2020-07-14,GE,40,40,2,38,2022-05-03_11-02-08,fp7d
2020-07-14,GL,NA,NA,NA,NA,2022-05-03_11-02-08,fp7d
2020-07-14,GR,17,20,3,17,2022-05-03_11-02-08,fp7d
2020-07-14,JU,6,6,0,6,2022-05-03_11-02-08,fp7d
2020-07-14,LU,54,50,2,48,2022-05-03_11-02-08,fp7d
2020-07-14,NE,10,10,0,10,2022-05-03_11-02-08,fp7d
2020-07-14,NW,6,2,0,2,2022-05-03_11-02-08,fp7d
2020-07-14,OW,0,0,0,0,2022-05-03_11-02-08,fp7d
2020-07-14,SG,54,55,1,54,2022-05-03_11-02-08,fp7d
2020-07-14,SH,8,8,0,8,2022-05-03_11-02-08,fp7d
2020-07-14,SO,17,17,0,17,2022-05-03_11-02-08,fp7d
2020-07-14,SZ,12,11,0,11,2022-05-03_11-02-08,fp7d
2020-07-14,TG,21,38,17,21,2022-05-03_11-02-08,fp7d
2020-07-14,TI,38,51,13,38,2022-05-03_11-02-08,fp7d
2020-07-14,UR,6,6,0,6,2022-05-03_11-02-08,fp7d
2020-07-14,VD,71,76,5,71,2022-05-03_11-02-08,fp7d
2020-07-14,VS,21,27,6,21,2022-05-03_11-02-08,fp7d
2020-07-14,ZG,8,8,0,8,2022-05-03_11-02-08,fp7d
2020-07-14,ZH,192,314,125,189,2022-05-03_11-02-08,fp7d
2020-07-15,AG,52,50,0,50,2022-05-03_11-02-08,fp7d
2020-07-15,AI,0,0,0,0,2022-05-03_11-02-08,fp7d
2020-07-15,AR,6,10,4,6,2022-05-03_11-02-08,fp7d
2020-07-15,BE,92,102,12,90,2022-05-03_11-02-08,fp7d
2020-07-15,BL,20,18,2,16,2022-05-03_11-02-08,fp7d
2020-07-15,BS,54,50,0,50,2022-05-03_11-02-08,fp7d
2020-07-15,FR,24,24,0,24,2022-05-03_11-02-08,fp7d
2020-07-15,GE,40,40,2,38,2022-05-03_11-02-08,fp7d
2020-07-15,GL,NA,NA,NA,NA,2022-05-03_11-02-08,fp7d
2020-07-15,GR,17,20,3,17,2022-05-03_11-02-08,fp7d
2020-07-15,JU,6,6,0,6,2022-05-03_11-02-08,fp7d
2020-07-15,LU,54,50,2,48,2022-05-03_11-02-08,fp7d
2020-07-15,NE,10,10,0,10,2022-05-03_11-02-08,fp7d
2020-07-15,NW,6,2,0,2,2022-05-03_11-02-08,fp7d
2020-07-15,OW,0,0,0,0,2022-05-03_11-02-08,fp7d
2020-07-15,SG,54,55,1,54,2022-05-03_11-02-08,fp7d
2020-07-15,SH,8,8,0,8,2022-05-03_11-02-08,fp7d
2020-07-15,SO,17,17,0,17,2022-05-03_11-02-08,fp7d
2020-07-15,SZ,12,11,0,11,2022-05-03_11-02-08,fp7d
2020-07-15,TG,21,38,17,21,2022-05-03_11-02-08,fp7d
2020-07-15,TI,46,59,13,46,2022-05-03_11-02-08,fp7d
2020-07-15,UR,6,6,0,6,2022-05-03_11-02-08,fp7d
2020-07-15,VD,71,76,5,71,2022-05-03_11-02-08,fp7d
2020-07-15,VS,21,27,6,21,2022-05-03_11-02-08,fp7d
2020-07-15,ZG,8,8,0,8,2022-05-03_11-02-08,fp7d
2020-07-15,ZH,192,314,125,189,2022-05-03_11-02-08,fp7d
2020-07-16,AG,52,50,0,50,2022-05-03_11-02-08,fp7d
2020-07-16,AI,0,0,0,0,2022-05-03_11-02-08,fp7d
2020-07-16,AR,6,10,4,6,2022-05-03_11-02-08,fp7d
2020-07-16,BE,92,102,12,90,2022-05-03_11-02-08,fp7d
2020-07-16,BL,20,17,1,16,2022-05-03_11-02-08,fp7d
2020-07-16,BS,54,50,0,50,2022-05-03_11-02-08,fp7d
2020-07-16,FR,24,24,0,24,2022-05-03_11-02-08,fp7d
2020-07-16,GE,40,40,2,38,2022-05-03_11-02-08,fp7d
2020-07-16,GL,NA,NA,NA,NA,2022-05-03_11-02-08,fp7d
2020-07-16,GR,17,20,3,17,2022-05-03_11-02-08,fp7d
2020-07-16,JU,6,6,0,6,2022-05-03_11-02-08,fp7d
2020-07-16,LU,40,34,0,34,2022-05-03_11-02-08,fp7d
2020-07-16,NE,10,10,0,10,2022-05-03_11-02-08,fp7d
2020-07-16,NW,6,4,0,4,2022-05-03_11-02-08,fp7d
2020-07-16,OW,0,0,0,0,2022-05-03_11-02-08,fp7d
2020-07-16,SG,54,55,1,54,2022-05-03_11-02-08,fp7d
2020-07-16,SH,8,8,0,8,2022-05-03_11-02-08,fp7d
2020-07-16,SO,17,17,0,17,2022-05-03_11-02-08,fp7d
2020-07-16,SZ,12,11,0,11,2022-05-03_11-02-08,fp7d
2020-07-16,TG,21,38,17,21,2022-05-03_11-02-08,fp7d
2020-07-16,TI,46,59,13,46,2022-05-03_11-02-08,fp7d
2020-07-16,UR,6,6,0,6,2022-05-03_11-02-08,fp7d
2020-07-16,VD,71,76,5,71,2022-05-03_11-02-08,fp7d
2020-07-16,VS,21,27,6,21,2022-05-03_11-02-08,fp7d
2020-07-16,ZG,8,8,0,8,2022-05-03_11-02-08,fp7d
2020-07-16,ZH,192,314,125,189,2022-05-03_11-02-08,fp7d
2020-07-17,AG,52,50,0,50,2022-05-03_11-02-08,fp7d
2020-07-17,AI,0,0,0,0,2022-05-03_11-02-08,fp7d
2020-07-17,AR,6,10,4,6,2022-05-03_11-02-08,fp7d
2020-07-17,BE,104,114,12,102,2022-05-03_11-02-08,fp7d
2020-07-17,BL,20,18,2,16,2022-05-03_11-02-08,fp7d
2020-07-17,BS,54,50,0,50,2022-05-03_11-02-08,fp7d
2020-07-17,FR,24,24,0,24,2022-05-03_11-02-08,fp7d
2020-07-17,GE,40,40,2,38,2022-05-03_11-02-08,fp7d
2020-07-17,GL,NA,NA,NA,NA,2022-05-03_11-02-08,fp7d
2020-07-17,GR,17,20,3,17,2022-05-03_11-02-08,fp7d
2020-07-17,JU,6,6,0,6,2022-05-03_11-02-08,fp7d
2020-07-17,LU,40,36,0,36,2022-05-03_11-02-08,fp7d
2020-07-17,NE,10,10,0,10,2022-05-03_11-02-08,fp7d
2020-07-17,NW,6,3,0,3,2022-05-03_11-02-08,fp7d
2020-07-17,OW,0,0,0,0,2022-05-03_11-02-08,fp7d
2020-07-17,SG,54,55,1,54,2022-05-03_11-02-08,fp7d
2020-07-17,SH,8,8,0,8,2022-05-03_11-02-08,fp7d
2020-07-17,SO,17,17,0,17,2022-05-03_11-02-08,fp7d
2020-07-17,SZ,12,11,0,11,2022-05-03_11-02-08,fp7d
2020-07-17,TG,21,38,17,21,2022-05-03_11-02-08,fp7d
2020-07-17,TI,46,59,13,46,2022-05-03_11-02-08,fp7d
2020-07-17,UR,6,6,0,6,2022-05-03_11-02-08,fp7d
2020-07-17,VD,71,76,5,71,2022-05-03_11-02-08,fp7d
2020-07-17,VS,21,27,6,21,2022-05-03_11-02-08,fp7d
2020-07-17,ZG,8,8,0,8,2022-05-03_11-02-08,fp7d
2020-07-17,ZH,192,316,125,191,2022-05-03_11-02-08,fp7d
2020-07-18,AG,52,50,0,50,2022-05-03_11-02-08,fp7d
2020-07-18,AI,0,0,0,0,2022-05-03_11-02-08,fp7d
2020-07-18,AR,6,10,4,6,2022-05-03_11-02-08,fp7d
2020-07-18,BE,104,114,12,102,2022-05-03_11-02-08,fp7d
2020-07-18,BL,20,16,0,16,2022-05-03_11-02-08,fp7d
2020-07-18,BS,54,50,0,50,2022-05-03_11-02-08,fp7d
2020-07-18,FR,24,24,0,24,2022-05-03_11-02-08,fp7d
2020-07-18,GE,40,40,2,38,2022-05-03_11-02-08,fp7d
2020-07-18,GL,NA,NA,NA,NA,2022-05-03_11-02-08,fp7d
2020-07-18,GR,17,20,3,17,2022-05-03_11-02-08,fp7d
2020-07-18,JU,6,6,0,6,2022-05-03_11-02-08,fp7d
2020-07-18,LU,40,36,0,36,2022-05-03_11-02-08,fp7d
2020-07-18,NE,10,10,0,10,2022-05-03_11-02-08,fp7d
2020-07-18,NW,6,3,0,3,2022-05-03_11-02-08,fp7d
2020-07-18,OW,0,0,0,0,2022-05-03_11-02-08,fp7d
2020-07-18,SG,54,55,1,54,2022-05-03_11-02-08,fp7d
2020-07-18,SH,8,8,0,8,2022-05-03_11-02-08,fp7d
2020-07-18,SO,17,17,0,17,2022-05-03_11-02-08,fp7d
2020-07-18,SZ,12,11,0,11,2022-05-03_11-02-08,fp7d
2020-07-18,TG,21,38,17,21,2022-05-03_11-02-08,fp7d
2020-07-18,TI,46,59,13,46,2022-05-03_11-02-08,fp7d
2020-07-18,UR,6,6,0,6,2022-05-03_11-02-08,fp7d
2020-07-18,VD,71,76,5,71,2022-05-03_11-02-08,fp7d
2020-07-18,VS,21,27,6,21,2022-05-03_11-02-08,fp7d
2020-07-18,ZG,8,8,0,8,2022-05-03_11-02-08,fp7d
2020-07-18,ZH,192,313,125,188,2022-05-03_11-02-08,fp7d
2020-07-19,AG,52,50,0,50,2022-05-03_11-02-08,fp7d
2020-07-19,AI,0,0,0,0,2022-05-03_11-02-08,fp7d
2020-07-19,AR,6,10,4,6,2022-05-03_11-02-08,fp7d
2020-07-19,BE,104,114,12,102,2022-05-03_11-02-08,fp7d
2020-07-19,BL,20,16,0,16,2022-05-03_11-02-08,fp7d
2020-07-19,BS,54,50,0,50,2022-05-03_11-02-08,fp7d
2020-07-19,FR,24,24,0,24,2022-05-03_11-02-08,fp7d
2020-07-19,GE,40,40,2,38,2022-05-03_11-02-08,fp7d
2020-07-19,GL,NA,NA,NA,NA,2022-05-03_11-02-08,fp7d
2020-07-19,GR,17,20,3,17,2022-05-03_11-02-08,fp7d
2020-07-19,JU,6,6,0,6,2022-05-03_11-02-08,fp7d
2020-07-19,LU,40,36,0,36,2022-05-03_11-02-08,fp7d
2020-07-19,NE,10,10,0,10,2022-05-03_11-02-08,fp7d
2020-07-19,NW,6,3,0,3,2022-05-03_11-02-08,fp7d
2020-07-19,OW,0,0,0,0,2022-05-03_11-02-08,fp7d
2020-07-19,SG,54,55,1,54,2022-05-03_11-02-08,fp7d
2020-07-19,SH,8,8,0,8,2022-05-03_11-02-08,fp7d
2020-07-19,SO,17,17,0,17,2022-05-03_11-02-08,fp7d
2020-07-19,SZ,12,11,0,11,2022-05-03_11-02-08,fp7d
2020-07-19,TG,21,38,17,21,2022-05-03_11-02-08,fp7d
2020-07-19,TI,46,59,13,46,2022-05-03_11-02-08,fp7d
2020-07-19,UR,6,6,0,6,2022-05-03_11-02-08,fp7d
2020-07-19,VD,71,76,5,71,2022-05-03_11-02-08,fp7d
2020-07-19,VS,21,27,6,21,2022-05-03_11-02-08,fp7d
2020-07-19,ZG,8,8,0,8,2022-05-03_11-02-08,fp7d
2020-07-19,ZH,192,312,125,187,2022-05-03_11-02-08,fp7d
2020-07-20,AG,52,50,0,50,2022-05-03_11-02-08,fp7d
2020-07-20,AI,0,0,0,0,2022-05-03_11-02-08,fp7d
2020-07-20,AR,6,10,4,6,2022-05-03_11-02-08,fp7d
2020-07-20,BE,104,114,12,102,2022-05-03_11-02-08,fp7d
2020-07-20,BL,20,16,0,16,2022-05-03_11-02-08,fp7d
2020-07-20,BS,54,50,0,50,2022-05-03_11-02-08,fp7d
2020-07-20,FR,24,24,0,24,2022-05-03_11-02-08,fp7d
2020-07-20,GE,40,40,2,38,2022-05-03_11-02-08,fp7d
2020-07-20,GL,NA,NA,NA,NA,2022-05-03_11-02-08,fp7d
2020-07-20,GR,17,20,3,17,2022-05-03_11-02-08,fp7d
2020-07-20,JU,6,6,0,6,2022-05-03_11-02-08,fp7d
2020-07-20,LU,54,52,2,50,2022-05-03_11-02-08,fp7d
2020-07-20,NE,10,10,0,10,2022-05-03_11-02-08,fp7d
2020-07-20,NW,6,4,0,4,2022-05-03_11-02-08,fp7d
2020-07-20,OW,0,0,0,0,2022-05-03_11-02-08,fp7d
2020-07-20,SG,54,55,1,54,2022-05-03_11-02-08,fp7d
2020-07-20,SH,8,8,0,8,2022-05-03_11-02-08,fp7d
2020-07-20,SO,17,17,0,17,2022-05-03_11-02-08,fp7d
2020-07-20,SZ,12,11,0,11,2022-05-03_11-02-08,fp7d
2020-07-20,TG,21,38,17,21,2022-05-03_11-02-08,fp7d
2020-07-20,TI,46,59,13,46,2022-05-03_11-02-08,fp7d
2020-07-20,UR,6,6,0,6,2022-05-03_11-02-08,fp7d
2020-07-20,VD,71,76,5,71,2022-05-03_11-02-08,fp7d
2020-07-20,VS,21,27,6,21,2022-05-03_11-02-08,fp7d
2020-07-20,ZG,8,8,0,8,2022-05-03_11-02-08,fp7d
2020-07-20,ZH,192,312,125,187,2022-05-03_11-02-08,fp7d
2020-07-21,AG,52,50,0,50,2022-05-03_11-02-08,fp7d
2020-07-21,AI,0,0,0,0,2022-05-03_11-02-08,fp7d
2020-07-21,AR,6,10,4,6,2022-05-03_11-02-08,fp7d
2020-07-21,BE,104,114,12,102,2022-05-03_11-02-08,fp7d
2020-07-21,BL,20,16,0,16,2022-05-03_11-02-08,fp7d
2020-07-21,BS,54,50,0,50,2022-05-03_11-02-08,fp7d
2020-07-21,FR,24,24,0,24,2022-05-03_11-02-08,fp7d
2020-07-21,GE,40,40,2,38,2022-05-03_11-02-08,fp7d
2020-07-21,GL,NA,NA,NA,NA,2022-05-03_11-02-08,fp7d
2020-07-21,GR,17,20,3,17,2022-05-03_11-02-08,fp7d
2020-07-21,JU,6,6,0,6,2022-05-03_11-02-08,fp7d
2020-07-21,LU,54,52,2,50,2022-05-03_11-02-08,fp7d
2020-07-21,NE,10,10,0,10,2022-05-03_11-02-08,fp7d
2020-07-21,NW,6,6,0,6,2022-05-03_11-02-08,fp7d
2020-07-21,OW,0,0,0,0,2022-05-03_11-02-08,fp7d
2020-07-21,SG,54,55,1,54,2022-05-03_11-02-08,fp7d
2020-07-21,SH,8,8,0,8,2022-05-03_11-02-08,fp7d
2020-07-21,SO,17,17,0,17,2022-05-03_11-02-08,fp7d
2020-07-21,SZ,12,11,0,11,2022-05-03_11-02-08,fp7d
2020-07-21,TG,21,38,17,21,2022-05-03_11-02-08,fp7d
2020-07-21,TI,46,59,13,46,2022-05-03_11-02-08,fp7d
2020-07-21,UR,6,6,0,6,2022-05-03_11-02-08,fp7d
2020-07-21,VD,71,76,5,71,2022-05-03_11-02-08,fp7d
2020-07-21,VS,21,27,6,21,2022-05-03_11-02-08,fp7d
2020-07-21,ZG,8,8,0,8,2022-05-03_11-02-08,fp7d
2020-07-21,ZH,192,314,125,189,2022-05-03_11-02-08,fp7d
2020-07-22,AG,52,50,0,50,2022-05-03_11-02-08,fp7d
2020-07-22,AI,0,0,0,0,2022-05-03_11-02-08,fp7d
2020-07-22,AR,6,10,4,6,2022-05-03_11-02-08,fp7d
2020-07-22,BE,104,114,12,102,2022-05-03_11-02-08,fp7d
2020-07-22,BL,20,16,0,16,2022-05-03_11-02-08,fp7d
2020-07-22,BS,54,50,0,50,2022-05-03_11-02-08,fp7d
2020-07-22,FR,24,24,0,24,2022-05-03_11-02-08,fp7d
2020-07-22,GE,40,40,2,38,2022-05-03_11-02-08,fp7d
2020-07-22,GL,NA,NA,NA,NA,2022-05-03_11-02-08,fp7d
2020-07-22,GR,17,20,3,17,2022-05-03_11-02-08,fp7d
2020-07-22,JU,6,6,0,6,2022-05-03_11-02-08,fp7d
2020-07-22,LU,54,52,2,50,2022-05-03_11-02-08,fp7d
2020-07-22,NE,10,10,0,10,2022-05-03_11-02-08,fp7d
2020-07-22,NW,6,6,0,6,2022-05-03_11-02-08,fp7d
2020-07-22,OW,0,0,0,0,2022-05-03_11-02-08,fp7d
2020-07-22,SG,54,55,1,54,2022-05-03_11-02-08,fp7d
2020-07-22,SH,8,8,0,8,2022-05-03_11-02-08,fp7d
2020-07-22,SO,17,17,0,17,2022-05-03_11-02-08,fp7d
2020-07-22,SZ,12,11,0,11,2022-05-03_11-02-08,fp7d
2020-07-22,TG,21,38,17,21,2022-05-03_11-02-08,fp7d
2020-07-22,TI,38,51,13,38,2022-05-03_11-02-08,fp7d
2020-07-22,UR,6,6,0,6,2022-05-03_11-02-08,fp7d
2020-07-22,VD,71,76,5,71,2022-05-03_11-02-08,fp7d
2020-07-22,VS,21,27,6,21,2022-05-03_11-02-08,fp7d
2020-07-22,ZG,8,8,0,8,2022-05-03_11-02-08,fp7d
2020-07-22,ZH,192,316,125,191,2022-05-03_11-02-08,fp7d
2020-07-23,AG,52,50,0,50,2022-05-03_11-02-08,fp7d
2020-07-23,AI,0,0,0,0,2022-05-03_11-02-08,fp7d
2020-07-23,AR,6,10,4,6,2022-05-03_11-02-08,fp7d
2020-07-23,BE,104,114,12,102,2022-05-03_11-02-08,fp7d
2020-07-23,BL,20,16,0,16,2022-05-03_11-02-08,fp7d
2020-07-23,BS,54,50,0,50,2022-05-03_11-02-08,fp7d
2020-07-23,FR,24,24,0,24,2022-05-03_11-02-08,fp7d
2020-07-23,GE,40,40,2,38,2022-05-03_11-02-08,fp7d
2020-07-23,GL,NA,NA,NA,NA,2022-05-03_11-02-08,fp7d
2020-07-23,GR,17,20,3,17,2022-05-03_11-02-08,fp7d
2020-07-23,JU,6,6,0,6,2022-05-03_11-02-08,fp7d
2020-07-23,LU,54,52,2,50,2022-05-03_11-02-08,fp7d
2020-07-23,NE,10,10,0,10,2022-05-03_11-02-08,fp7d
2020-07-23,NW,6,6,0,6,2022-05-03_11-02-08,fp7d
2020-07-23,OW,0,0,0,0,2022-05-03_11-02-08,fp7d
2020-07-23,SG,54,55,1,54,2022-05-03_11-02-08,fp7d
2020-07-23,SH,8,8,0,8,2022-05-03_11-02-08,fp7d
2020-07-23,SO,17,17,0,17,2022-05-03_11-02-08,fp7d
2020-07-23,SZ,12,11,0,11,2022-05-03_11-02-08,fp7d
2020-07-23,TG,21,38,17,21,2022-05-03_11-02-08,fp7d
2020-07-23,TI,38,51,13,38,2022-05-03_11-02-08,fp7d
2020-07-23,UR,6,6,0,6,2022-05-03_11-02-08,fp7d
2020-07-23,VD,71,76,5,71,2022-05-03_11-02-08,fp7d
2020-07-23,VS,21,27,6,21,2022-05-03_11-02-08,fp7d
2020-07-23,ZG,8,8,0,8,2022-05-03_11-02-08,fp7d
2020-07-23,ZH,192,313,125,188,2022-05-03_11-02-08,fp7d
2020-07-24,AG,52,50,0,50,2022-05-03_11-02-08,fp7d
2020-07-24,AI,0,0,0,0,2022-05-03_11-02-08,fp7d
2020-07-24,AR,6,10,4,6,2022-05-03_11-02-08,fp7d
2020-07-24,BE,83,93,12,81,2022-05-03_11-02-08,fp7d
2020-07-24,BL,20,16,0,16,2022-05-03_11-02-08,fp7d
2020-07-24,BS,54,50,0,50,2022-05-03_11-02-08,fp7d
2020-07-24,FR,24,24,0,24,2022-05-03_11-02-08,fp7d
2020-07-24,GE,40,40,2,38,2022-05-03_11-02-08,fp7d
2020-07-24,GL,NA,NA,NA,NA,2022-05-03_11-02-08,fp7d
2020-07-24,GR,17,20,3,17,2022-05-03_11-02-08,fp7d
2020-07-24,JU,6,6,0,6,2022-05-03_11-02-08,fp7d
2020-07-24,LU,54,52,2,50,2022-05-03_11-02-08,fp7d
2020-07-24,NE,10,10,0,10,2022-05-03_11-02-08,fp7d
2020-07-24,NW,6,3,0,3,2022-05-03_11-02-08,fp7d
2020-07-24,OW,0,0,0,0,2022-05-03_11-02-08,fp7d
2020-07-24,SG,54,55,1,54,2022-05-03_11-02-08,fp7d
2020-07-24,SH,8,8,0,8,2022-05-03_11-02-08,fp7d
2020-07-24,SO,17,17,0,17,2022-05-03_11-02-08,fp7d
2020-07-24,SZ,12,11,0,11,2022-05-03_11-02-08,fp7d
2020-07-24,TG,21,38,17,21,2022-05-03_11-02-08,fp7d
2020-07-24,TI,38,51,13,38,2022-05-03_11-02-08,fp7d
2020-07-24,UR,6,6,0,6,2022-05-03_11-02-08,fp7d
2020-07-24,VD,79,90,11,79,2022-05-03_11-02-08,fp7d
2020-07-24,VS,21,27,6,21,2022-05-03_11-02-08,fp7d
2020-07-24,ZG,8,8,0,8,2022-05-03_11-02-08,fp7d
2020-07-24,ZH,192,313,125,188,2022-05-03_11-02-08,fp7d
2020-07-25,AG,52,50,0,50,2022-05-03_11-02-08,fp7d
2020-07-25,AI,0,0,0,0,2022-05-03_11-02-08,fp7d
2020-07-25,AR,6,10,4,6,2022-05-03_11-02-08,fp7d
2020-07-25,BE,83,93,12,81,2022-05-03_11-02-08,fp7d
2020-07-25,BL,20,16,0,16,2022-05-03_11-02-08,fp7d
2020-07-25,BS,54,50,0,50,2022-05-03_11-02-08,fp7d
2020-07-25,FR,24,24,0,24,2022-05-03_11-02-08,fp7d
2020-07-25,GE,40,40,2,38,2022-05-03_11-02-08,fp7d
2020-07-25,GL,NA,NA,NA,NA,2022-05-03_11-02-08,fp7d
2020-07-25,GR,17,20,3,17,2022-05-03_11-02-08,fp7d
2020-07-25,JU,6,6,0,6,2022-05-03_11-02-08,fp7d
2020-07-25,LU,54,52,2,50,2022-05-03_11-02-08,fp7d
2020-07-25,NE,10,10,0,10,2022-05-03_11-02-08,fp7d
2020-07-25,NW,6,3,0,3,2022-05-03_11-02-08,fp7d
2020-07-25,OW,0,0,0,0,2022-05-03_11-02-08,fp7d
2020-07-25,SG,54,55,1,54,2022-05-03_11-02-08,fp7d
2020-07-25,SH,8,8,0,8,2022-05-03_11-02-08,fp7d
2020-07-25,SO,17,17,0,17,2022-05-03_11-02-08,fp7d
2020-07-25,SZ,12,11,0,11,2022-05-03_11-02-08,fp7d
2020-07-25,TG,21,38,17,21,2022-05-03_11-02-08,fp7d
2020-07-25,TI,38,51,13,38,2022-05-03_11-02-08,fp7d
2020-07-25,UR,6,6,0,6,2022-05-03_11-02-08,fp7d
2020-07-25,VD,79,90,11,79,2022-05-03_11-02-08,fp7d
2020-07-25,VS,21,27,6,21,2022-05-03_11-02-08,fp7d
2020-07-25,ZG,8,8,0,8,2022-05-03_11-02-08,fp7d
2020-07-25,ZH,192,313,125,188,2022-05-03_11-02-08,fp7d
2020-07-26,AG,52,50,0,50,2022-05-03_11-02-08,fp7d
2020-07-26,AI,0,0,0,0,2022-05-03_11-02-08,fp7d
2020-07-26,AR,6,10,4,6,2022-05-03_11-02-08,fp7d
2020-07-26,BE,83,93,12,81,2022-05-03_11-02-08,fp7d
2020-07-26,BL,20,16,0,16,2022-05-03_11-02-08,fp7d
2020-07-26,BS,54,50,0,50,2022-05-03_11-02-08,fp7d
2020-07-26,FR,24,24,0,24,2022-05-03_11-02-08,fp7d
2020-07-26,GE,40,40,2,38,2022-05-03_11-02-08,fp7d
2020-07-26,GL,NA,NA,NA,NA,2022-05-03_11-02-08,fp7d
2020-07-26,GR,17,20,3,17,2022-05-03_11-02-08,fp7d
2020-07-26,JU,6,6,0,6,2022-05-03_11-02-08,fp7d
2020-07-26,LU,54,52,2,50,2022-05-03_11-02-08,fp7d
2020-07-26,NE,10,10,0,10,2022-05-03_11-02-08,fp7d
2020-07-26,NW,6,3,0,3,2022-05-03_11-02-08,fp7d
2020-07-26,OW,0,0,0,0,2022-05-03_11-02-08,fp7d
2020-07-26,SG,54,55,1,54,2022-05-03_11-02-08,fp7d
2020-07-26,SH,8,8,0,8,2022-05-03_11-02-08,fp7d
2020-07-26,SO,17,17,0,17,2022-05-03_11-02-08,fp7d
2020-07-26,SZ,12,11,0,11,2022-05-03_11-02-08,fp7d
2020-07-26,TG,21,38,17,21,2022-05-03_11-02-08,fp7d
2020-07-26,TI,38,51,13,38,2022-05-03_11-02-08,fp7d
2020-07-26,UR,6,6,0,6,2022-05-03_11-02-08,fp7d
2020-07-26,VD,79,90,11,79,2022-05-03_11-02-08,fp7d
2020-07-26,VS,21,27,6,21,2022-05-03_11-02-08,fp7d
2020-07-26,ZG,8,8,0,8,2022-05-03_11-02-08,fp7d
2020-07-26,ZH,192,313,125,188,2022-05-03_11-02-08,fp7d
2020-07-27,AG,52,50,0,50,2022-05-03_11-02-08,fp7d
2020-07-27,AI,0,0,0,0,2022-05-03_11-02-08,fp7d
2020-07-27,AR,6,10,4,6,2022-05-03_11-02-08,fp7d
2020-07-27,BE,92,102,12,90,2022-05-03_11-02-08,fp7d
2020-07-27,BL,20,16,0,16,2022-05-03_11-02-08,fp7d
2020-07-27,BS,54,50,0,50,2022-05-03_11-02-08,fp7d
2020-07-27,FR,24,24,0,24,2022-05-03_11-02-08,fp7d
2020-07-27,GE,40,40,2,38,2022-05-03_11-02-08,fp7d
2020-07-27,GL,NA,NA,NA,NA,2022-05-03_11-02-08,fp7d
2020-07-27,GR,17,20,3,17,2022-05-03_11-02-08,fp7d
2020-07-27,JU,6,6,0,6,2022-05-03_11-02-08,fp7d
2020-07-27,LU,40,36,0,36,2022-05-03_11-02-08,fp7d
2020-07-27,NE,10,10,0,10,2022-05-03_11-02-08,fp7d
2020-07-27,NW,6,5,0,5,2022-05-03_11-02-08,fp7d
2020-07-27,OW,0,0,0,0,2022-05-03_11-02-08,fp7d
2020-07-27,SG,54,55,1,54,2022-05-03_11-02-08,fp7d
2020-07-27,SH,8,8,0,8,2022-05-03_11-02-08,fp7d
2020-07-27,SO,17,17,0,17,2022-05-03_11-02-08,fp7d
2020-07-27,SZ,12,11,0,11,2022-05-03_11-02-08,fp7d
2020-07-27,TG,21,38,17,21,2022-05-03_11-02-08,fp7d
2020-07-27,TI,38,51,13,38,2022-05-03_11-02-08,fp7d
2020-07-27,UR,6,6,0,6,2022-05-03_11-02-08,fp7d
2020-07-27,VD,79,90,11,79,2022-05-03_11-02-08,fp7d
2020-07-27,VS,21,27,6,21,2022-05-03_11-02-08,fp7d
2020-07-27,ZG,8,8,0,8,2022-05-03_11-02-08,fp7d
2020-07-27,ZH,192,316,125,191,2022-05-03_11-02-08,fp7d
2020-07-28,AG,52,50,0,50,2022-05-03_11-02-08,fp7d
2020-07-28,AI,0,0,0,0,2022-05-03_11-02-08,fp7d
2020-07-28,AR,6,10,4,6,2022-05-03_11-02-08,fp7d
2020-07-28,BE,92,102,12,90,2022-05-03_11-02-08,fp7d
2020-07-28,BL,20,16,0,16,2022-05-03_11-02-08,fp7d
2020-07-28,BS,54,50,0,50,2022-05-03_11-02-08,fp7d
2020-07-28,FR,24,24,0,24,2022-05-03_11-02-08,fp7d
2020-07-28,GE,40,40,2,38,2022-05-03_11-02-08,fp7d
2020-07-28,GL,NA,NA,NA,NA,2022-05-03_11-02-08,fp7d
2020-07-28,GR,17,20,3,17,2022-05-03_11-02-08,fp7d
2020-07-28,JU,6,6,0,6,2022-05-03_11-02-08,fp7d
2020-07-28,LU,40,36,0,36,2022-05-03_11-02-08,fp7d
2020-07-28,NE,10,10,0,10,2022-05-03_11-02-08,fp7d
2020-07-28,NW,6,5,0,5,2022-05-03_11-02-08,fp7d
2020-07-28,OW,0,0,0,0,2022-05-03_11-02-08,fp7d
2020-07-28,SG,54,55,1,54,2022-05-03_11-02-08,fp7d
2020-07-28,SH,8,8,0,8,2022-05-03_11-02-08,fp7d
2020-07-28,SO,17,17,0,17,2022-05-03_11-02-08,fp7d
2020-07-28,SZ,12,11,0,11,2022-05-03_11-02-08,fp7d
2020-07-28,TG,21,38,17,21,2022-05-03_11-02-08,fp7d
2020-07-28,TI,38,51,13,38,2022-05-03_11-02-08,fp7d
2020-07-28,UR,6,6,0,6,2022-05-03_11-02-08,fp7d
2020-07-28,VD,79,90,11,79,2022-05-03_11-02-08,fp7d
2020-07-28,VS,21,27,6,21,2022-05-03_11-02-08,fp7d
2020-07-28,ZG,8,8,0,8,2022-05-03_11-02-08,fp7d
2020-07-28,ZH,192,316,125,191,2022-05-03_11-02-08,fp7d
2020-07-29,AG,52,50,0,50,2022-05-03_11-02-08,fp7d
2020-07-29,AI,0,0,0,0,2022-05-03_11-02-08,fp7d
2020-07-29,AR,6,10,4,6,2022-05-03_11-02-08,fp7d
2020-07-29,BE,104,114,12,102,2022-05-03_11-02-08,fp7d
2020-07-29,BL,20,16,0,16,2022-05-03_11-02-08,fp7d
2020-07-29,BS,54,50,0,50,2022-05-03_11-02-08,fp7d
2020-07-29,FR,24,24,0,24,2022-05-03_11-02-08,fp7d
2020-07-29,GE,40,40,2,38,2022-05-03_11-02-08,fp7d
2020-07-29,GL,NA,NA,NA,NA,2022-05-03_11-02-08,fp7d
2020-07-29,GR,17,20,3,17,2022-05-03_11-02-08,fp7d
2020-07-29,JU,6,6,0,6,2022-05-03_11-02-08,fp7d
2020-07-29,LU,40,36,0,36,2022-05-03_11-02-08,fp7d
2020-07-29,NE,10,10,0,10,2022-05-03_11-02-08,fp7d
2020-07-29,NW,6,5,0,5,2022-05-03_11-02-08,fp7d
2020-07-29,OW,0,0,0,0,2022-05-03_11-02-08,fp7d
2020-07-29,SG,54,55,1,54,2022-05-03_11-02-08,fp7d
2020-07-29,SH,8,8,0,8,2022-05-03_11-02-08,fp7d
2020-07-29,SO,17,17,0,17,2022-05-03_11-02-08,fp7d
2020-07-29,SZ,12,11,0,11,2022-05-03_11-02-08,fp7d
2020-07-29,TG,21,38,17,21,2022-05-03_11-02-08,fp7d
2020-07-29,TI,38,51,13,38,2022-05-03_11-02-08,fp7d
2020-07-29,UR,6,6,0,6,2022-05-03_11-02-08,fp7d
2020-07-29,VD,79,90,11,79,2022-05-03_11-02-08,fp7d
2020-07-29,VS,21,27,6,21,2022-05-03_11-02-08,fp7d
2020-07-29,ZG,8,8,0,8,2022-05-03_11-02-08,fp7d
2020-07-29,ZH,192,316,125,191,2022-05-03_11-02-08,fp7d
2020-07-30,AG,52,50,0,50,2022-05-03_11-02-08,fp7d
2020-07-30,AI,0,0,0,0,2022-05-03_11-02-08,fp7d
2020-07-30,AR,6,10,4,6,2022-05-03_11-02-08,fp7d
2020-07-30,BE,104,114,12,102,2022-05-03_11-02-08,fp7d
2020-07-30,BL,20,16,0,16,2022-05-03_11-02-08,fp7d
2020-07-30,BS,54,50,0,50,2022-05-03_11-02-08,fp7d
2020-07-30,FR,24,24,0,24,2022-05-03_11-02-08,fp7d
2020-07-30,GE,40,40,2,38,2022-05-03_11-02-08,fp7d
2020-07-30,GL,NA,NA,NA,NA,2022-05-03_11-02-08,fp7d
2020-07-30,GR,17,20,3,17,2022-05-03_11-02-08,fp7d
2020-07-30,JU,6,6,0,6,2022-05-03_11-02-08,fp7d
2020-07-30,LU,54,52,2,50,2022-05-03_11-02-08,fp7d
2020-07-30,NE,10,10,0,10,2022-05-03_11-02-08,fp7d
2020-07-30,NW,6,6,0,6,2022-05-03_11-02-08,fp7d
2020-07-30,OW,0,0,0,0,2022-05-03_11-02-08,fp7d
2020-07-30,SG,54,55,1,54,2022-05-03_11-02-08,fp7d
2020-07-30,SH,8,6,0,6,2022-05-03_11-02-08,fp7d
2020-07-30,SO,17,17,0,17,2022-05-03_11-02-08,fp7d
2020-07-30,SZ,12,11,0,11,2022-05-03_11-02-08,fp7d
2020-07-30,TG,21,38,17,21,2022-05-03_11-02-08,fp7d
2020-07-30,TI,38,51,13,38,2022-05-03_11-02-08,fp7d
2020-07-30,UR,6,6,0,6,2022-05-03_11-02-08,fp7d
2020-07-30,VD,79,90,11,79,2022-05-03_11-02-08,fp7d
2020-07-30,VS,21,27,6,21,2022-05-03_11-02-08,fp7d
2020-07-30,ZG,8,8,0,8,2022-05-03_11-02-08,fp7d
2020-07-30,ZH,192,315,125,190,2022-05-03_11-02-08,fp7d
2020-07-31,AG,52,50,0,50,2022-05-03_11-02-08,fp7d
2020-07-31,AI,0,0,0,0,2022-05-03_11-02-08,fp7d
2020-07-31,AR,6,10,4,6,2022-05-03_11-02-08,fp7d
2020-07-31,BE,104,114,12,102,2022-05-03_11-02-08,fp7d
2020-07-31,BL,20,16,0,16,2022-05-03_11-02-08,fp7d
2020-07-31,BS,54,50,0,50,2022-05-03_11-02-08,fp7d
2020-07-31,FR,24,24,0,24,2022-05-03_11-02-08,fp7d
2020-07-31,GE,40,40,2,38,2022-05-03_11-02-08,fp7d
2020-07-31,GL,NA,NA,NA,NA,2022-05-03_11-02-08,fp7d
2020-07-31,GR,17,20,3,17,2022-05-03_11-02-08,fp7d
2020-07-31,JU,6,6,0,6,2022-05-03_11-02-08,fp7d
2020-07-31,LU,54,52,2,50,2022-05-03_11-02-08,fp7d
2020-07-31,NE,10,10,0,10,2022-05-03_11-02-08,fp7d
2020-07-31,NW,6,6,0,6,2022-05-03_11-02-08,fp7d
2020-07-31,OW,0,0,0,0,2022-05-03_11-02-08,fp7d
2020-07-31,SG,54,55,1,54,2022-05-03_11-02-08,fp7d
2020-07-31,SH,8,6,0,6,2022-05-03_11-02-08,fp7d
2020-07-31,SO,17,17,0,17,2022-05-03_11-02-08,fp7d
2020-07-31,SZ,12,11,0,11,2022-05-03_11-02-08,fp7d
2020-07-31,TG,21,38,17,21,2022-05-03_11-02-08,fp7d
2020-07-31,TI,38,51,13,38,2022-05-03_11-02-08,fp7d
2020-07-31,UR,6,6,0,6,2022-05-03_11-02-08,fp7d
2020-07-31,VD,79,90,11,79,2022-05-03_11-02-08,fp7d
2020-07-31,VS,21,27,6,21,2022-05-03_11-02-08,fp7d
2020-07-31,ZG,8,8,0,8,2022-05-03_11-02-08,fp7d
2020-07-31,ZH,192,315,125,190,2022-05-03_11-02-08,fp7d
2020-08-01,AG,52,50,0,50,2022-05-03_11-02-08,fp7d
2020-08-01,AI,0,0,0,0,2022-05-03_11-02-08,fp7d
2020-08-01,AR,6,10,4,6,2022-05-03_11-02-08,fp7d
2020-08-01,BE,104,114,12,102,2022-05-03_11-02-08,fp7d
2020-08-01,BL,20,16,0,16,2022-05-03_11-02-08,fp7d
2020-08-01,BS,54,50,0,50,2022-05-03_11-02-08,fp7d
2020-08-01,FR,24,24,0,24,2022-05-03_11-02-08,fp7d
2020-08-01,GE,40,40,2,38,2022-05-03_11-02-08,fp7d
2020-08-01,GL,NA,NA,NA,NA,2022-05-03_11-02-08,fp7d
2020-08-01,GR,17,20,3,17,2022-05-03_11-02-08,fp7d
2020-08-01,JU,6,6,0,6,2022-05-03_11-02-08,fp7d
2020-08-01,LU,54,52,2,50,2022-05-03_11-02-08,fp7d
2020-08-01,NE,10,10,0,10,2022-05-03_11-02-08,fp7d
2020-08-01,NW,6,6,0,6,2022-05-03_11-02-08,fp7d
2020-08-01,OW,0,0,0,0,2022-05-03_11-02-08,fp7d
2020-08-01,SG,54,55,1,54,2022-05-03_11-02-08,fp7d
2020-08-01,SH,8,6,0,6,2022-05-03_11-02-08,fp7d
2020-08-01,SO,17,17,0,17,2022-05-03_11-02-08,fp7d
2020-08-01,SZ,12,11,0,11,2022-05-03_11-02-08,fp7d
2020-08-01,TG,21,38,17,21,2022-05-03_11-02-08,fp7d
2020-08-01,TI,38,51,13,38,2022-05-03_11-02-08,fp7d
2020-08-01,UR,6,6,0,6,2022-05-03_11-02-08,fp7d
2020-08-01,VD,79,90,11,79,2022-05-03_11-02-08,fp7d
2020-08-01,VS,21,27,6,21,2022-05-03_11-02-08,fp7d
2020-08-01,ZG,8,8,0,8,2022-05-03_11-02-08,fp7d
2020-08-01,ZH,192,315,125,190,2022-05-03_11-02-08,fp7d
2020-08-02,AG,52,50,0,50,2022-05-03_11-02-08,fp7d
2020-08-02,AI,0,0,0,0,2022-05-03_11-02-08,fp7d
2020-08-02,AR,6,10,4,6,2022-05-03_11-02-08,fp7d
2020-08-02,BE,104,114,12,102,2022-05-03_11-02-08,fp7d
2020-08-02,BL,20,17,1,16,2022-05-03_11-02-08,fp7d
2020-08-02,BS,54,50,0,50,2022-05-03_11-02-08,fp7d
2020-08-02,FR,24,24,0,24,2022-05-03_11-02-08,fp7d
2020-08-02,GE,40,40,2,38,2022-05-03_11-02-08,fp7d
2020-08-02,GL,NA,NA,NA,NA,2022-05-03_11-02-08,fp7d
2020-08-02,GR,17,20,3,17,2022-05-03_11-02-08,fp7d
2020-08-02,JU,6,6,0,6,2022-05-03_11-02-08,fp7d
2020-08-02,LU,54,52,2,50,2022-05-03_11-02-08,fp7d
2020-08-02,NE,10,10,0,10,2022-05-03_11-02-08,fp7d
2020-08-02,NW,6,6,0,6,2022-05-03_11-02-08,fp7d
2020-08-02,OW,0,0,0,0,2022-05-03_11-02-08,fp7d
2020-08-02,SG,54,55,1,54,2022-05-03_11-02-08,fp7d
2020-08-02,SH,8,6,0,6,2022-05-03_11-02-08,fp7d
2020-08-02,SO,17,17,0,17,2022-05-03_11-02-08,fp7d
2020-08-02,SZ,12,11,0,11,2022-05-03_11-02-08,fp7d
2020-08-02,TG,21,38,17,21,2022-05-03_11-02-08,fp7d
2020-08-02,TI,38,51,13,38,2022-05-03_11-02-08,fp7d
2020-08-02,UR,6,6,0,6,2022-05-03_11-02-08,fp7d
2020-08-02,VD,79,90,11,79,2022-05-03_11-02-08,fp7d
2020-08-02,VS,21,27,6,21,2022-05-03_11-02-08,fp7d
2020-08-02,ZG,8,8,0,8,2022-05-03_11-02-08,fp7d
2020-08-02,ZH,192,315,125,190,2022-05-03_11-02-08,fp7d
2020-08-03,AG,52,50,0,50,2022-05-03_11-02-08,fp7d
2020-08-03,AI,0,0,0,0,2022-05-03_11-02-08,fp7d
2020-08-03,AR,6,10,4,6,2022-05-03_11-02-08,fp7d
2020-08-03,BE,104,114,12,102,2022-05-03_11-02-08,fp7d
2020-08-03,BL,20,16,0,16,2022-05-03_11-02-08,fp7d
2020-08-03,BS,54,50,0,50,2022-05-03_11-02-08,fp7d
2020-08-03,FR,24,24,0,24,2022-05-03_11-02-08,fp7d
2020-08-03,GE,40,40,2,38,2022-05-03_11-02-08,fp7d
2020-08-03,GL,NA,NA,NA,NA,2022-05-03_11-02-08,fp7d
2020-08-03,GR,17,20,3,17,2022-05-03_11-02-08,fp7d
2020-08-03,JU,6,6,0,6,2022-05-03_11-02-08,fp7d
2020-08-03,LU,54,52,2,50,2022-05-03_11-02-08,fp7d
2020-08-03,NE,10,10,0,10,2022-05-03_11-02-08,fp7d
2020-08-03,NW,6,6,0,6,2022-05-03_11-02-08,fp7d
2020-08-03,OW,0,0,0,0,2022-05-03_11-02-08,fp7d
2020-08-03,SG,54,55,1,54,2022-05-03_11-02-08,fp7d
2020-08-03,SH,8,8,0,8,2022-05-03_11-02-08,fp7d
2020-08-03,SO,17,17,0,17,2022-05-03_11-02-08,fp7d
2020-08-03,SZ,12,11,0,11,2022-05-03_11-02-08,fp7d
2020-08-03,TG,21,38,17,21,2022-05-03_11-02-08,fp7d
2020-08-03,TI,38,51,13,38,2022-05-03_11-02-08,fp7d
2020-08-03,UR,6,6,0,6,2022-05-03_11-02-08,fp7d
2020-08-03,VD,79,90,11,79,2022-05-03_11-02-08,fp7d
2020-08-03,VS,21,27,6,21,2022-05-03_11-02-08,fp7d
2020-08-03,ZG,8,8,0,8,2022-05-03_11-02-08,fp7d
2020-08-03,ZH,192,316,125,191,2022-05-03_11-02-08,fp7d
2020-08-04,AG,52,50,0,50,2022-05-03_11-02-08,fp7d
2020-08-04,AI,0,0,0,0,2022-05-03_11-02-08,fp7d
2020-08-04,AR,6,10,4,6,2022-05-03_11-02-08,fp7d
2020-08-04,BE,104,114,12,102,2022-05-03_11-02-08,fp7d
2020-08-04,BL,20,16,0,16,2022-05-03_11-02-08,fp7d
2020-08-04,BS,54,50,0,50,2022-05-03_11-02-08,fp7d
2020-08-04,FR,24,24,0,24,2022-05-03_11-02-08,fp7d
2020-08-04,GE,40,40,2,38,2022-05-03_11-02-08,fp7d
2020-08-04,GL,NA,NA,NA,NA,2022-05-03_11-02-08,fp7d
2020-08-04,GR,17,20,3,17,2022-05-03_11-02-08,fp7d
2020-08-04,JU,6,6,0,6,2022-05-03_11-02-08,fp7d
2020-08-04,LU,54,52,2,50,2022-05-03_11-02-08,fp7d
2020-08-04,NE,10,10,0,10,2022-05-03_11-02-08,fp7d
2020-08-04,NW,6,6,0,6,2022-05-03_11-02-08,fp7d
2020-08-04,OW,0,0,0,0,2022-05-03_11-02-08,fp7d
2020-08-04,SG,54,55,1,54,2022-05-03_11-02-08,fp7d
2020-08-04,SH,8,6,0,6,2022-05-03_11-02-08,fp7d
2020-08-04,SO,17,17,0,17,2022-05-03_11-02-08,fp7d
2020-08-04,SZ,12,11,0,11,2022-05-03_11-02-08,fp7d
2020-08-04,TG,21,38,17,21,2022-05-03_11-02-08,fp7d
2020-08-04,TI,38,51,13,38,2022-05-03_11-02-08,fp7d
2020-08-04,UR,6,6,0,6,2022-05-03_11-02-08,fp7d
2020-08-04,VD,79,90,11,79,2022-05-03_11-02-08,fp7d
2020-08-04,VS,21,27,6,21,2022-05-03_11-02-08,fp7d
2020-08-04,ZG,8,8,0,8,2022-05-03_11-02-08,fp7d
2020-08-04,ZH,192,299,111,188,2022-05-03_11-02-08,fp7d
2020-08-05,AG,52,50,0,50,2022-05-03_11-02-08,fp7d
2020-08-05,AI,0,0,0,0,2022-05-03_11-02-08,fp7d
2020-08-05,AR,6,10,4,6,2022-05-03_11-02-08,fp7d
2020-08-05,BE,92,102,12,90,2022-05-03_11-02-08,fp7d
2020-08-05,BL,20,16,0,16,2022-05-03_11-02-08,fp7d
2020-08-05,BS,54,50,0,50,2022-05-03_11-02-08,fp7d
2020-08-05,FR,24,24,0,24,2022-05-03_11-02-08,fp7d
2020-08-05,GE,40,40,2,38,2022-05-03_11-02-08,fp7d
2020-08-05,GL,NA,NA,NA,NA,2022-05-03_11-02-08,fp7d
2020-08-05,GR,17,20,3,17,2022-05-03_11-02-08,fp7d
2020-08-05,JU,6,6,0,6,2022-05-03_11-02-08,fp7d
2020-08-05,LU,54,52,2,50,2022-05-03_11-02-08,fp7d
2020-08-05,NE,10,10,0,10,2022-05-03_11-02-08,fp7d
2020-08-05,NW,6,6,0,6,2022-05-03_11-02-08,fp7d
2020-08-05,OW,0,0,0,0,2022-05-03_11-02-08,fp7d
2020-08-05,SG,54,55,1,54,2022-05-03_11-02-08,fp7d
2020-08-05,SH,8,6,0,6,2022-05-03_11-02-08,fp7d
2020-08-05,SO,17,17,0,17,2022-05-03_11-02-08,fp7d
2020-08-05,SZ,12,12,1,11,2022-05-03_11-02-08,fp7d
2020-08-05,TG,21,38,17,21,2022-05-03_11-02-08,fp7d
2020-08-05,TI,38,51,13,38,2022-05-03_11-02-08,fp7d
2020-08-05,UR,6,6,0,6,2022-05-03_11-02-08,fp7d
2020-08-05,VD,79,90,11,79,2022-05-03_11-02-08,fp7d
2020-08-05,VS,21,27,6,21,2022-05-03_11-02-08,fp7d
2020-08-05,ZG,8,8,0,8,2022-05-03_11-02-08,fp7d
2020-08-05,ZH,198,299,101,198,2022-05-03_11-02-08,fp7d
2020-08-06,AG,52,50,0,50,2022-05-03_11-02-08,fp7d
2020-08-06,AI,0,0,0,0,2022-05-03_11-02-08,fp7d
2020-08-06,AR,6,10,4,6,2022-05-03_11-02-08,fp7d
2020-08-06,BE,92,102,12,90,2022-05-03_11-02-08,fp7d
2020-08-06,BL,20,16,0,16,2022-05-03_11-02-08,fp7d
2020-08-06,BS,54,50,0,50,2022-05-03_11-02-08,fp7d
2020-08-06,FR,24,24,0,24,2022-05-03_11-02-08,fp7d
2020-08-06,GE,40,40,2,38,2022-05-03_11-02-08,fp7d
2020-08-06,GL,NA,NA,NA,NA,2022-05-03_11-02-08,fp7d
2020-08-06,GR,17,20,3,17,2022-05-03_11-02-08,fp7d
2020-08-06,JU,6,6,0,6,2022-05-03_11-02-08,fp7d
2020-08-06,LU,54,52,2,50,2022-05-03_11-02-08,fp7d
2020-08-06,NE,10,10,0,10,2022-05-03_11-02-08,fp7d
2020-08-06,NW,6,6,0,6,2022-05-03_11-02-08,fp7d
2020-08-06,OW,0,0,0,0,2022-05-03_11-02-08,fp7d
2020-08-06,SG,54,55,1,54,2022-05-03_11-02-08,fp7d
2020-08-06,SH,8,6,0,6,2022-05-03_11-02-08,fp7d
2020-08-06,SO,17,17,0,17,2022-05-03_11-02-08,fp7d
2020-08-06,SZ,12,12,1,11,2022-05-03_11-02-08,fp7d
2020-08-06,TG,21,38,17,21,2022-05-03_11-02-08,fp7d
2020-08-06,TI,47,51,13,38,2022-05-03_11-02-08,fp7d
2020-08-06,UR,6,6,0,6,2022-05-03_11-02-08,fp7d
2020-08-06,VD,79,90,11,79,2022-05-03_11-02-08,fp7d
2020-08-06,VS,21,27,6,21,2022-05-03_11-02-08,fp7d
2020-08-06,ZG,8,8,0,8,2022-05-03_11-02-08,fp7d
2020-08-06,ZH,198,299,101,198,2022-05-03_11-02-08,fp7d
2020-08-07,AG,52,50,0,50,2022-05-03_11-02-08,fp7d
2020-08-07,AI,0,0,0,0,2022-05-03_11-02-08,fp7d
2020-08-07,AR,6,10,4,6,2022-05-03_11-02-08,fp7d
2020-08-07,BE,92,102,12,90,2022-05-03_11-02-08,fp7d
2020-08-07,BL,20,16,0,16,2022-05-03_11-02-08,fp7d
2020-08-07,BS,54,50,0,50,2022-05-03_11-02-08,fp7d
2020-08-07,FR,24,24,0,24,2022-05-03_11-02-08,fp7d
2020-08-07,GE,40,40,2,38,2022-05-03_11-02-08,fp7d
2020-08-07,GL,NA,NA,NA,NA,2022-05-03_11-02-08,fp7d
2020-08-07,GR,17,20,3,17,2022-05-03_11-02-08,fp7d
2020-08-07,JU,6,6,0,6,2022-05-03_11-02-08,fp7d
2020-08-07,LU,54,52,2,50,2022-05-03_11-02-08,fp7d
2020-08-07,NE,10,10,0,10,2022-05-03_11-02-08,fp7d
2020-08-07,NW,6,6,0,6,2022-05-03_11-02-08,fp7d
2020-08-07,OW,0,0,0,0,2022-05-03_11-02-08,fp7d
2020-08-07,SG,54,55,1,54,2022-05-03_11-02-08,fp7d
2020-08-07,SH,8,6,0,6,2022-05-03_11-02-08,fp7d
2020-08-07,SO,17,17,0,17,2022-05-03_11-02-08,fp7d
2020-08-07,SZ,12,11,0,11,2022-05-03_11-02-08,fp7d
2020-08-07,TG,21,38,17,21,2022-05-03_11-02-08,fp7d
2020-08-07,TI,47,51,13,38,2022-05-03_11-02-08,fp7d
2020-08-07,UR,6,6,0,6,2022-05-03_11-02-08,fp7d
2020-08-07,VD,79,90,11,79,2022-05-03_11-02-08,fp7d
2020-08-07,VS,21,27,6,21,2022-05-03_11-02-08,fp7d
2020-08-07,ZG,8,8,0,8,2022-05-03_11-02-08,fp7d
2020-08-07,ZH,198,299,101,198,2022-05-03_11-02-08,fp7d
2020-08-08,AG,52,50,0,50,2022-05-03_11-02-08,fp7d
2020-08-08,AI,0,0,0,0,2022-05-03_11-02-08,fp7d
2020-08-08,AR,6,10,4,6,2022-05-03_11-02-08,fp7d
2020-08-08,BE,92,102,12,90,2022-05-03_11-02-08,fp7d
2020-08-08,BL,20,16,0,16,2022-05-03_11-02-08,fp7d
2020-08-08,BS,54,50,0,50,2022-05-03_11-02-08,fp7d
2020-08-08,FR,24,24,0,24,2022-05-03_11-02-08,fp7d
2020-08-08,GE,40,40,2,38,2022-05-03_11-02-08,fp7d
2020-08-08,GL,NA,NA,NA,NA,2022-05-03_11-02-08,fp7d
2020-08-08,GR,17,20,3,17,2022-05-03_11-02-08,fp7d
2020-08-08,JU,6,6,0,6,2022-05-03_11-02-08,fp7d
2020-08-08,LU,40,36,0,36,2022-05-03_11-02-08,fp7d
2020-08-08,NE,10,10,0,10,2022-05-03_11-02-08,fp7d
2020-08-08,NW,6,6,0,6,2022-05-03_11-02-08,fp7d
2020-08-08,OW,0,0,0,0,2022-05-03_11-02-08,fp7d
2020-08-08,SG,54,55,1,54,2022-05-03_11-02-08,fp7d
2020-08-08,SH,8,6,0,6,2022-05-03_11-02-08,fp7d
2020-08-08,SO,17,17,0,17,2022-05-03_11-02-08,fp7d
2020-08-08,SZ,12,11,0,11,2022-05-03_11-02-08,fp7d
2020-08-08,TG,21,38,17,21,2022-05-03_11-02-08,fp7d
2020-08-08,TI,47,51,13,38,2022-05-03_11-02-08,fp7d
2020-08-08,UR,6,6,0,6,2022-05-03_11-02-08,fp7d
2020-08-08,VD,79,90,11,79,2022-05-03_11-02-08,fp7d
2020-08-08,VS,21,27,6,21,2022-05-03_11-02-08,fp7d
2020-08-08,ZG,8,8,0,8,2022-05-03_11-02-08,fp7d
2020-08-08,ZH,198,299,101,198,2022-05-03_11-02-08,fp7d
2020-08-09,AG,52,50,0,50,2022-05-03_11-02-08,fp7d
2020-08-09,AI,0,0,0,0,2022-05-03_11-02-08,fp7d
2020-08-09,AR,6,10,4,6,2022-05-03_11-02-08,fp7d
2020-08-09,BE,92,102,12,90,2022-05-03_11-02-08,fp7d
2020-08-09,BL,20,16,0,16,2022-05-03_11-02-08,fp7d
2020-08-09,BS,54,50,0,50,2022-05-03_11-02-08,fp7d
2020-08-09,FR,24,24,0,24,2022-05-03_11-02-08,fp7d
2020-08-09,GE,40,40,2,38,2022-05-03_11-02-08,fp7d
2020-08-09,GL,NA,NA,NA,NA,2022-05-03_11-02-08,fp7d
2020-08-09,GR,17,20,3,17,2022-05-03_11-02-08,fp7d
2020-08-09,JU,6,6,0,6,2022-05-03_11-02-08,fp7d
2020-08-09,LU,40,36,0,36,2022-05-03_11-02-08,fp7d
2020-08-09,NE,10,10,0,10,2022-05-03_11-02-08,fp7d
2020-08-09,NW,6,6,0,6,2022-05-03_11-02-08,fp7d
2020-08-09,OW,0,0,0,0,2022-05-03_11-02-08,fp7d
2020-08-09,SG,54,55,1,54,2022-05-03_11-02-08,fp7d
2020-08-09,SH,8,6,0,6,2022-05-03_11-02-08,fp7d
2020-08-09,SO,17,17,0,17,2022-05-03_11-02-08,fp7d
2020-08-09,SZ,12,11,0,11,2022-05-03_11-02-08,fp7d
2020-08-09,TG,21,38,17,21,2022-05-03_11-02-08,fp7d
2020-08-09,TI,47,51,13,38,2022-05-03_11-02-08,fp7d
2020-08-09,UR,6,6,0,6,2022-05-03_11-02-08,fp7d
2020-08-09,VD,79,90,11,79,2022-05-03_11-02-08,fp7d
2020-08-09,VS,15,15,0,15,2022-05-03_11-02-08,fp7d
2020-08-09,ZG,8,8,0,8,2022-05-03_11-02-08,fp7d
2020-08-09,ZH,198,299,101,198,2022-05-03_11-02-08,fp7d
2020-08-10,AG,52,50,0,50,2022-05-03_11-02-08,fp7d
2020-08-10,AI,0,0,0,0,2022-05-03_11-02-08,fp7d
2020-08-10,AR,6,10,4,6,2022-05-03_11-02-08,fp7d
2020-08-10,BE,92,102,12,90,2022-05-03_11-02-08,fp7d
2020-08-10,BL,20,15,0,15,2022-05-03_11-02-08,fp7d
2020-08-10,BS,54,50,0,50,2022-05-03_11-02-08,fp7d
2020-08-10,FR,24,24,0,24,2022-05-03_11-02-08,fp7d
2020-08-10,GE,40,40,2,38,2022-05-03_11-02-08,fp7d
2020-08-10,GL,NA,NA,NA,NA,2022-05-03_11-02-08,fp7d
2020-08-10,GR,17,20,3,17,2022-05-03_11-02-08,fp7d
2020-08-10,JU,6,6,0,6,2022-05-03_11-02-08,fp7d
2020-08-10,LU,40,36,0,36,2022-05-03_11-02-08,fp7d
2020-08-10,NE,10,10,0,10,2022-05-03_11-02-08,fp7d
2020-08-10,NW,6,4,0,4,2022-05-03_11-02-08,fp7d
2020-08-10,OW,0,0,0,0,2022-05-03_11-02-08,fp7d
2020-08-10,SG,54,55,1,54,2022-05-03_11-02-08,fp7d
2020-08-10,SH,8,6,0,6,2022-05-03_11-02-08,fp7d
2020-08-10,SO,17,17,0,17,2022-05-03_11-02-08,fp7d
2020-08-10,SZ,12,11,0,11,2022-05-03_11-02-08,fp7d
2020-08-10,TG,21,38,17,21,2022-05-03_11-02-08,fp7d
2020-08-10,TI,47,51,13,38,2022-05-03_11-02-08,fp7d
2020-08-10,UR,6,6,0,6,2022-05-03_11-02-08,fp7d
2020-08-10,VD,79,90,11,79,2022-05-03_11-02-08,fp7d
2020-08-10,VS,15,15,0,15,2022-05-03_11-02-08,fp7d
2020-08-10,ZG,8,8,0,8,2022-05-03_11-02-08,fp7d
2020-08-10,ZH,198,299,101,198,2022-05-03_11-02-08,fp7d
2020-08-11,AG,52,50,0,50,2022-05-03_11-02-08,fp7d
2020-08-11,AI,0,0,0,0,2022-05-03_11-02-08,fp7d
2020-08-11,AR,6,10,4,6,2022-05-03_11-02-08,fp7d
2020-08-11,BE,92,102,12,90,2022-05-03_11-02-08,fp7d
2020-08-11,BL,20,15,0,15,2022-05-03_11-02-08,fp7d
2020-08-11,BS,54,50,0,50,2022-05-03_11-02-08,fp7d
2020-08-11,FR,24,24,0,24,2022-05-03_11-02-08,fp7d
2020-08-11,GE,40,40,2,38,2022-05-03_11-02-08,fp7d
2020-08-11,GL,NA,NA,NA,NA,2022-05-03_11-02-08,fp7d
2020-08-11,GR,17,20,3,17,2022-05-03_11-02-08,fp7d
2020-08-11,JU,6,6,0,6,2022-05-03_11-02-08,fp7d
2020-08-11,LU,40,36,0,36,2022-05-03_11-02-08,fp7d
2020-08-11,NE,10,10,0,10,2022-05-03_11-02-08,fp7d
2020-08-11,NW,6,4,0,4,2022-05-03_11-02-08,fp7d
2020-08-11,OW,0,0,0,0,2022-05-03_11-02-08,fp7d
2020-08-11,SG,54,55,1,54,2022-05-03_11-02-08,fp7d
2020-08-11,SH,8,5,0,5,2022-05-03_11-02-08,fp7d
2020-08-11,SO,17,17,0,17,2022-05-03_11-02-08,fp7d
2020-08-11,SZ,12,11,0,11,2022-05-03_11-02-08,fp7d
2020-08-11,TG,21,38,17,21,2022-05-03_11-02-08,fp7d
2020-08-11,TI,47,51,13,38,2022-05-03_11-02-08,fp7d
2020-08-11,UR,6,6,0,6,2022-05-03_11-02-08,fp7d
2020-08-11,VD,79,90,11,79,2022-05-03_11-02-08,fp7d
2020-08-11,VS,15,15,0,15,2022-05-03_11-02-08,fp7d
2020-08-11,ZG,8,8,0,8,2022-05-03_11-02-08,fp7d
2020-08-11,ZH,198,299,101,198,2022-05-03_11-02-08,fp7d
2020-08-12,AG,52,50,0,50,2022-05-03_11-02-08,fp7d
2020-08-12,AI,0,0,0,0,2022-05-03_11-02-08,fp7d
2020-08-12,AR,6,10,4,6,2022-05-03_11-02-08,fp7d
2020-08-12,BE,92,102,12,90,2022-05-03_11-02-08,fp7d
2020-08-12,BL,20,15,0,15,2022-05-03_11-02-08,fp7d
2020-08-12,BS,46,42,0,42,2022-05-03_11-02-08,fp7d
2020-08-12,FR,24,24,0,24,2022-05-03_11-02-08,fp7d
2020-08-12,GE,40,40,2,38,2022-05-03_11-02-08,fp7d
2020-08-12,GL,NA,NA,NA,NA,2022-05-03_11-02-08,fp7d
2020-08-12,GR,17,20,3,17,2022-05-03_11-02-08,fp7d
2020-08-12,JU,6,6,0,6,2022-05-03_11-02-08,fp7d
2020-08-12,LU,40,36,0,36,2022-05-03_11-02-08,fp7d
2020-08-12,NE,10,10,0,10,2022-05-03_11-02-08,fp7d
2020-08-12,NW,6,6,0,6,2022-05-03_11-02-08,fp7d
2020-08-12,OW,0,0,0,0,2022-05-03_11-02-08,fp7d
2020-08-12,SG,54,55,1,54,2022-05-03_11-02-08,fp7d
2020-08-12,SH,8,5,0,5,2022-05-03_11-02-08,fp7d
2020-08-12,SO,17,16,0,16,2022-05-03_11-02-08,fp7d
2020-08-12,SZ,12,11,0,11,2022-05-03_11-02-08,fp7d
2020-08-12,TG,21,38,17,21,2022-05-03_11-02-08,fp7d
2020-08-12,TI,47,51,13,38,2022-05-03_11-02-08,fp7d
2020-08-12,UR,6,6,0,6,2022-05-03_11-02-08,fp7d
2020-08-12,VD,79,90,11,79,2022-05-03_11-02-08,fp7d
2020-08-12,VS,15,15,0,15,2022-05-03_11-02-08,fp7d
2020-08-12,ZG,8,8,0,8,2022-05-03_11-02-08,fp7d
2020-08-12,ZH,198,299,101,198,2022-05-03_11-02-08,fp7d
2020-08-13,AG,52,50,0,50,2022-05-03_11-02-08,fp7d
2020-08-13,AI,0,0,0,0,2022-05-03_11-02-08,fp7d
2020-08-13,AR,6,10,4,6,2022-05-03_11-02-08,fp7d
2020-08-13,BE,92,102,12,90,2022-05-03_11-02-08,fp7d
2020-08-13,BL,20,15,0,15,2022-05-03_11-02-08,fp7d
2020-08-13,BS,54,50,0,50,2022-05-03_11-02-08,fp7d
2020-08-13,FR,24,24,0,24,2022-05-03_11-02-08,fp7d
2020-08-13,GE,40,40,2,38,2022-05-03_11-02-08,fp7d
2020-08-13,GL,NA,NA,NA,NA,2022-05-03_11-02-08,fp7d
2020-08-13,GR,17,20,3,17,2022-05-03_11-02-08,fp7d
2020-08-13,JU,6,6,0,6,2022-05-03_11-02-08,fp7d
2020-08-13,LU,40,36,0,36,2022-05-03_11-02-08,fp7d
2020-08-13,NE,10,10,0,10,2022-05-03_11-02-08,fp7d
2020-08-13,NW,6,6,0,6,2022-05-03_11-02-08,fp7d
2020-08-13,OW,0,0,0,0,2022-05-03_11-02-08,fp7d
2020-08-13,SG,54,55,1,54,2022-05-03_11-02-08,fp7d
2020-08-13,SH,8,5,0,5,2022-05-03_11-02-08,fp7d
2020-08-13,SO,17,16,0,16,2022-05-03_11-02-08,fp7d
2020-08-13,SZ,12,11,0,11,2022-05-03_11-02-08,fp7d
2020-08-13,TG,21,38,17,21,2022-05-03_11-02-08,fp7d
2020-08-13,TI,47,51,13,38,2022-05-03_11-02-08,fp7d
2020-08-13,UR,6,6,0,6,2022-05-03_11-02-08,fp7d
2020-08-13,VD,79,90,11,79,2022-05-03_11-02-08,fp7d
2020-08-13,VS,15,15,0,15,2022-05-03_11-02-08,fp7d
2020-08-13,ZG,8,8,0,8,2022-05-03_11-02-08,fp7d
2020-08-13,ZH,198,300,102,198,2022-05-03_11-02-08,fp7d
2020-08-14,AG,52,50,0,50,2022-05-03_11-02-08,fp7d
2020-08-14,AI,0,0,0,0,2022-05-03_11-02-08,fp7d
2020-08-14,AR,6,10,4,6,2022-05-03_11-02-08,fp7d
2020-08-14,BE,92,102,12,90,2022-05-03_11-02-08,fp7d
2020-08-14,BL,20,15,0,15,2022-05-03_11-02-08,fp7d
2020-08-14,BS,54,50,0,50,2022-05-03_11-02-08,fp7d
2020-08-14,FR,24,24,0,24,2022-05-03_11-02-08,fp7d
2020-08-14,GE,40,40,2,38,2022-05-03_11-02-08,fp7d
2020-08-14,GL,NA,NA,NA,NA,2022-05-03_11-02-08,fp7d
2020-08-14,GR,17,20,3,17,2022-05-03_11-02-08,fp7d
2020-08-14,JU,6,6,0,6,2022-05-03_11-02-08,fp7d
2020-08-14,LU,40,36,0,36,2022-05-03_11-02-08,fp7d
2020-08-14,NE,10,10,0,10,2022-05-03_11-02-08,fp7d
2020-08-14,NW,6,6,0,6,2022-05-03_11-02-08,fp7d
2020-08-14,OW,0,0,0,0,2022-05-03_11-02-08,fp7d
2020-08-14,SG,54,55,1,54,2022-05-03_11-02-08,fp7d
2020-08-14,SH,8,5,0,5,2022-05-03_11-02-08,fp7d
2020-08-14,SO,17,16,0,16,2022-05-03_11-02-08,fp7d
2020-08-14,SZ,12,11,0,11,2022-05-03_11-02-08,fp7d
2020-08-14,TG,21,38,17,21,2022-05-03_11-02-08,fp7d
2020-08-14,TI,47,51,13,38,2022-05-03_11-02-08,fp7d
2020-08-14,UR,6,6,0,6,2022-05-03_11-02-08,fp7d
2020-08-14,VD,79,90,11,79,2022-05-03_11-02-08,fp7d
2020-08-14,VS,15,15,0,15,2022-05-03_11-02-08,fp7d
2020-08-14,ZG,8,8,0,8,2022-05-03_11-02-08,fp7d
2020-08-14,ZH,198,299,101,198,2022-05-03_11-02-08,fp7d
2020-08-15,AG,52,49,0,49,2022-05-03_11-02-08,fp7d
2020-08-15,AI,0,0,0,0,2022-05-03_11-02-08,fp7d
2020-08-15,AR,6,10,4,6,2022-05-03_11-02-08,fp7d
2020-08-15,BE,92,102,12,90,2022-05-03_11-02-08,fp7d
2020-08-15,BL,20,15,0,15,2022-05-03_11-02-08,fp7d
2020-08-15,BS,54,50,0,50,2022-05-03_11-02-08,fp7d
2020-08-15,FR,24,24,0,24,2022-05-03_11-02-08,fp7d
2020-08-15,GE,40,40,2,38,2022-05-03_11-02-08,fp7d
2020-08-15,GL,NA,NA,NA,NA,2022-05-03_11-02-08,fp7d
2020-08-15,GR,17,20,3,17,2022-05-03_11-02-08,fp7d
2020-08-15,JU,6,6,0,6,2022-05-03_11-02-08,fp7d
2020-08-15,LU,40,36,0,36,2022-05-03_11-02-08,fp7d
2020-08-15,NE,10,10,0,10,2022-05-03_11-02-08,fp7d
2020-08-15,NW,6,6,0,6,2022-05-03_11-02-08,fp7d
2020-08-15,OW,0,0,0,0,2022-05-03_11-02-08,fp7d
2020-08-15,SG,54,55,1,54,2022-05-03_11-02-08,fp7d
2020-08-15,SH,8,4,0,4,2022-05-03_11-02-08,fp7d
2020-08-15,SO,17,16,0,16,2022-05-03_11-02-08,fp7d
2020-08-15,SZ,12,11,0,11,2022-05-03_11-02-08,fp7d
2020-08-15,TG,21,38,17,21,2022-05-03_11-02-08,fp7d
2020-08-15,TI,47,51,13,38,2022-05-03_11-02-08,fp7d
2020-08-15,UR,6,6,0,6,2022-05-03_11-02-08,fp7d
2020-08-15,VD,79,90,11,79,2022-05-03_11-02-08,fp7d
2020-08-15,VS,15,15,0,15,2022-05-03_11-02-08,fp7d
2020-08-15,ZG,8,8,0,8,2022-05-03_11-02-08,fp7d
2020-08-15,ZH,198,299,101,198,2022-05-03_11-02-08,fp7d
2020-08-16,AG,52,49,0,49,2022-05-03_11-02-08,fp7d
2020-08-16,AI,0,0,0,0,2022-05-03_11-02-08,fp7d
2020-08-16,AR,6,10,4,6,2022-05-03_11-02-08,fp7d
2020-08-16,BE,92,102,12,90,2022-05-03_11-02-08,fp7d
2020-08-16,BL,20,15,0,15,2022-05-03_11-02-08,fp7d
2020-08-16,BS,54,50,0,50,2022-05-03_11-02-08,fp7d
2020-08-16,FR,24,24,0,24,2022-05-03_11-02-08,fp7d
2020-08-16,GE,40,40,2,38,2022-05-03_11-02-08,fp7d
2020-08-16,GL,NA,NA,NA,NA,2022-05-03_11-02-08,fp7d
2020-08-16,GR,17,20,3,17,2022-05-03_11-02-08,fp7d
2020-08-16,JU,6,6,0,6,2022-05-03_11-02-08,fp7d
2020-08-16,LU,40,36,0,36,2022-05-03_11-02-08,fp7d
2020-08-16,NE,10,10,0,10,2022-05-03_11-02-08,fp7d
2020-08-16,NW,6,6,0,6,2022-05-03_11-02-08,fp7d
2020-08-16,OW,0,0,0,0,2022-05-03_11-02-08,fp7d
2020-08-16,SG,54,55,1,54,2022-05-03_11-02-08,fp7d
2020-08-16,SH,8,4,0,4,2022-05-03_11-02-08,fp7d
2020-08-16,SO,17,16,0,16,2022-05-03_11-02-08,fp7d
2020-08-16,SZ,12,11,0,11,2022-05-03_11-02-08,fp7d
2020-08-16,TG,21,38,17,21,2022-05-03_11-02-08,fp7d
2020-08-16,TI,47,51,13,38,2022-05-03_11-02-08,fp7d
2020-08-16,UR,6,6,0,6,2022-05-03_11-02-08,fp7d
2020-08-16,VD,79,90,11,79,2022-05-03_11-02-08,fp7d
2020-08-16,VS,15,15,0,15,2022-05-03_11-02-08,fp7d
2020-08-16,ZG,8,8,0,8,2022-05-03_11-02-08,fp7d
2020-08-16,ZH,198,299,101,198,2022-05-03_11-02-08,fp7d
2020-08-17,AG,52,50,0,50,2022-05-03_11-02-08,fp7d
2020-08-17,AI,0,0,0,0,2022-05-03_11-02-08,fp7d
2020-08-17,AR,6,10,4,6,2022-05-03_11-02-08,fp7d
2020-08-17,BE,92,102,12,90,2022-05-03_11-02-08,fp7d
2020-08-17,BL,20,15,0,15,2022-05-03_11-02-08,fp7d
2020-08-17,BS,54,50,0,50,2022-05-03_11-02-08,fp7d
2020-08-17,FR,24,24,0,24,2022-05-03_11-02-08,fp7d
2020-08-17,GE,40,40,2,38,2022-05-03_11-02-08,fp7d
2020-08-17,GL,NA,NA,NA,NA,2022-05-03_11-02-08,fp7d
2020-08-17,GR,17,17,0,17,2022-05-03_11-02-08,fp7d
2020-08-17,JU,6,6,0,6,2022-05-03_11-02-08,fp7d
2020-08-17,LU,40,36,0,36,2022-05-03_11-02-08,fp7d
2020-08-17,NE,10,10,0,10,2022-05-03_11-02-08,fp7d
2020-08-17,NW,6,6,0,6,2022-05-03_11-02-08,fp7d
2020-08-17,OW,0,0,0,0,2022-05-03_11-02-08,fp7d
2020-08-17,SG,54,55,1,54,2022-05-03_11-02-08,fp7d
2020-08-17,SH,8,4,0,4,2022-05-03_11-02-08,fp7d
2020-08-17,SO,17,17,0,17,2022-05-03_11-02-08,fp7d
2020-08-17,SZ,12,11,0,11,2022-05-03_11-02-08,fp7d
2020-08-17,TG,21,38,17,21,2022-05-03_11-02-08,fp7d
2020-08-17,TI,47,51,13,38,2022-05-03_11-02-08,fp7d
2020-08-17,UR,6,6,0,6,2022-05-03_11-02-08,fp7d
2020-08-17,VD,79,90,11,79,2022-05-03_11-02-08,fp7d
2020-08-17,VS,15,15,0,15,2022-05-03_11-02-08,fp7d
2020-08-17,ZG,8,8,0,8,2022-05-03_11-02-08,fp7d
2020-08-17,ZH,198,299,101,198,2022-05-03_11-02-08,fp7d
2020-08-18,AG,52,50,0,50,2022-05-03_11-02-08,fp7d
2020-08-18,AI,0,0,0,0,2022-05-03_11-02-08,fp7d
2020-08-18,AR,6,10,4,6,2022-05-03_11-02-08,fp7d
2020-08-18,BE,92,102,12,90,2022-05-03_11-02-08,fp7d
2020-08-18,BL,20,15,0,15,2022-05-03_11-02-08,fp7d
2020-08-18,BS,54,50,0,50,2022-05-03_11-02-08,fp7d
2020-08-18,FR,24,24,0,24,2022-05-03_11-02-08,fp7d
2020-08-18,GE,40,40,2,38,2022-05-03_11-02-08,fp7d
2020-08-18,GL,NA,NA,NA,NA,2022-05-03_11-02-08,fp7d
2020-08-18,GR,17,20,3,17,2022-05-03_11-02-08,fp7d
2020-08-18,JU,6,6,0,6,2022-05-03_11-02-08,fp7d
2020-08-18,LU,40,36,0,36,2022-05-03_11-02-08,fp7d
2020-08-18,NE,10,10,0,10,2022-05-03_11-02-08,fp7d
2020-08-18,NW,6,6,0,6,2022-05-03_11-02-08,fp7d
2020-08-18,OW,0,0,0,0,2022-05-03_11-02-08,fp7d
2020-08-18,SG,54,55,1,54,2022-05-03_11-02-08,fp7d
2020-08-18,SH,8,4,0,4,2022-05-03_11-02-08,fp7d
2020-08-18,SO,17,17,0,17,2022-05-03_11-02-08,fp7d
2020-08-18,SZ,12,11,0,11,2022-05-03_11-02-08,fp7d
2020-08-18,TG,21,38,17,21,2022-05-03_11-02-08,fp7d
2020-08-18,TI,47,51,13,38,2022-05-03_11-02-08,fp7d
2020-08-18,UR,6,6,0,6,2022-05-03_11-02-08,fp7d
2020-08-18,VD,79,90,11,79,2022-05-03_11-02-08,fp7d
2020-08-18,VS,15,15,0,15,2022-05-03_11-02-08,fp7d
2020-08-18,ZG,8,8,0,8,2022-05-03_11-02-08,fp7d
2020-08-18,ZH,198,299,101,198,2022-05-03_11-02-08,fp7d
2020-08-19,AG,52,50,0,50,2022-05-03_11-02-08,fp7d
2020-08-19,AI,0,0,0,0,2022-05-03_11-02-08,fp7d
2020-08-19,AR,6,10,4,6,2022-05-03_11-02-08,fp7d
2020-08-19,BE,104,113,12,101,2022-05-03_11-02-08,fp7d
2020-08-19,BL,20,15,0,15,2022-05-03_11-02-08,fp7d
2020-08-19,BS,54,50,0,50,2022-05-03_11-02-08,fp7d
2020-08-19,FR,24,24,0,24,2022-05-03_11-02-08,fp7d
2020-08-19,GE,40,40,2,38,2022-05-03_11-02-08,fp7d
2020-08-19,GL,NA,NA,NA,NA,2022-05-03_11-02-08,fp7d
2020-08-19,GR,17,20,3,17,2022-05-03_11-02-08,fp7d
2020-08-19,JU,6,6,0,6,2022-05-03_11-02-08,fp7d
2020-08-19,LU,40,36,0,36,2022-05-03_11-02-08,fp7d
2020-08-19,NE,10,10,0,10,2022-05-03_11-02-08,fp7d
2020-08-19,NW,6,6,0,6,2022-05-03_11-02-08,fp7d
2020-08-19,OW,0,0,0,0,2022-05-03_11-02-08,fp7d
2020-08-19,SG,54,55,1,54,2022-05-03_11-02-08,fp7d
2020-08-19,SH,8,5,0,5,2022-05-03_11-02-08,fp7d
2020-08-19,SO,17,17,0,17,2022-05-03_11-02-08,fp7d
2020-08-19,SZ,12,11,0,11,2022-05-03_11-02-08,fp7d
2020-08-19,TG,21,38,17,21,2022-05-03_11-02-08,fp7d
2020-08-19,TI,47,51,13,38,2022-05-03_11-02-08,fp7d
2020-08-19,UR,6,6,0,6,2022-05-03_11-02-08,fp7d
2020-08-19,VD,79,90,11,79,2022-05-03_11-02-08,fp7d
2020-08-19,VS,15,15,0,15,2022-05-03_11-02-08,fp7d
2020-08-19,ZG,8,8,0,8,2022-05-03_11-02-08,fp7d
2020-08-19,ZH,198,299,101,198,2022-05-03_11-02-08,fp7d
2020-08-20,AG,52,50,0,50,2022-05-03_11-02-08,fp7d
2020-08-20,AI,0,0,0,0,2022-05-03_11-02-08,fp7d
2020-08-20,AR,6,10,4,6,2022-05-03_11-02-08,fp7d
2020-08-20,BE,104,114,12,102,2022-05-03_11-02-08,fp7d
2020-08-20,BL,20,15,0,15,2022-05-03_11-02-08,fp7d
2020-08-20,BS,54,50,0,50,2022-05-03_11-02-08,fp7d
2020-08-20,FR,24,24,0,24,2022-05-03_11-02-08,fp7d
2020-08-20,GE,40,40,2,38,2022-05-03_11-02-08,fp7d
2020-08-20,GL,NA,NA,NA,NA,2022-05-03_11-02-08,fp7d
2020-08-20,GR,17,20,3,17,2022-05-03_11-02-08,fp7d
2020-08-20,JU,6,6,0,6,2022-05-03_11-02-08,fp7d
2020-08-20,LU,40,36,0,36,2022-05-03_11-02-08,fp7d
2020-08-20,NE,10,10,0,10,2022-05-03_11-02-08,fp7d
2020-08-20,NW,6,6,0,6,2022-05-03_11-02-08,fp7d
2020-08-20,OW,0,0,0,0,2022-05-03_11-02-08,fp7d
2020-08-20,SG,54,55,1,54,2022-05-03_11-02-08,fp7d
2020-08-20,SH,8,5,0,5,2022-05-03_11-02-08,fp7d
2020-08-20,SO,17,17,0,17,2022-05-03_11-02-08,fp7d
2020-08-20,SZ,12,11,0,11,2022-05-03_11-02-08,fp7d
2020-08-20,TG,21,38,17,21,2022-05-03_11-02-08,fp7d
2020-08-20,TI,47,51,13,38,2022-05-03_11-02-08,fp7d
2020-08-20,UR,6,6,0,6,2022-05-03_11-02-08,fp7d
2020-08-20,VD,79,90,11,79,2022-05-03_11-02-08,fp7d
2020-08-20,VS,15,15,0,15,2022-05-03_11-02-08,fp7d
2020-08-20,ZG,8,8,0,8,2022-05-03_11-02-08,fp7d
2020-08-20,ZH,198,299,101,198,2022-05-03_11-02-08,fp7d
2020-08-21,AG,52,50,0,50,2022-05-03_11-02-08,fp7d
2020-08-21,AI,0,0,0,0,2022-05-03_11-02-08,fp7d
2020-08-21,AR,6,10,4,6,2022-05-03_11-02-08,fp7d
2020-08-21,BE,104,114,12,102,2022-05-03_11-02-08,fp7d
2020-08-21,BL,20,15,0,15,2022-05-03_11-02-08,fp7d
2020-08-21,BS,54,50,0,50,2022-05-03_11-02-08,fp7d
2020-08-21,FR,24,24,0,24,2022-05-03_11-02-08,fp7d
2020-08-21,GE,40,40,2,38,2022-05-03_11-02-08,fp7d
2020-08-21,GL,NA,NA,NA,NA,2022-05-03_11-02-08,fp7d
2020-08-21,GR,17,20,3,17,2022-05-03_11-02-08,fp7d
2020-08-21,JU,6,6,0,6,2022-05-03_11-02-08,fp7d
2020-08-21,LU,40,36,0,36,2022-05-03_11-02-08,fp7d
2020-08-21,NE,10,10,0,10,2022-05-03_11-02-08,fp7d
2020-08-21,NW,6,6,0,6,2022-05-03_11-02-08,fp7d
2020-08-21,OW,0,0,0,0,2022-05-03_11-02-08,fp7d
2020-08-21,SG,54,55,1,54,2022-05-03_11-02-08,fp7d
2020-08-21,SH,8,6,0,6,2022-05-03_11-02-08,fp7d
2020-08-21,SO,17,17,0,17,2022-05-03_11-02-08,fp7d
2020-08-21,SZ,12,11,0,11,2022-05-03_11-02-08,fp7d
2020-08-21,TG,21,38,17,21,2022-05-03_11-02-08,fp7d
2020-08-21,TI,47,51,13,38,2022-05-03_11-02-08,fp7d
2020-08-21,UR,6,6,0,6,2022-05-03_11-02-08,fp7d
2020-08-21,VD,79,89,11,78,2022-05-03_11-02-08,fp7d
2020-08-21,VS,15,15,0,15,2022-05-03_11-02-08,fp7d
2020-08-21,ZG,8,8,0,8,2022-05-03_11-02-08,fp7d
2020-08-21,ZH,198,300,102,198,2022-05-03_11-02-08,fp7d
2020-08-22,AG,52,50,0,50,2022-05-03_11-02-08,fp7d
2020-08-22,AI,0,0,0,0,2022-05-03_11-02-08,fp7d
2020-08-22,AR,6,10,4,6,2022-05-03_11-02-08,fp7d
2020-08-22,BE,104,114,12,102,2022-05-03_11-02-08,fp7d
2020-08-22,BL,20,15,0,15,2022-05-03_11-02-08,fp7d
2020-08-22,BS,54,50,0,50,2022-05-03_11-02-08,fp7d
2020-08-22,FR,24,24,0,24,2022-05-03_11-02-08,fp7d
2020-08-22,GE,40,40,2,38,2022-05-03_11-02-08,fp7d
2020-08-22,GL,NA,NA,NA,NA,2022-05-03_11-02-08,fp7d
2020-08-22,GR,17,20,3,17,2022-05-03_11-02-08,fp7d
2020-08-22,JU,6,6,0,6,2022-05-03_11-02-08,fp7d
2020-08-22,LU,40,36,0,36,2022-05-03_11-02-08,fp7d
2020-08-22,NE,10,10,0,10,2022-05-03_11-02-08,fp7d
2020-08-22,NW,6,6,0,6,2022-05-03_11-02-08,fp7d
2020-08-22,OW,0,0,0,0,2022-05-03_11-02-08,fp7d
2020-08-22,SG,54,55,1,54,2022-05-03_11-02-08,fp7d
2020-08-22,SH,8,6,0,6,2022-05-03_11-02-08,fp7d
2020-08-22,SO,17,17,0,17,2022-05-03_11-02-08,fp7d
2020-08-22,SZ,12,11,0,11,2022-05-03_11-02-08,fp7d
2020-08-22,TG,21,38,17,21,2022-05-03_11-02-08,fp7d
2020-08-22,TI,47,51,13,38,2022-05-03_11-02-08,fp7d
2020-08-22,UR,6,6,0,6,2022-05-03_11-02-08,fp7d
2020-08-22,VD,79,89,11,78,2022-05-03_11-02-08,fp7d
2020-08-22,VS,15,15,0,15,2022-05-03_11-02-08,fp7d
2020-08-22,ZG,8,8,0,8,2022-05-03_11-02-08,fp7d
2020-08-22,ZH,198,300,102,198,2022-05-03_11-02-08,fp7d
2020-08-23,AG,52,50,0,50,2022-05-03_11-02-08,fp7d
2020-08-23,AI,0,0,0,0,2022-05-03_11-02-08,fp7d
2020-08-23,AR,6,10,4,6,2022-05-03_11-02-08,fp7d
2020-08-23,BE,104,114,12,102,2022-05-03_11-02-08,fp7d
2020-08-23,BL,20,15,0,15,2022-05-03_11-02-08,fp7d
2020-08-23,BS,54,50,0,50,2022-05-03_11-02-08,fp7d
2020-08-23,FR,24,24,0,24,2022-05-03_11-02-08,fp7d
2020-08-23,GE,40,40,2,38,2022-05-03_11-02-08,fp7d
2020-08-23,GL,NA,NA,NA,NA,2022-05-03_11-02-08,fp7d
2020-08-23,GR,17,20,3,17,2022-05-03_11-02-08,fp7d
2020-08-23,JU,6,6,0,6,2022-05-03_11-02-08,fp7d
2020-08-23,LU,40,36,0,36,2022-05-03_11-02-08,fp7d
2020-08-23,NE,10,10,0,10,2022-05-03_11-02-08,fp7d
2020-08-23,NW,6,6,0,6,2022-05-03_11-02-08,fp7d
2020-08-23,OW,0,0,0,0,2022-05-03_11-02-08,fp7d
2020-08-23,SG,54,55,1,54,2022-05-03_11-02-08,fp7d
2020-08-23,SH,8,6,0,6,2022-05-03_11-02-08,fp7d
2020-08-23,SO,17,17,0,17,2022-05-03_11-02-08,fp7d
2020-08-23,SZ,12,11,0,11,2022-05-03_11-02-08,fp7d
2020-08-23,TG,21,38,17,21,2022-05-03_11-02-08,fp7d
2020-08-23,TI,47,51,13,38,2022-05-03_11-02-08,fp7d
2020-08-23,UR,6,6,0,6,2022-05-03_11-02-08,fp7d
2020-08-23,VD,79,89,11,78,2022-05-03_11-02-08,fp7d
2020-08-23,VS,15,15,0,15,2022-05-03_11-02-08,fp7d
2020-08-23,ZG,8,8,0,8,2022-05-03_11-02-08,fp7d
2020-08-23,ZH,198,300,102,198,2022-05-03_11-02-08,fp7d
2020-08-24,AG,52,50,0,50,2022-05-03_11-02-08,fp7d
2020-08-24,AI,0,0,0,0,2022-05-03_11-02-08,fp7d
2020-08-24,AR,6,10,4,6,2022-05-03_11-02-08,fp7d
2020-08-24,BE,104,114,12,102,2022-05-03_11-02-08,fp7d
2020-08-24,BL,20,15,0,15,2022-05-03_11-02-08,fp7d
2020-08-24,BS,54,50,0,50,2022-05-03_11-02-08,fp7d
2020-08-24,FR,24,24,0,24,2022-05-03_11-02-08,fp7d
2020-08-24,GE,40,40,2,38,2022-05-03_11-02-08,fp7d
2020-08-24,GL,NA,NA,NA,NA,2022-05-03_11-02-08,fp7d
2020-08-24,GR,17,20,3,17,2022-05-03_11-02-08,fp7d
2020-08-24,JU,6,6,0,6,2022-05-03_11-02-08,fp7d
2020-08-24,LU,40,36,0,36,2022-05-03_11-02-08,fp7d
2020-08-24,NE,10,10,0,10,2022-05-03_11-02-08,fp7d
2020-08-24,NW,6,6,0,6,2022-05-03_11-02-08,fp7d
2020-08-24,OW,0,0,0,0,2022-05-03_11-02-08,fp7d
2020-08-24,SG,54,55,1,54,2022-05-03_11-02-08,fp7d
2020-08-24,SH,8,6,0,6,2022-05-03_11-02-08,fp7d
2020-08-24,SO,17,17,0,17,2022-05-03_11-02-08,fp7d
2020-08-24,SZ,12,11,0,11,2022-05-03_11-02-08,fp7d
2020-08-24,TG,21,38,17,21,2022-05-03_11-02-08,fp7d
2020-08-24,TI,47,51,13,38,2022-05-03_11-02-08,fp7d
2020-08-24,UR,6,6,0,6,2022-05-03_11-02-08,fp7d
2020-08-24,VD,79,90,11,79,2022-05-03_11-02-08,fp7d
2020-08-24,VS,21,27,6,21,2022-05-03_11-02-08,fp7d
2020-08-24,ZG,8,8,0,8,2022-05-03_11-02-08,fp7d
2020-08-24,ZH,198,299,101,198,2022-05-03_11-02-08,fp7d
2020-08-25,AG,52,50,0,50,2022-05-03_11-02-08,fp7d
2020-08-25,AI,0,0,0,0,2022-05-03_11-02-08,fp7d
2020-08-25,AR,6,10,4,6,2022-05-03_11-02-08,fp7d
2020-08-25,BE,104,114,12,102,2022-05-03_11-02-08,fp7d
2020-08-25,BL,20,15,0,15,2022-05-03_11-02-08,fp7d
2020-08-25,BS,54,50,0,50,2022-05-03_11-02-08,fp7d
2020-08-25,FR,24,24,0,24,2022-05-03_11-02-08,fp7d
2020-08-25,GE,40,40,2,38,2022-05-03_11-02-08,fp7d
2020-08-25,GL,NA,NA,NA,NA,2022-05-03_11-02-08,fp7d
2020-08-25,GR,17,20,3,17,2022-05-03_11-02-08,fp7d
2020-08-25,JU,6,6,0,6,2022-05-03_11-02-08,fp7d
2020-08-25,LU,40,36,0,36,2022-05-03_11-02-08,fp7d
2020-08-25,NE,10,10,0,10,2022-05-03_11-02-08,fp7d
2020-08-25,NW,6,6,0,6,2022-05-03_11-02-08,fp7d
2020-08-25,OW,0,0,0,0,2022-05-03_11-02-08,fp7d
2020-08-25,SG,54,55,1,54,2022-05-03_11-02-08,fp7d
2020-08-25,SH,8,6,0,6,2022-05-03_11-02-08,fp7d
2020-08-25,SO,17,17,0,17,2022-05-03_11-02-08,fp7d
2020-08-25,SZ,12,11,0,11,2022-05-03_11-02-08,fp7d
2020-08-25,TG,21,38,17,21,2022-05-03_11-02-08,fp7d
2020-08-25,TI,47,51,13,38,2022-05-03_11-02-08,fp7d
2020-08-25,UR,6,6,0,6,2022-05-03_11-02-08,fp7d
2020-08-25,VD,79,90,11,79,2022-05-03_11-02-08,fp7d
2020-08-25,VS,21,27,6,21,2022-05-03_11-02-08,fp7d
2020-08-25,ZG,8,8,0,8,2022-05-03_11-02-08,fp7d
2020-08-25,ZH,198,299,101,198,2022-05-03_11-02-08,fp7d
2020-08-26,AG,52,50,0,50,2022-05-03_11-02-08,fp7d
2020-08-26,AI,0,0,0,0,2022-05-03_11-02-08,fp7d
2020-08-26,AR,6,10,4,6,2022-05-03_11-02-08,fp7d
2020-08-26,BE,104,114,12,102,2022-05-03_11-02-08,fp7d
2020-08-26,BL,20,15,0,15,2022-05-03_11-02-08,fp7d
2020-08-26,BS,54,50,0,50,2022-05-03_11-02-08,fp7d
2020-08-26,FR,24,24,0,24,2022-05-03_11-02-08,fp7d
2020-08-26,GE,40,42,4,38,2022-05-03_11-02-08,fp7d
2020-08-26,GL,NA,NA,NA,NA,2022-05-03_11-02-08,fp7d
2020-08-26,GR,17,20,3,17,2022-05-03_11-02-08,fp7d
2020-08-26,JU,6,6,0,6,2022-05-03_11-02-08,fp7d
2020-08-26,LU,54,52,2,50,2022-05-03_11-02-08,fp7d
2020-08-26,NE,10,10,0,10,2022-05-03_11-02-08,fp7d
2020-08-26,NW,6,6,0,6,2022-05-03_11-02-08,fp7d
2020-08-26,OW,0,0,0,0,2022-05-03_11-02-08,fp7d
2020-08-26,SG,54,55,1,54,2022-05-03_11-02-08,fp7d
2020-08-26,SH,8,6,0,6,2022-05-03_11-02-08,fp7d
2020-08-26,SO,17,17,0,17,2022-05-03_11-02-08,fp7d
2020-08-26,SZ,12,11,0,11,2022-05-03_11-02-08,fp7d
2020-08-26,TG,21,38,17,21,2022-05-03_11-02-08,fp7d
2020-08-26,TI,47,51,13,38,2022-05-03_11-02-08,fp7d
2020-08-26,UR,6,6,0,6,2022-05-03_11-02-08,fp7d
2020-08-26,VD,79,90,11,79,2022-05-03_11-02-08,fp7d
2020-08-26,VS,21,27,6,21,2022-05-03_11-02-08,fp7d
2020-08-26,ZG,8,8,0,8,2022-05-03_11-02-08,fp7d
2020-08-26,ZH,198,301,103,198,2022-05-03_11-02-08,fp7d
2020-08-27,AG,52,50,0,50,2022-05-03_11-02-08,fp7d
2020-08-27,AI,0,0,0,0,2022-05-03_11-02-08,fp7d
2020-08-27,AR,6,10,4,6,2022-05-03_11-02-08,fp7d
2020-08-27,BE,104,114,12,102,2022-05-03_11-02-08,fp7d
2020-08-27,BL,20,15,0,15,2022-05-03_11-02-08,fp7d
2020-08-27,BS,54,50,0,50,2022-05-03_11-02-08,fp7d
2020-08-27,FR,24,24,0,24,2022-05-03_11-02-08,fp7d
2020-08-27,GE,40,40,2,38,2022-05-03_11-02-08,fp7d
2020-08-27,GL,NA,NA,NA,NA,2022-05-03_11-02-08,fp7d
2020-08-27,GR,17,20,3,17,2022-05-03_11-02-08,fp7d
2020-08-27,JU,6,6,0,6,2022-05-03_11-02-08,fp7d
2020-08-27,LU,54,52,2,50,2022-05-03_11-02-08,fp7d
2020-08-27,NE,10,10,0,10,2022-05-03_11-02-08,fp7d
2020-08-27,NW,6,6,0,6,2022-05-03_11-02-08,fp7d
2020-08-27,OW,0,0,0,0,2022-05-03_11-02-08,fp7d
2020-08-27,SG,54,55,1,54,2022-05-03_11-02-08,fp7d
2020-08-27,SH,8,6,0,6,2022-05-03_11-02-08,fp7d
2020-08-27,SO,17,17,0,17,2022-05-03_11-02-08,fp7d
2020-08-27,SZ,12,11,0,11,2022-05-03_11-02-08,fp7d
2020-08-27,TG,21,38,17,21,2022-05-03_11-02-08,fp7d
2020-08-27,TI,47,51,13,38,2022-05-03_11-02-08,fp7d
2020-08-27,UR,6,6,0,6,2022-05-03_11-02-08,fp7d
2020-08-27,VD,79,90,11,79,2022-05-03_11-02-08,fp7d
2020-08-27,VS,21,27,6,21,2022-05-03_11-02-08,fp7d
2020-08-27,ZG,8,8,0,8,2022-05-03_11-02-08,fp7d
2020-08-27,ZH,198,301,103,198,2022-05-03_11-02-08,fp7d
2020-08-28,AG,52,50,0,50,2022-05-03_11-02-08,fp7d
2020-08-28,AI,0,0,0,0,2022-05-03_11-02-08,fp7d
2020-08-28,AR,6,10,4,6,2022-05-03_11-02-08,fp7d
2020-08-28,BE,104,114,12,102,2022-05-03_11-02-08,fp7d
2020-08-28,BL,20,15,0,15,2022-05-03_11-02-08,fp7d
2020-08-28,BS,54,50,0,50,2022-05-03_11-02-08,fp7d
2020-08-28,FR,24,24,0,24,2022-05-03_11-02-08,fp7d
2020-08-28,GE,40,40,2,38,2022-05-03_11-02-08,fp7d
2020-08-28,GL,NA,NA,NA,NA,2022-05-03_11-02-08,fp7d
2020-08-28,GR,17,20,3,17,2022-05-03_11-02-08,fp7d
2020-08-28,JU,6,6,0,6,2022-05-03_11-02-08,fp7d
2020-08-28,LU,54,52,2,50,2022-05-03_11-02-08,fp7d
2020-08-28,NE,10,10,0,10,2022-05-03_11-02-08,fp7d
2020-08-28,NW,6,6,0,6,2022-05-03_11-02-08,fp7d
2020-08-28,OW,0,0,0,0,2022-05-03_11-02-08,fp7d
2020-08-28,SG,54,55,1,54,2022-05-03_11-02-08,fp7d
2020-08-28,SH,8,6,0,6,2022-05-03_11-02-08,fp7d
2020-08-28,SO,17,17,0,17,2022-05-03_11-02-08,fp7d
2020-08-28,SZ,12,12,0,12,2022-05-03_11-02-08,fp7d
2020-08-28,TG,21,38,17,21,2022-05-03_11-02-08,fp7d
2020-08-28,TI,47,51,13,38,2022-05-03_11-02-08,fp7d
2020-08-28,UR,6,6,0,6,2022-05-03_11-02-08,fp7d
2020-08-28,VD,79,94,15,79,2022-05-03_11-02-08,fp7d
2020-08-28,VS,21,27,6,21,2022-05-03_11-02-08,fp7d
2020-08-28,ZG,8,8,0,8,2022-05-03_11-02-08,fp7d
2020-08-28,ZH,198,300,102,198,2022-05-03_11-02-08,fp7d
2020-08-29,AG,52,50,0,50,2022-05-03_11-02-08,fp7d
2020-08-29,AI,0,0,0,0,2022-05-03_11-02-08,fp7d
2020-08-29,AR,6,10,4,6,2022-05-03_11-02-08,fp7d
2020-08-29,BE,104,114,12,102,2022-05-03_11-02-08,fp7d
2020-08-29,BL,20,17,2,15,2022-05-03_11-02-08,fp7d
2020-08-29,BS,54,50,0,50,2022-05-03_11-02-08,fp7d
2020-08-29,FR,24,24,0,24,2022-05-03_11-02-08,fp7d
2020-08-29,GE,40,40,2,38,2022-05-03_11-02-08,fp7d
2020-08-29,GL,NA,NA,NA,NA,2022-05-03_11-02-08,fp7d
2020-08-29,GR,17,20,3,17,2022-05-03_11-02-08,fp7d
2020-08-29,JU,6,6,0,6,2022-05-03_11-02-08,fp7d
2020-08-29,LU,54,52,2,50,2022-05-03_11-02-08,fp7d
2020-08-29,NE,10,10,0,10,2022-05-03_11-02-08,fp7d
2020-08-29,NW,6,6,0,6,2022-05-03_11-02-08,fp7d
2020-08-29,OW,0,0,0,0,2022-05-03_11-02-08,fp7d
2020-08-29,SG,54,55,1,54,2022-05-03_11-02-08,fp7d
2020-08-29,SH,8,6,0,6,2022-05-03_11-02-08,fp7d
2020-08-29,SO,17,17,0,17,2022-05-03_11-02-08,fp7d
2020-08-29,SZ,12,12,0,12,2022-05-03_11-02-08,fp7d
2020-08-29,TG,21,38,17,21,2022-05-03_11-02-08,fp7d
2020-08-29,TI,47,51,13,38,2022-05-03_11-02-08,fp7d
2020-08-29,UR,6,6,0,6,2022-05-03_11-02-08,fp7d
2020-08-29,VD,79,94,15,79,2022-05-03_11-02-08,fp7d
2020-08-29,VS,21,27,6,21,2022-05-03_11-02-08,fp7d
2020-08-29,ZG,8,8,0,8,2022-05-03_11-02-08,fp7d
2020-08-29,ZH,198,300,102,198,2022-05-03_11-02-08,fp7d
2020-08-30,AG,52,50,0,50,2022-05-03_11-02-08,fp7d
2020-08-30,AI,0,0,0,0,2022-05-03_11-02-08,fp7d
2020-08-30,AR,6,10,4,6,2022-05-03_11-02-08,fp7d
2020-08-30,BE,104,114,12,102,2022-05-03_11-02-08,fp7d
2020-08-30,BL,20,17,2,15,2022-05-03_11-02-08,fp7d
2020-08-30,BS,54,50,0,50,2022-05-03_11-02-08,fp7d
2020-08-30,FR,24,24,0,24,2022-05-03_11-02-08,fp7d
2020-08-30,GE,40,40,2,38,2022-05-03_11-02-08,fp7d
2020-08-30,GL,NA,NA,NA,NA,2022-05-03_11-02-08,fp7d
2020-08-30,GR,17,20,3,17,2022-05-03_11-02-08,fp7d
2020-08-30,JU,6,6,0,6,2022-05-03_11-02-08,fp7d
2020-08-30,LU,54,52,2,50,2022-05-03_11-02-08,fp7d
2020-08-30,NE,10,10,0,10,2022-05-03_11-02-08,fp7d
2020-08-30,NW,6,6,0,6,2022-05-03_11-02-08,fp7d
2020-08-30,OW,0,0,0,0,2022-05-03_11-02-08,fp7d
2020-08-30,SG,54,55,1,54,2022-05-03_11-02-08,fp7d
2020-08-30,SH,8,6,0,6,2022-05-03_11-02-08,fp7d
2020-08-30,SO,17,17,0,17,2022-05-03_11-02-08,fp7d
2020-08-30,SZ,12,12,0,12,2022-05-03_11-02-08,fp7d
2020-08-30,TG,21,38,17,21,2022-05-03_11-02-08,fp7d
2020-08-30,TI,47,51,13,38,2022-05-03_11-02-08,fp7d
2020-08-30,UR,6,6,0,6,2022-05-03_11-02-08,fp7d
2020-08-30,VD,79,94,15,79,2022-05-03_11-02-08,fp7d
2020-08-30,VS,21,27,6,21,2022-05-03_11-02-08,fp7d
2020-08-30,ZG,8,8,0,8,2022-05-03_11-02-08,fp7d
2020-08-30,ZH,198,300,102,198,2022-05-03_11-02-08,fp7d
2020-08-31,AG,52,50,0,50,2022-05-03_11-02-08,fp7d
2020-08-31,AI,0,0,0,0,2022-05-03_11-02-08,fp7d
2020-08-31,AR,6,10,4,6,2022-05-03_11-02-08,fp7d
2020-08-31,BE,104,116,12,104,2022-05-03_11-02-08,fp7d
2020-08-31,BL,20,16,1,15,2022-05-03_11-02-08,fp7d
2020-08-31,BS,54,50,0,50,2022-05-03_11-02-08,fp7d
2020-08-31,FR,24,24,0,24,2022-05-03_11-02-08,fp7d
2020-08-31,GE,40,40,2,38,2022-05-03_11-02-08,fp7d
2020-08-31,GL,NA,NA,NA,NA,2022-05-03_11-02-08,fp7d
2020-08-31,GR,17,20,3,17,2022-05-03_11-02-08,fp7d
2020-08-31,JU,6,6,0,6,2022-05-03_11-02-08,fp7d
2020-08-31,LU,54,52,2,50,2022-05-03_11-02-08,fp7d
2020-08-31,NE,10,10,0,10,2022-05-03_11-02-08,fp7d
2020-08-31,NW,6,6,0,6,2022-05-03_11-02-08,fp7d
2020-08-31,OW,0,0,0,0,2022-05-03_11-02-08,fp7d
2020-08-31,SG,54,55,1,54,2022-05-03_11-02-08,fp7d
2020-08-31,SH,8,6,0,6,2022-05-03_11-02-08,fp7d
2020-08-31,SO,17,17,0,17,2022-05-03_11-02-08,fp7d
2020-08-31,SZ,12,11,0,11,2022-05-03_11-02-08,fp7d
2020-08-31,TG,21,38,17,21,2022-05-03_11-02-08,fp7d
2020-08-31,TI,47,51,13,38,2022-05-03_11-02-08,fp7d
2020-08-31,UR,6,6,0,6,2022-05-03_11-02-08,fp7d
2020-08-31,VD,79,85,6,79,2022-05-03_11-02-08,fp7d
2020-08-31,VS,15,15,0,15,2022-05-03_11-02-08,fp7d
2020-08-31,ZG,8,8,0,8,2022-05-03_11-02-08,fp7d
2020-08-31,ZH,198,300,102,198,2022-05-03_11-02-08,fp7d
2020-09-01,AG,52,50,0,50,2022-05-03_11-02-08,fp7d
2020-09-01,AI,0,0,0,0,2022-05-03_11-02-08,fp7d
2020-09-01,AR,6,10,4,6,2022-05-03_11-02-08,fp7d
2020-09-01,BE,104,114,12,102,2022-05-03_11-02-08,fp7d
2020-09-01,BL,20,15,0,15,2022-05-03_11-02-08,fp7d
2020-09-01,BS,54,50,0,50,2022-05-03_11-02-08,fp7d
2020-09-01,FR,24,24,0,24,2022-05-03_11-02-08,fp7d
2020-09-01,GE,40,40,2,38,2022-05-03_11-02-08,fp7d
2020-09-01,GL,NA,NA,NA,NA,2022-05-03_11-02-08,fp7d
2020-09-01,GR,16,16,0,16,2022-05-03_11-02-08,fp7d
2020-09-01,JU,6,6,0,6,2022-05-03_11-02-08,fp7d
2020-09-01,LU,54,52,2,50,2022-05-03_11-02-08,fp7d
2020-09-01,NE,10,10,0,10,2022-05-03_11-02-08,fp7d
2020-09-01,NW,6,6,0,6,2022-05-03_11-02-08,fp7d
2020-09-01,OW,0,0,0,0,2022-05-03_11-02-08,fp7d
2020-09-01,SG,54,55,1,54,2022-05-03_11-02-08,fp7d
2020-09-01,SH,8,6,0,6,2022-05-03_11-02-08,fp7d
2020-09-01,SO,17,17,0,17,2022-05-03_11-02-08,fp7d
2020-09-01,SZ,12,11,0,11,2022-05-03_11-02-08,fp7d
2020-09-01,TG,21,38,17,21,2022-05-03_11-02-08,fp7d
2020-09-01,TI,47,51,13,38,2022-05-03_11-02-08,fp7d
2020-09-01,UR,6,6,0,6,2022-05-03_11-02-08,fp7d
2020-09-01,VD,85,98,13,85,2022-05-03_11-02-08,fp7d
2020-09-01,VS,15,15,0,15,2022-05-03_11-02-08,fp7d
2020-09-01,ZG,8,8,0,8,2022-05-03_11-02-08,fp7d
2020-09-01,ZH,198,300,102,198,2022-05-03_11-02-08,fp7d
2020-09-02,AG,52,50,0,50,2022-05-03_11-02-08,fp7d
2020-09-02,AI,0,0,0,0,2022-05-03_11-02-08,fp7d
2020-09-02,AR,6,10,4,6,2022-05-03_11-02-08,fp7d
2020-09-02,BE,92,102,12,90,2022-05-03_11-02-08,fp7d
2020-09-02,BL,20,15,0,15,2022-05-03_11-02-08,fp7d
2020-09-02,BS,54,50,0,50,2022-05-03_11-02-08,fp7d
2020-09-02,FR,24,24,0,24,2022-05-03_11-02-08,fp7d
2020-09-02,GE,40,40,2,38,2022-05-03_11-02-08,fp7d
2020-09-02,GL,NA,NA,NA,NA,2022-05-03_11-02-08,fp7d
2020-09-02,GR,16,16,0,16,2022-05-03_11-02-08,fp7d
2020-09-02,JU,6,6,0,6,2022-05-03_11-02-08,fp7d
2020-09-02,LU,54,52,2,50,2022-05-03_11-02-08,fp7d
2020-09-02,NE,10,10,0,10,2022-05-03_11-02-08,fp7d
2020-09-02,NW,6,6,0,6,2022-05-03_11-02-08,fp7d
2020-09-02,OW,0,0,0,0,2022-05-03_11-02-08,fp7d
2020-09-02,SG,54,55,1,54,2022-05-03_11-02-08,fp7d
2020-09-02,SH,8,6,0,6,2022-05-03_11-02-08,fp7d
2020-09-02,SO,17,17,0,17,2022-05-03_11-02-08,fp7d
2020-09-02,SZ,12,11,0,11,2022-05-03_11-02-08,fp7d
2020-09-02,TG,21,38,17,21,2022-05-03_11-02-08,fp7d
2020-09-02,TI,47,51,13,38,2022-05-03_11-02-08,fp7d
2020-09-02,UR,6,6,0,6,2022-05-03_11-02-08,fp7d
2020-09-02,VD,85,98,13,85,2022-05-03_11-02-08,fp7d
2020-09-02,VS,15,15,0,15,2022-05-03_11-02-08,fp7d
2020-09-02,ZG,8,8,0,8,2022-05-03_11-02-08,fp7d
2020-09-02,ZH,198,300,102,198,2022-05-03_11-02-08,fp7d
2020-09-03,AG,52,50,0,50,2022-05-03_11-02-08,fp7d
2020-09-03,AI,0,0,0,0,2022-05-03_11-02-08,fp7d
2020-09-03,AR,6,10,4,6,2022-05-03_11-02-08,fp7d
2020-09-03,BE,104,114,12,102,2022-05-03_11-02-08,fp7d
2020-09-03,BL,20,16,0,16,2022-05-03_11-02-08,fp7d
2020-09-03,BS,54,50,0,50,2022-05-03_11-02-08,fp7d
2020-09-03,FR,24,22,0,22,2022-05-03_11-02-08,fp7d
2020-09-03,GE,40,40,2,38,2022-05-03_11-02-08,fp7d
2020-09-03,GL,NA,NA,NA,NA,2022-05-03_11-02-08,fp7d
2020-09-03,GR,16,16,0,16,2022-05-03_11-02-08,fp7d
2020-09-03,JU,6,6,0,6,2022-05-03_11-02-08,fp7d
2020-09-03,LU,54,52,2,50,2022-05-03_11-02-08,fp7d
2020-09-03,NE,10,10,0,10,2022-05-03_11-02-08,fp7d
2020-09-03,NW,6,6,0,6,2022-05-03_11-02-08,fp7d
2020-09-03,OW,0,0,0,0,2022-05-03_11-02-08,fp7d
2020-09-03,SG,54,55,1,54,2022-05-03_11-02-08,fp7d
2020-09-03,SH,8,6,0,6,2022-05-03_11-02-08,fp7d
2020-09-03,SO,17,17,0,17,2022-05-03_11-02-08,fp7d
2020-09-03,SZ,12,11,0,11,2022-05-03_11-02-08,fp7d
2020-09-03,TG,21,38,17,21,2022-05-03_11-02-08,fp7d
2020-09-03,TI,47,60,13,47,2022-05-03_11-02-08,fp7d
2020-09-03,UR,6,6,0,6,2022-05-03_11-02-08,fp7d
2020-09-03,VD,85,98,13,85,2022-05-03_11-02-08,fp7d
2020-09-03,VS,15,15,0,15,2022-05-03_11-02-08,fp7d
2020-09-03,ZG,8,8,0,8,2022-05-03_11-02-08,fp7d
2020-09-03,ZH,198,300,102,198,2022-05-03_11-02-08,fp7d
2020-09-04,AG,52,50,0,50,2022-05-03_11-02-08,fp7d
2020-09-04,AI,0,0,0,0,2022-05-03_11-02-08,fp7d
2020-09-04,AR,6,10,4,6,2022-05-03_11-02-08,fp7d
2020-09-04,BE,104,114,12,102,2022-05-03_11-02-08,fp7d
2020-09-04,BL,20,16,0,16,2022-05-03_11-02-08,fp7d
2020-09-04,BS,54,50,0,50,2022-05-03_11-02-08,fp7d
2020-09-04,FR,24,22,0,22,2022-05-03_11-02-08,fp7d
2020-09-04,GE,40,40,2,38,2022-05-03_11-02-08,fp7d
2020-09-04,GL,NA,NA,NA,NA,2022-05-03_11-02-08,fp7d
2020-09-04,GR,16,16,0,16,2022-05-03_11-02-08,fp7d
2020-09-04,JU,6,6,0,6,2022-05-03_11-02-08,fp7d
2020-09-04,LU,40,36,0,36,2022-05-03_11-02-08,fp7d
2020-09-04,NE,10,10,0,10,2022-05-03_11-02-08,fp7d
2020-09-04,NW,6,6,0,6,2022-05-03_11-02-08,fp7d
2020-09-04,OW,0,0,0,0,2022-05-03_11-02-08,fp7d
2020-09-04,SG,54,55,1,54,2022-05-03_11-02-08,fp7d
2020-09-04,SH,8,6,0,6,2022-05-03_11-02-08,fp7d
2020-09-04,SO,17,17,0,17,2022-05-03_11-02-08,fp7d
2020-09-04,SZ,12,11,0,11,2022-05-03_11-02-08,fp7d
2020-09-04,TG,21,38,17,21,2022-05-03_11-02-08,fp7d
2020-09-04,TI,47,60,13,47,2022-05-03_11-02-08,fp7d
2020-09-04,UR,6,6,0,6,2022-05-03_11-02-08,fp7d
2020-09-04,VD,85,98,13,85,2022-05-03_11-02-08,fp7d
2020-09-04,VS,15,15,0,15,2022-05-03_11-02-08,fp7d
2020-09-04,ZG,8,8,0,8,2022-05-03_11-02-08,fp7d
2020-09-04,ZH,198,300,102,198,2022-05-03_11-02-08,fp7d
2020-09-05,AG,52,50,0,50,2022-05-03_11-02-08,fp7d
2020-09-05,AI,0,0,0,0,2022-05-03_11-02-08,fp7d
2020-09-05,AR,6,10,4,6,2022-05-03_11-02-08,fp7d
2020-09-05,BE,104,114,12,102,2022-05-03_11-02-08,fp7d
2020-09-05,BL,20,16,0,16,2022-05-03_11-02-08,fp7d
2020-09-05,BS,54,50,0,50,2022-05-03_11-02-08,fp7d
2020-09-05,FR,24,22,0,22,2022-05-03_11-02-08,fp7d
2020-09-05,GE,40,40,2,38,2022-05-03_11-02-08,fp7d
2020-09-05,GL,NA,NA,NA,NA,2022-05-03_11-02-08,fp7d
2020-09-05,GR,16,16,0,16,2022-05-03_11-02-08,fp7d
2020-09-05,JU,6,6,0,6,2022-05-03_11-02-08,fp7d
2020-09-05,LU,40,36,0,36,2022-05-03_11-02-08,fp7d
2020-09-05,NE,10,10,0,10,2022-05-03_11-02-08,fp7d
2020-09-05,NW,6,6,0,6,2022-05-03_11-02-08,fp7d
2020-09-05,OW,0,0,0,0,2022-05-03_11-02-08,fp7d
2020-09-05,SG,54,55,1,54,2022-05-03_11-02-08,fp7d
2020-09-05,SH,8,6,0,6,2022-05-03_11-02-08,fp7d
2020-09-05,SO,17,17,0,17,2022-05-03_11-02-08,fp7d
2020-09-05,SZ,12,11,0,11,2022-05-03_11-02-08,fp7d
2020-09-05,TG,21,38,17,21,2022-05-03_11-02-08,fp7d
2020-09-05,TI,47,60,13,47,2022-05-03_11-02-08,fp7d
2020-09-05,UR,6,6,0,6,2022-05-03_11-02-08,fp7d
2020-09-05,VD,85,98,13,85,2022-05-03_11-02-08,fp7d
2020-09-05,VS,21,27,6,21,2022-05-03_11-02-08,fp7d
2020-09-05,ZG,8,8,0,8,2022-05-03_11-02-08,fp7d
2020-09-05,ZH,198,300,102,198,2022-05-03_11-02-08,fp7d
2020-09-06,AG,52,50,0,50,2022-05-03_11-02-08,fp7d
2020-09-06,AI,0,0,0,0,2022-05-03_11-02-08,fp7d
2020-09-06,AR,6,10,4,6,2022-05-03_11-02-08,fp7d
2020-09-06,BE,104,114,12,102,2022-05-03_11-02-08,fp7d
2020-09-06,BL,20,16,0,16,2022-05-03_11-02-08,fp7d
2020-09-06,BS,54,50,0,50,2022-05-03_11-02-08,fp7d
2020-09-06,FR,24,22,0,22,2022-05-03_11-02-08,fp7d
2020-09-06,GE,40,40,2,38,2022-05-03_11-02-08,fp7d
2020-09-06,GL,NA,NA,NA,NA,2022-05-03_11-02-08,fp7d
2020-09-06,GR,16,16,0,16,2022-05-03_11-02-08,fp7d
2020-09-06,JU,6,6,0,6,2022-05-03_11-02-08,fp7d
2020-09-06,LU,40,36,0,36,2022-05-03_11-02-08,fp7d
2020-09-06,NE,10,10,0,10,2022-05-03_11-02-08,fp7d
2020-09-06,NW,6,6,0,6,2022-05-03_11-02-08,fp7d
2020-09-06,OW,0,0,0,0,2022-05-03_11-02-08,fp7d
2020-09-06,SG,54,55,1,54,2022-05-03_11-02-08,fp7d
2020-09-06,SH,8,6,0,6,2022-05-03_11-02-08,fp7d
2020-09-06,SO,17,17,0,17,2022-05-03_11-02-08,fp7d
2020-09-06,SZ,12,11,0,11,2022-05-03_11-02-08,fp7d
2020-09-06,TG,21,38,17,21,2022-05-03_11-02-08,fp7d
2020-09-06,TI,47,60,13,47,2022-05-03_11-02-08,fp7d
2020-09-06,UR,6,6,0,6,2022-05-03_11-02-08,fp7d
2020-09-06,VD,85,98,13,85,2022-05-03_11-02-08,fp7d
2020-09-06,VS,21,27,6,21,2022-05-03_11-02-08,fp7d
2020-09-06,ZG,8,8,0,8,2022-05-03_11-02-08,fp7d
2020-09-06,ZH,198,300,102,198,2022-05-03_11-02-08,fp7d
2020-09-07,AG,52,50,0,50,2022-05-03_11-02-08,fp7d
2020-09-07,AI,0,0,0,0,2022-05-03_11-02-08,fp7d
2020-09-07,AR,6,10,4,6,2022-05-03_11-02-08,fp7d
2020-09-07,BE,104,114,12,102,2022-05-03_11-02-08,fp7d
2020-09-07,BL,20,16,0,16,2022-05-03_11-02-08,fp7d
2020-09-07,BS,54,50,0,50,2022-05-03_11-02-08,fp7d
2020-09-07,FR,24,22,0,22,2022-05-03_11-02-08,fp7d
2020-09-07,GE,40,40,2,38,2022-05-03_11-02-08,fp7d
2020-09-07,GL,NA,NA,NA,NA,2022-05-03_11-02-08,fp7d
2020-09-07,GR,16,16,0,16,2022-05-03_11-02-08,fp7d
2020-09-07,JU,6,6,0,6,2022-05-03_11-02-08,fp7d
2020-09-07,LU,40,36,0,36,2022-05-03_11-02-08,fp7d
2020-09-07,NE,10,10,0,10,2022-05-03_11-02-08,fp7d
2020-09-07,NW,6,6,0,6,2022-05-03_11-02-08,fp7d
2020-09-07,OW,0,0,0,0,2022-05-03_11-02-08,fp7d
2020-09-07,SG,54,55,1,54,2022-05-03_11-02-08,fp7d
2020-09-07,SH,8,6,0,6,2022-05-03_11-02-08,fp7d
2020-09-07,SO,17,17,0,17,2022-05-03_11-02-08,fp7d
2020-09-07,SZ,12,11,0,11,2022-05-03_11-02-08,fp7d
2020-09-07,TG,21,38,17,21,2022-05-03_11-02-08,fp7d
2020-09-07,TI,47,60,13,47,2022-05-03_11-02-08,fp7d
2020-09-07,UR,6,6,0,6,2022-05-03_11-02-08,fp7d
2020-09-07,VD,85,98,13,85,2022-05-03_11-02-08,fp7d
2020-09-07,VS,21,27,6,21,2022-05-03_11-02-08,fp7d
2020-09-07,ZG,8,8,0,8,2022-05-03_11-02-08,fp7d
2020-09-07,ZH,198,300,102,198,2022-05-03_11-02-08,fp7d
2020-09-08,AG,52,50,0,50,2022-05-03_11-02-08,fp7d
2020-09-08,AI,0,0,0,0,2022-05-03_11-02-08,fp7d
2020-09-08,AR,6,10,4,6,2022-05-03_11-02-08,fp7d
2020-09-08,BE,104,114,12,102,2022-05-03_11-02-08,fp7d
2020-09-08,BL,20,16,0,16,2022-05-03_11-02-08,fp7d
2020-09-08,BS,54,50,0,50,2022-05-03_11-02-08,fp7d
2020-09-08,FR,24,22,0,22,2022-05-03_11-02-08,fp7d
2020-09-08,GE,40,40,2,38,2022-05-03_11-02-08,fp7d
2020-09-08,GL,NA,NA,NA,NA,2022-05-03_11-02-08,fp7d
2020-09-08,GR,16,16,0,16,2022-05-03_11-02-08,fp7d
2020-09-08,JU,6,6,0,6,2022-05-03_11-02-08,fp7d
2020-09-08,LU,40,36,0,36,2022-05-03_11-02-08,fp7d
2020-09-08,NE,10,10,0,10,2022-05-03_11-02-08,fp7d
2020-09-08,NW,6,6,0,6,2022-05-03_11-02-08,fp7d
2020-09-08,OW,0,0,0,0,2022-05-03_11-02-08,fp7d
2020-09-08,SG,54,55,1,54,2022-05-03_11-02-08,fp7d
2020-09-08,SH,8,7,0,7,2022-05-03_11-02-08,fp7d
2020-09-08,SO,17,17,0,17,2022-05-03_11-02-08,fp7d
2020-09-08,SZ,12,11,0,11,2022-05-03_11-02-08,fp7d
2020-09-08,TG,21,38,17,21,2022-05-03_11-02-08,fp7d
2020-09-08,TI,47,60,13,47,2022-05-03_11-02-08,fp7d
2020-09-08,UR,6,6,0,6,2022-05-03_11-02-08,fp7d
2020-09-08,VD,85,98,13,85,2022-05-03_11-02-08,fp7d
2020-09-08,VS,21,27,6,21,2022-05-03_11-02-08,fp7d
2020-09-08,ZG,8,8,0,8,2022-05-03_11-02-08,fp7d
2020-09-08,ZH,198,299,101,198,2022-05-03_11-02-08,fp7d
2020-09-09,AG,52,50,0,50,2022-05-03_11-02-08,fp7d
2020-09-09,AI,0,0,0,0,2022-05-03_11-02-08,fp7d
2020-09-09,AR,6,10,4,6,2022-05-03_11-02-08,fp7d
2020-09-09,BE,104,114,12,102,2022-05-03_11-02-08,fp7d
2020-09-09,BL,20,16,0,16,2022-05-03_11-02-08,fp7d
2020-09-09,BS,54,50,0,50,2022-05-03_11-02-08,fp7d
2020-09-09,FR,24,22,0,22,2022-05-03_11-02-08,fp7d
2020-09-09,GE,40,40,2,38,2022-05-03_11-02-08,fp7d
2020-09-09,GL,NA,NA,NA,NA,2022-05-03_11-02-08,fp7d
2020-09-09,GR,16,16,0,16,2022-05-03_11-02-08,fp7d
2020-09-09,JU,6,6,0,6,2022-05-03_11-02-08,fp7d
2020-09-09,LU,40,36,0,36,2022-05-03_11-02-08,fp7d
2020-09-09,NE,10,10,0,10,2022-05-03_11-02-08,fp7d
2020-09-09,NW,6,6,0,6,2022-05-03_11-02-08,fp7d
2020-09-09,OW,0,0,0,0,2022-05-03_11-02-08,fp7d
2020-09-09,SG,54,55,1,54,2022-05-03_11-02-08,fp7d
2020-09-09,SH,8,7,0,7,2022-05-03_11-02-08,fp7d
2020-09-09,SO,17,17,0,17,2022-05-03_11-02-08,fp7d
2020-09-09,SZ,12,11,0,11,2022-05-03_11-02-08,fp7d
2020-09-09,TG,21,38,17,21,2022-05-03_11-02-08,fp7d
2020-09-09,TI,47,60,13,47,2022-05-03_11-02-08,fp7d
2020-09-09,UR,6,6,0,6,2022-05-03_11-02-08,fp7d
2020-09-09,VD,85,98,13,85,2022-05-03_11-02-08,fp7d
2020-09-09,VS,21,27,6,21,2022-05-03_11-02-08,fp7d
2020-09-09,ZG,8,8,0,8,2022-05-03_11-02-08,fp7d
2020-09-09,ZH,198,300,102,198,2022-05-03_11-02-08,fp7d
2020-09-10,AG,52,50,0,50,2022-05-03_11-02-08,fp7d
2020-09-10,AI,0,0,0,0,2022-05-03_11-02-08,fp7d
2020-09-10,AR,6,10,4,6,2022-05-03_11-02-08,fp7d
2020-09-10,BE,104,114,12,102,2022-05-03_11-02-08,fp7d
2020-09-10,BL,20,16,0,16,2022-05-03_11-02-08,fp7d
2020-09-10,BS,54,50,0,50,2022-05-03_11-02-08,fp7d
2020-09-10,FR,24,22,0,22,2022-05-03_11-02-08,fp7d
2020-09-10,GE,40,40,2,38,2022-05-03_11-02-08,fp7d
2020-09-10,GL,NA,NA,NA,NA,2022-05-03_11-02-08,fp7d
2020-09-10,GR,16,16,0,16,2022-05-03_11-02-08,fp7d
2020-09-10,JU,6,6,0,6,2022-05-03_11-02-08,fp7d
2020-09-10,LU,54,52,2,50,2022-05-03_11-02-08,fp7d
2020-09-10,NE,10,10,0,10,2022-05-03_11-02-08,fp7d
2020-09-10,NW,6,6,0,6,2022-05-03_11-02-08,fp7d
2020-09-10,OW,0,0,0,0,2022-05-03_11-02-08,fp7d
2020-09-10,SG,54,55,1,54,2022-05-03_11-02-08,fp7d
2020-09-10,SH,8,8,0,8,2022-05-03_11-02-08,fp7d
2020-09-10,SO,17,17,0,17,2022-05-03_11-02-08,fp7d
2020-09-10,SZ,12,11,0,11,2022-05-03_11-02-08,fp7d
2020-09-10,TG,21,37,16,21,2022-05-03_11-02-08,fp7d
2020-09-10,TI,38,51,13,38,2022-05-03_11-02-08,fp7d
2020-09-10,UR,6,6,0,6,2022-05-03_11-02-08,fp7d
2020-09-10,VD,85,98,13,85,2022-05-03_11-02-08,fp7d
2020-09-10,VS,21,27,6,21,2022-05-03_11-02-08,fp7d
2020-09-10,ZG,8,8,0,8,2022-05-03_11-02-08,fp7d
2020-09-10,ZH,198,299,101,198,2022-05-03_11-02-08,fp7d
2020-09-11,AG,52,50,0,50,2022-05-03_11-02-08,fp7d
2020-09-11,AI,0,0,0,0,2022-05-03_11-02-08,fp7d
2020-09-11,AR,6,10,4,6,2022-05-03_11-02-08,fp7d
2020-09-11,BE,104,114,12,102,2022-05-03_11-02-08,fp7d
2020-09-11,BL,20,16,0,16,2022-05-03_11-02-08,fp7d
2020-09-11,BS,54,50,0,50,2022-05-03_11-02-08,fp7d
2020-09-11,FR,24,22,0,22,2022-05-03_11-02-08,fp7d
2020-09-11,GE,40,40,2,38,2022-05-03_11-02-08,fp7d
2020-09-11,GL,NA,NA,NA,NA,2022-05-03_11-02-08,fp7d
2020-09-11,GR,16,16,0,16,2022-05-03_11-02-08,fp7d
2020-09-11,JU,6,6,0,6,2022-05-03_11-02-08,fp7d
2020-09-11,LU,54,52,2,50,2022-05-03_11-02-08,fp7d
2020-09-11,NE,10,10,0,10,2022-05-03_11-02-08,fp7d
2020-09-11,NW,6,6,0,6,2022-05-03_11-02-08,fp7d
2020-09-11,OW,0,0,0,0,2022-05-03_11-02-08,fp7d
2020-09-11,SG,54,55,1,54,2022-05-03_11-02-08,fp7d
2020-09-11,SH,8,8,0,8,2022-05-03_11-02-08,fp7d
2020-09-11,SO,17,17,0,17,2022-05-03_11-02-08,fp7d
2020-09-11,SZ,12,11,0,11,2022-05-03_11-02-08,fp7d
2020-09-11,TG,21,37,16,21,2022-05-03_11-02-08,fp7d
2020-09-11,TI,38,51,13,38,2022-05-03_11-02-08,fp7d
2020-09-11,UR,6,6,0,6,2022-05-03_11-02-08,fp7d
2020-09-11,VD,85,97,13,84,2022-05-03_11-02-08,fp7d
2020-09-11,VS,21,27,6,21,2022-05-03_11-02-08,fp7d
2020-09-11,ZG,8,8,0,8,2022-05-03_11-02-08,fp7d
2020-09-11,ZH,198,300,102,198,2022-05-03_11-02-08,fp7d
2020-09-12,AG,52,50,0,50,2022-05-03_11-02-08,fp7d
2020-09-12,AI,0,0,0,0,2022-05-03_11-02-08,fp7d
2020-09-12,AR,6,10,4,6,2022-05-03_11-02-08,fp7d
2020-09-12,BE,104,114,12,102,2022-05-03_11-02-08,fp7d
2020-09-12,BL,20,16,0,16,2022-05-03_11-02-08,fp7d
2020-09-12,BS,54,50,0,50,2022-05-03_11-02-08,fp7d
2020-09-12,FR,24,22,0,22,2022-05-03_11-02-08,fp7d
2020-09-12,GE,40,40,2,38,2022-05-03_11-02-08,fp7d
2020-09-12,GL,NA,NA,NA,NA,2022-05-03_11-02-08,fp7d
2020-09-12,GR,16,16,0,16,2022-05-03_11-02-08,fp7d
2020-09-12,JU,6,6,0,6,2022-05-03_11-02-08,fp7d
2020-09-12,LU,54,52,2,50,2022-05-03_11-02-08,fp7d
2020-09-12,NE,10,10,0,10,2022-05-03_11-02-08,fp7d
2020-09-12,NW,6,6,0,6,2022-05-03_11-02-08,fp7d
2020-09-12,OW,0,0,0,0,2022-05-03_11-02-08,fp7d
2020-09-12,SG,54,55,1,54,2022-05-03_11-02-08,fp7d
2020-09-12,SH,8,8,0,8,2022-05-03_11-02-08,fp7d
2020-09-12,SO,17,17,0,17,2022-05-03_11-02-08,fp7d
2020-09-12,SZ,12,11,0,11,2022-05-03_11-02-08,fp7d
2020-09-12,TG,21,37,16,21,2022-05-03_11-02-08,fp7d
2020-09-12,TI,38,51,13,38,2022-05-03_11-02-08,fp7d
2020-09-12,UR,6,6,0,6,2022-05-03_11-02-08,fp7d
2020-09-12,VD,85,97,13,84,2022-05-03_11-02-08,fp7d
2020-09-12,VS,15,15,0,15,2022-05-03_11-02-08,fp7d
2020-09-12,ZG,8,8,0,8,2022-05-03_11-02-08,fp7d
2020-09-12,ZH,198,300,102,198,2022-05-03_11-02-08,fp7d
2020-09-13,AG,52,50,0,50,2022-05-03_11-02-08,fp7d
2020-09-13,AI,0,0,0,0,2022-05-03_11-02-08,fp7d
2020-09-13,AR,6,10,4,6,2022-05-03_11-02-08,fp7d
2020-09-13,BE,104,114,12,102,2022-05-03_11-02-08,fp7d
2020-09-13,BL,20,16,0,16,2022-05-03_11-02-08,fp7d
2020-09-13,BS,54,50,0,50,2022-05-03_11-02-08,fp7d
2020-09-13,FR,24,22,0,22,2022-05-03_11-02-08,fp7d
2020-09-13,GE,40,40,2,38,2022-05-03_11-02-08,fp7d
2020-09-13,GL,NA,NA,NA,NA,2022-05-03_11-02-08,fp7d
2020-09-13,GR,16,16,0,16,2022-05-03_11-02-08,fp7d
2020-09-13,JU,6,6,0,6,2022-05-03_11-02-08,fp7d
2020-09-13,LU,54,52,2,50,2022-05-03_11-02-08,fp7d
2020-09-13,NE,10,10,0,10,2022-05-03_11-02-08,fp7d
2020-09-13,NW,6,6,0,6,2022-05-03_11-02-08,fp7d
2020-09-13,OW,0,0,0,0,2022-05-03_11-02-08,fp7d
2020-09-13,SG,54,55,1,54,2022-05-03_11-02-08,fp7d
2020-09-13,SH,8,8,0,8,2022-05-03_11-02-08,fp7d
2020-09-13,SO,17,17,0,17,2022-05-03_11-02-08,fp7d
2020-09-13,SZ,12,11,0,11,2022-05-03_11-02-08,fp7d
2020-09-13,TG,21,37,16,21,2022-05-03_11-02-08,fp7d
2020-09-13,TI,38,51,13,38,2022-05-03_11-02-08,fp7d
2020-09-13,UR,6,6,0,6,2022-05-03_11-02-08,fp7d
2020-09-13,VD,85,97,13,84,2022-05-03_11-02-08,fp7d
2020-09-13,VS,15,15,0,15,2022-05-03_11-02-08,fp7d
2020-09-13,ZG,8,8,0,8,2022-05-03_11-02-08,fp7d
2020-09-13,ZH,198,300,102,198,2022-05-03_11-02-08,fp7d
2020-09-14,AG,52,50,0,50,2022-05-03_11-02-08,fp7d
2020-09-14,AI,0,0,0,0,2022-05-03_11-02-08,fp7d
2020-09-14,AR,6,10,4,6,2022-05-03_11-02-08,fp7d
2020-09-14,BE,104,116,12,104,2022-05-03_11-02-08,fp7d
2020-09-14,BL,20,16,0,16,2022-05-03_11-02-08,fp7d
2020-09-14,BS,54,50,0,50,2022-05-03_11-02-08,fp7d
2020-09-14,FR,24,22,0,22,2022-05-03_11-02-08,fp7d
2020-09-14,GE,40,40,2,38,2022-05-03_11-02-08,fp7d
2020-09-14,GL,NA,NA,NA,NA,2022-05-03_11-02-08,fp7d
2020-09-14,GR,16,16,0,16,2022-05-03_11-02-08,fp7d
2020-09-14,JU,6,6,0,6,2022-05-03_11-02-08,fp7d
2020-09-14,LU,54,52,2,50,2022-05-03_11-02-08,fp7d
2020-09-14,NE,10,10,0,10,2022-05-03_11-02-08,fp7d
2020-09-14,NW,6,6,0,6,2022-05-03_11-02-08,fp7d
2020-09-14,OW,0,0,0,0,2022-05-03_11-02-08,fp7d
2020-09-14,SG,54,55,1,54,2022-05-03_11-02-08,fp7d
2020-09-14,SH,8,6,0,6,2022-05-03_11-02-08,fp7d
2020-09-14,SO,17,17,0,17,2022-05-03_11-02-08,fp7d
2020-09-14,SZ,12,11,0,11,2022-05-03_11-02-08,fp7d
2020-09-14,TG,21,37,16,21,2022-05-03_11-02-08,fp7d
2020-09-14,TI,38,51,13,38,2022-05-03_11-02-08,fp7d
2020-09-14,UR,6,6,0,6,2022-05-03_11-02-08,fp7d
2020-09-14,VD,79,89,11,78,2022-05-03_11-02-08,fp7d
2020-09-14,VS,15,15,0,15,2022-05-03_11-02-08,fp7d
2020-09-14,ZG,8,8,0,8,2022-05-03_11-02-08,fp7d
2020-09-14,ZH,198,300,102,198,2022-05-03_11-02-08,fp7d
2020-09-15,AG,52,50,0,50,2022-05-03_11-02-08,fp7d
2020-09-15,AI,0,0,0,0,2022-05-03_11-02-08,fp7d
2020-09-15,AR,6,10,4,6,2022-05-03_11-02-08,fp7d
2020-09-15,BE,104,114,12,102,2022-05-03_11-02-08,fp7d
2020-09-15,BL,20,16,0,16,2022-05-03_11-02-08,fp7d
2020-09-15,BS,54,50,0,50,2022-05-03_11-02-08,fp7d
2020-09-15,FR,24,22,0,22,2022-05-03_11-02-08,fp7d
2020-09-15,GE,40,40,2,38,2022-05-03_11-02-08,fp7d
2020-09-15,GL,NA,NA,NA,NA,2022-05-03_11-02-08,fp7d
2020-09-15,GR,16,16,0,16,2022-05-03_11-02-08,fp7d
2020-09-15,JU,6,6,0,6,2022-05-03_11-02-08,fp7d
2020-09-15,LU,54,52,2,50,2022-05-03_11-02-08,fp7d
2020-09-15,NE,10,10,0,10,2022-05-03_11-02-08,fp7d
2020-09-15,NW,6,6,0,6,2022-05-03_11-02-08,fp7d
2020-09-15,OW,0,0,0,0,2022-05-03_11-02-08,fp7d
2020-09-15,SG,54,55,1,54,2022-05-03_11-02-08,fp7d
2020-09-15,SH,8,6,0,6,2022-05-03_11-02-08,fp7d
2020-09-15,SO,17,17,0,17,2022-05-03_11-02-08,fp7d
2020-09-15,SZ,12,12,0,12,2022-05-03_11-02-08,fp7d
2020-09-15,TG,21,37,16,21,2022-05-03_11-02-08,fp7d
2020-09-15,TI,38,51,13,38,2022-05-03_11-02-08,fp7d
2020-09-15,UR,6,6,0,6,2022-05-03_11-02-08,fp7d
2020-09-15,VD,79,89,11,78,2022-05-03_11-02-08,fp7d
2020-09-15,VS,21,27,6,21,2022-05-03_11-02-08,fp7d
2020-09-15,ZG,8,8,0,8,2022-05-03_11-02-08,fp7d
2020-09-15,ZH,198,300,102,198,2022-05-03_11-02-08,fp7d
2020-09-16,AG,52,50,0,50,2022-05-03_11-02-08,fp7d
2020-09-16,AI,0,0,0,0,2022-05-03_11-02-08,fp7d
2020-09-16,AR,6,10,4,6,2022-05-03_11-02-08,fp7d
2020-09-16,BE,104,114,12,102,2022-05-03_11-02-08,fp7d
2020-09-16,BL,20,16,0,16,2022-05-03_11-02-08,fp7d
2020-09-16,BS,54,50,0,50,2022-05-03_11-02-08,fp7d
2020-09-16,FR,24,22,0,22,2022-05-03_11-02-08,fp7d
2020-09-16,GE,40,36,2,34,2022-05-03_11-02-08,fp7d
2020-09-16,GL,NA,NA,NA,NA,2022-05-03_11-02-08,fp7d
2020-09-16,GR,16,16,0,16,2022-05-03_11-02-08,fp7d
2020-09-16,JU,6,6,0,6,2022-05-03_11-02-08,fp7d
2020-09-16,LU,54,52,2,50,2022-05-03_11-02-08,fp7d
2020-09-16,NE,10,10,0,10,2022-05-03_11-02-08,fp7d
2020-09-16,NW,6,6,0,6,2022-05-03_11-02-08,fp7d
2020-09-16,OW,0,0,0,0,2022-05-03_11-02-08,fp7d
2020-09-16,SG,48,49,1,48,2022-05-03_11-02-08,fp7d
2020-09-16,SH,8,6,0,6,2022-05-03_11-02-08,fp7d
2020-09-16,SO,17,17,0,17,2022-05-03_11-02-08,fp7d
2020-09-16,SZ,12,12,0,12,2022-05-03_11-02-08,fp7d
2020-09-16,TG,21,37,16,21,2022-05-03_11-02-08,fp7d
2020-09-16,TI,38,51,13,38,2022-05-03_11-02-08,fp7d
2020-09-16,UR,6,6,0,6,2022-05-03_11-02-08,fp7d
2020-09-16,VD,79,90,12,78,2022-05-03_11-02-08,fp7d
2020-09-16,VS,21,27,6,21,2022-05-03_11-02-08,fp7d
2020-09-16,ZG,8,8,0,8,2022-05-03_11-02-08,fp7d
2020-09-16,ZH,198,300,102,198,2022-05-03_11-02-08,fp7d
2020-09-17,AG,52,49,0,49,2022-05-03_11-02-08,fp7d
2020-09-17,AI,0,0,0,0,2022-05-03_11-02-08,fp7d
2020-09-17,AR,6,10,4,6,2022-05-03_11-02-08,fp7d
2020-09-17,BE,104,112,12,100,2022-05-03_11-02-08,fp7d
2020-09-17,BL,20,16,0,16,2022-05-03_11-02-08,fp7d
2020-09-17,BS,54,50,0,50,2022-05-03_11-02-08,fp7d
2020-09-17,FR,24,22,0,22,2022-05-03_11-02-08,fp7d
2020-09-17,GE,40,36,2,34,2022-05-03_11-02-08,fp7d
2020-09-17,GL,NA,NA,NA,NA,2022-05-03_11-02-08,fp7d
2020-09-17,GR,16,16,0,16,2022-05-03_11-02-08,fp7d
2020-09-17,JU,6,6,0,6,2022-05-03_11-02-08,fp7d
2020-09-17,LU,54,52,2,50,2022-05-03_11-02-08,fp7d
2020-09-17,NE,10,10,0,10,2022-05-03_11-02-08,fp7d
2020-09-17,NW,6,6,0,6,2022-05-03_11-02-08,fp7d
2020-09-17,OW,0,0,0,0,2022-05-03_11-02-08,fp7d
2020-09-17,SG,54,55,1,54,2022-05-03_11-02-08,fp7d
2020-09-17,SH,8,6,0,6,2022-05-03_11-02-08,fp7d
2020-09-17,SO,17,17,0,17,2022-05-03_11-02-08,fp7d
2020-09-17,SZ,12,12,0,12,2022-05-03_11-02-08,fp7d
2020-09-17,TG,21,37,16,21,2022-05-03_11-02-08,fp7d
2020-09-17,TI,47,60,13,47,2022-05-03_11-02-08,fp7d
2020-09-17,UR,6,6,0,6,2022-05-03_11-02-08,fp7d
2020-09-17,VD,79,89,11,78,2022-05-03_11-02-08,fp7d
2020-09-17,VS,21,27,6,21,2022-05-03_11-02-08,fp7d
2020-09-17,ZG,8,8,0,8,2022-05-03_11-02-08,fp7d
2020-09-17,ZH,198,300,102,198,2022-05-03_11-02-08,fp7d
2020-09-18,AG,52,50,0,50,2022-05-03_11-02-08,fp7d
2020-09-18,AI,0,0,0,0,2022-05-03_11-02-08,fp7d
2020-09-18,AR,6,10,4,6,2022-05-03_11-02-08,fp7d
2020-09-18,BE,104,112,12,100,2022-05-03_11-02-08,fp7d
2020-09-18,BL,20,16,0,16,2022-05-03_11-02-08,fp7d
2020-09-18,BS,54,50,0,50,2022-05-03_11-02-08,fp7d
2020-09-18,FR,24,22,0,22,2022-05-03_11-02-08,fp7d
2020-09-18,GE,40,32,2,30,2022-05-03_11-02-08,fp7d
2020-09-18,GL,NA,NA,NA,NA,2022-05-03_11-02-08,fp7d
2020-09-18,GR,16,16,0,16,2022-05-03_11-02-08,fp7d
2020-09-18,JU,6,6,0,6,2022-05-03_11-02-08,fp7d
2020-09-18,LU,54,52,2,50,2022-05-03_11-02-08,fp7d
2020-09-18,NE,10,10,0,10,2022-05-03_11-02-08,fp7d
2020-09-18,NW,6,6,0,6,2022-05-03_11-02-08,fp7d
2020-09-18,OW,0,0,0,0,2022-05-03_11-02-08,fp7d
2020-09-18,SG,54,55,1,54,2022-05-03_11-02-08,fp7d
2020-09-18,SH,8,7,0,7,2022-05-03_11-02-08,fp7d
2020-09-18,SO,17,17,0,17,2022-05-03_11-02-08,fp7d
2020-09-18,SZ,12,11,0,11,2022-05-03_11-02-08,fp7d
2020-09-18,TG,21,37,16,21,2022-05-03_11-02-08,fp7d
2020-09-18,TI,47,60,13,47,2022-05-03_11-02-08,fp7d
2020-09-18,UR,6,6,0,6,2022-05-03_11-02-08,fp7d
2020-09-18,VD,79,89,11,78,2022-05-03_11-02-08,fp7d
2020-09-18,VS,21,27,6,21,2022-05-03_11-02-08,fp7d
2020-09-18,ZG,8,8,0,8,2022-05-03_11-02-08,fp7d
2020-09-18,ZH,198,300,102,198,2022-05-03_11-02-08,fp7d
2020-09-19,AG,52,50,0,50,2022-05-03_11-02-08,fp7d
2020-09-19,AI,0,0,0,0,2022-05-03_11-02-08,fp7d
2020-09-19,AR,6,10,4,6,2022-05-03_11-02-08,fp7d
2020-09-19,BE,95,103,12,91,2022-05-03_11-02-08,fp7d
2020-09-19,BL,20,16,0,16,2022-05-03_11-02-08,fp7d
2020-09-19,BS,54,50,0,50,2022-05-03_11-02-08,fp7d
2020-09-19,FR,24,22,0,22,2022-05-03_11-02-08,fp7d
2020-09-19,GE,40,32,2,30,2022-05-03_11-02-08,fp7d
2020-09-19,GL,NA,NA,NA,NA,2022-05-03_11-02-08,fp7d
2020-09-19,GR,16,16,0,16,2022-05-03_11-02-08,fp7d
2020-09-19,JU,6,6,0,6,2022-05-03_11-02-08,fp7d
2020-09-19,LU,54,52,2,50,2022-05-03_11-02-08,fp7d
2020-09-19,NE,10,10,0,10,2022-05-03_11-02-08,fp7d
2020-09-19,NW,6,6,0,6,2022-05-03_11-02-08,fp7d
2020-09-19,OW,0,0,0,0,2022-05-03_11-02-08,fp7d
2020-09-19,SG,54,55,1,54,2022-05-03_11-02-08,fp7d
2020-09-19,SH,8,7,0,7,2022-05-03_11-02-08,fp7d
2020-09-19,SO,17,17,0,17,2022-05-03_11-02-08,fp7d
2020-09-19,SZ,12,11,0,11,2022-05-03_11-02-08,fp7d
2020-09-19,TG,21,37,16,21,2022-05-03_11-02-08,fp7d
2020-09-19,TI,47,60,13,47,2022-05-03_11-02-08,fp7d
2020-09-19,UR,6,6,0,6,2022-05-03_11-02-08,fp7d
2020-09-19,VD,79,89,11,78,2022-05-03_11-02-08,fp7d
2020-09-19,VS,21,27,6,21,2022-05-03_11-02-08,fp7d
2020-09-19,ZG,8,8,0,8,2022-05-03_11-02-08,fp7d
2020-09-19,ZH,198,300,102,198,2022-05-03_11-02-08,fp7d
2020-09-20,AG,52,50,0,50,2022-05-03_11-02-08,fp7d
2020-09-20,AI,0,0,0,0,2022-05-03_11-02-08,fp7d
2020-09-20,AR,6,10,4,6,2022-05-03_11-02-08,fp7d
2020-09-20,BE,95,103,12,91,2022-05-03_11-02-08,fp7d
2020-09-20,BL,20,16,0,16,2022-05-03_11-02-08,fp7d
2020-09-20,BS,54,50,0,50,2022-05-03_11-02-08,fp7d
2020-09-20,FR,24,22,0,22,2022-05-03_11-02-08,fp7d
2020-09-20,GE,40,32,2,30,2022-05-03_11-02-08,fp7d
2020-09-20,GL,NA,NA,NA,NA,2022-05-03_11-02-08,fp7d
2020-09-20,GR,16,16,0,16,2022-05-03_11-02-08,fp7d
2020-09-20,JU,6,6,0,6,2022-05-03_11-02-08,fp7d
2020-09-20,LU,54,52,2,50,2022-05-03_11-02-08,fp7d
2020-09-20,NE,10,10,0,10,2022-05-03_11-02-08,fp7d
2020-09-20,NW,6,6,0,6,2022-05-03_11-02-08,fp7d
2020-09-20,OW,0,0,0,0,2022-05-03_11-02-08,fp7d
2020-09-20,SG,54,55,1,54,2022-05-03_11-02-08,fp7d
2020-09-20,SH,8,7,0,7,2022-05-03_11-02-08,fp7d
2020-09-20,SO,17,17,0,17,2022-05-03_11-02-08,fp7d
2020-09-20,SZ,12,11,0,11,2022-05-03_11-02-08,fp7d
2020-09-20,TG,21,37,16,21,2022-05-03_11-02-08,fp7d
2020-09-20,TI,47,60,13,47,2022-05-03_11-02-08,fp7d
2020-09-20,UR,6,6,0,6,2022-05-03_11-02-08,fp7d
2020-09-20,VD,79,89,11,78,2022-05-03_11-02-08,fp7d
2020-09-20,VS,21,27,6,21,2022-05-03_11-02-08,fp7d
2020-09-20,ZG,8,8,0,8,2022-05-03_11-02-08,fp7d
2020-09-20,ZH,198,300,102,198,2022-05-03_11-02-08,fp7d
2020-09-21,AG,52,50,0,50,2022-05-03_11-02-08,fp7d
2020-09-21,AI,0,0,0,0,2022-05-03_11-02-08,fp7d
2020-09-21,AR,NA,NA,NA,NA,2022-05-03_11-02-08,fp7d
2020-09-21,BE,104,112,12,100,2022-05-03_11-02-08,fp7d
2020-09-21,BL,20,16,0,16,2022-05-03_11-02-08,fp7d
2020-09-21,BS,54,50,0,50,2022-05-03_11-02-08,fp7d
2020-09-21,FR,24,22,0,22,2022-05-03_11-02-08,fp7d
2020-09-21,GE,40,37,2,35,2022-05-03_11-02-08,fp7d
2020-09-21,GL,NA,NA,NA,NA,2022-05-03_11-02-08,fp7d
2020-09-21,GR,16,16,0,16,2022-05-03_11-02-08,fp7d
2020-09-21,JU,6,6,0,6,2022-05-03_11-02-08,fp7d
2020-09-21,LU,54,52,2,50,2022-05-03_11-02-08,fp7d
2020-09-21,NE,10,10,0,10,2022-05-03_11-02-08,fp7d
2020-09-21,NW,6,6,0,6,2022-05-03_11-02-08,fp7d
2020-09-21,OW,0,0,0,0,2022-05-03_11-02-08,fp7d
2020-09-21,SG,54,55,1,54,2022-05-03_11-02-08,fp7d
2020-09-21,SH,8,7,0,7,2022-05-03_11-02-08,fp7d
2020-09-21,SO,17,17,0,17,2022-05-03_11-02-08,fp7d
2020-09-21,SZ,12,11,0,11,2022-05-03_11-02-08,fp7d
2020-09-21,TG,21,37,16,21,2022-05-03_11-02-08,fp7d
2020-09-21,TI,47,60,13,47,2022-05-03_11-02-08,fp7d
2020-09-21,UR,6,6,0,6,2022-05-03_11-02-08,fp7d
2020-09-21,VD,79,89,11,78,2022-05-03_11-02-08,fp7d
2020-09-21,VS,21,27,6,21,2022-05-03_11-02-08,fp7d
2020-09-21,ZG,8,8,0,8,2022-05-03_11-02-08,fp7d
2020-09-21,ZH,198,300,102,198,2022-05-03_11-02-08,fp7d
2020-09-22,AG,52,50,0,50,2022-05-03_11-02-08,fp7d
2020-09-22,AI,0,0,0,0,2022-05-03_11-02-08,fp7d
2020-09-22,AR,NA,NA,NA,NA,2022-05-03_11-02-08,fp7d
2020-09-22,BE,104,112,12,100,2022-05-03_11-02-08,fp7d
2020-09-22,BL,20,16,0,16,2022-05-03_11-02-08,fp7d
2020-09-22,BS,54,50,0,50,2022-05-03_11-02-08,fp7d
2020-09-22,FR,24,22,0,22,2022-05-03_11-02-08,fp7d
2020-09-22,GE,40,40,2,38,2022-05-03_11-02-08,fp7d
2020-09-22,GL,NA,NA,NA,NA,2022-05-03_11-02-08,fp7d
2020-09-22,GR,16,16,0,16,2022-05-03_11-02-08,fp7d
2020-09-22,JU,6,6,0,6,2022-05-03_11-02-08,fp7d
2020-09-22,LU,54,52,2,50,2022-05-03_11-02-08,fp7d
2020-09-22,NE,10,10,0,10,2022-05-03_11-02-08,fp7d
2020-09-22,NW,6,6,0,6,2022-05-03_11-02-08,fp7d
2020-09-22,OW,0,0,0,0,2022-05-03_11-02-08,fp7d
2020-09-22,SG,54,55,1,54,2022-05-03_11-02-08,fp7d
2020-09-22,SH,8,7,0,7,2022-05-03_11-02-08,fp7d
2020-09-22,SO,17,17,0,17,2022-05-03_11-02-08,fp7d
2020-09-22,SZ,12,11,0,11,2022-05-03_11-02-08,fp7d
2020-09-22,TG,21,37,16,21,2022-05-03_11-02-08,fp7d
2020-09-22,TI,47,60,13,47,2022-05-03_11-02-08,fp7d
2020-09-22,UR,6,6,0,6,2022-05-03_11-02-08,fp7d
2020-09-22,VD,79,84,6,78,2022-05-03_11-02-08,fp7d
2020-09-22,VS,21,27,6,21,2022-05-03_11-02-08,fp7d
2020-09-22,ZG,8,8,0,8,2022-05-03_11-02-08,fp7d
2020-09-22,ZH,198,299,101,198,2022-05-03_11-02-08,fp7d
2020-09-23,AG,52,50,0,50,2022-05-03_11-02-08,fp7d
2020-09-23,AI,0,0,0,0,2022-05-03_11-02-08,fp7d
2020-09-23,AR,NA,NA,NA,NA,2022-05-03_11-02-08,fp7d
2020-09-23,BE,104,112,12,100,2022-05-03_11-02-08,fp7d
2020-09-23,BL,20,16,0,16,2022-05-03_11-02-08,fp7d
2020-09-23,BS,54,50,0,50,2022-05-03_11-02-08,fp7d
2020-09-23,FR,24,22,0,22,2022-05-03_11-02-08,fp7d
2020-09-23,GE,40,40,2,38,2022-05-03_11-02-08,fp7d
2020-09-23,GL,NA,NA,NA,NA,2022-05-03_11-02-08,fp7d
2020-09-23,GR,16,16,0,16,2022-05-03_11-02-08,fp7d
2020-09-23,JU,6,6,0,6,2022-05-03_11-02-08,fp7d
2020-09-23,LU,54,52,2,50,2022-05-03_11-02-08,fp7d
2020-09-23,NE,10,10,0,10,2022-05-03_11-02-08,fp7d
2020-09-23,NW,6,6,0,6,2022-05-03_11-02-08,fp7d
2020-09-23,OW,0,0,0,0,2022-05-03_11-02-08,fp7d
2020-09-23,SG,54,55,1,54,2022-05-03_11-02-08,fp7d
2020-09-23,SH,8,7,0,7,2022-05-03_11-02-08,fp7d
2020-09-23,SO,17,17,0,17,2022-05-03_11-02-08,fp7d
2020-09-23,SZ,12,11,0,11,2022-05-03_11-02-08,fp7d
2020-09-23,TG,21,37,16,21,2022-05-03_11-02-08,fp7d
2020-09-23,TI,47,60,13,47,2022-05-03_11-02-08,fp7d
2020-09-23,UR,6,6,0,6,2022-05-03_11-02-08,fp7d
2020-09-23,VD,79,89,11,78,2022-05-03_11-02-08,fp7d
2020-09-23,VS,21,27,6,21,2022-05-03_11-02-08,fp7d
2020-09-23,ZG,8,8,0,8,2022-05-03_11-02-08,fp7d
2020-09-23,ZH,198,300,102,198,2022-05-03_11-02-08,fp7d
2020-09-24,AG,52,50,0,50,2022-05-03_11-02-08,fp7d
2020-09-24,AI,0,0,0,0,2022-05-03_11-02-08,fp7d
2020-09-24,AR,NA,NA,NA,NA,2022-05-03_11-02-08,fp7d
2020-09-24,BE,92,102,12,90,2022-05-03_11-02-08,fp7d
2020-09-24,BL,20,16,0,16,2022-05-03_11-02-08,fp7d
2020-09-24,BS,54,50,0,50,2022-05-03_11-02-08,fp7d
2020-09-24,FR,24,22,0,22,2022-05-03_11-02-08,fp7d
2020-09-24,GE,40,40,2,38,2022-05-03_11-02-08,fp7d
2020-09-24,GL,NA,NA,NA,NA,2022-05-03_11-02-08,fp7d
2020-09-24,GR,16,16,0,16,2022-05-03_11-02-08,fp7d
2020-09-24,JU,6,6,0,6,2022-05-03_11-02-08,fp7d
2020-09-24,LU,54,52,2,50,2022-05-03_11-02-08,fp7d
2020-09-24,NE,10,10,0,10,2022-05-03_11-02-08,fp7d
2020-09-24,NW,6,6,0,6,2022-05-03_11-02-08,fp7d
2020-09-24,OW,0,0,0,0,2022-05-03_11-02-08,fp7d
2020-09-24,SG,54,55,1,54,2022-05-03_11-02-08,fp7d
2020-09-24,SH,8,7,0,7,2022-05-03_11-02-08,fp7d
2020-09-24,SO,17,17,0,17,2022-05-03_11-02-08,fp7d
2020-09-24,SZ,12,12,0,12,2022-05-03_11-02-08,fp7d
2020-09-24,TG,21,37,16,21,2022-05-03_11-02-08,fp7d
2020-09-24,TI,47,60,13,47,2022-05-03_11-02-08,fp7d
2020-09-24,UR,6,6,0,6,2022-05-03_11-02-08,fp7d
2020-09-24,VD,79,89,11,78,2022-05-03_11-02-08,fp7d
2020-09-24,VS,21,27,6,21,2022-05-03_11-02-08,fp7d
2020-09-24,ZG,8,8,0,8,2022-05-03_11-02-08,fp7d
2020-09-24,ZH,198,299,101,198,2022-05-03_11-02-08,fp7d
2020-09-25,AG,52,50,0,50,2022-05-03_11-02-08,fp7d
2020-09-25,AI,0,0,0,0,2022-05-03_11-02-08,fp7d
2020-09-25,AR,NA,NA,NA,NA,2022-05-03_11-02-08,fp7d
2020-09-25,BE,92,102,12,90,2022-05-03_11-02-08,fp7d
2020-09-25,BL,20,16,0,16,2022-05-03_11-02-08,fp7d
2020-09-25,BS,54,50,0,50,2022-05-03_11-02-08,fp7d
2020-09-25,FR,24,24,0,24,2022-05-03_11-02-08,fp7d
2020-09-25,GE,40,40,2,38,2022-05-03_11-02-08,fp7d
2020-09-25,GL,NA,NA,NA,NA,2022-05-03_11-02-08,fp7d
2020-09-25,GR,16,16,0,16,2022-05-03_11-02-08,fp7d
2020-09-25,JU,6,6,0,6,2022-05-03_11-02-08,fp7d
2020-09-25,LU,54,52,2,50,2022-05-03_11-02-08,fp7d
2020-09-25,NE,10,10,0,10,2022-05-03_11-02-08,fp7d
2020-09-25,NW,6,3,0,3,2022-05-03_11-02-08,fp7d
2020-09-25,OW,0,0,0,0,2022-05-03_11-02-08,fp7d
2020-09-25,SG,54,55,1,54,2022-05-03_11-02-08,fp7d
2020-09-25,SH,8,7,0,7,2022-05-03_11-02-08,fp7d
2020-09-25,SO,17,17,0,17,2022-05-03_11-02-08,fp7d
2020-09-25,SZ,12,11,0,11,2022-05-03_11-02-08,fp7d
2020-09-25,TG,21,37,16,21,2022-05-03_11-02-08,fp7d
2020-09-25,TI,47,60,13,47,2022-05-03_11-02-08,fp7d
2020-09-25,UR,6,6,0,6,2022-05-03_11-02-08,fp7d
2020-09-25,VD,79,89,11,78,2022-05-03_11-02-08,fp7d
2020-09-25,VS,21,27,6,21,2022-05-03_11-02-08,fp7d
2020-09-25,ZG,8,8,0,8,2022-05-03_11-02-08,fp7d
2020-09-25,ZH,198,299,101,198,2022-05-03_11-02-08,fp7d
2020-09-26,AG,52,50,0,50,2022-05-03_11-02-08,fp7d
2020-09-26,AI,0,0,0,0,2022-05-03_11-02-08,fp7d
2020-09-26,AR,NA,NA,NA,NA,2022-05-03_11-02-08,fp7d
2020-09-26,BE,92,102,12,90,2022-05-03_11-02-08,fp7d
2020-09-26,BL,20,16,0,16,2022-05-03_11-02-08,fp7d
2020-09-26,BS,54,50,0,50,2022-05-03_11-02-08,fp7d
2020-09-26,FR,24,24,0,24,2022-05-03_11-02-08,fp7d
2020-09-26,GE,40,40,2,38,2022-05-03_11-02-08,fp7d
2020-09-26,GL,NA,NA,NA,NA,2022-05-03_11-02-08,fp7d
2020-09-26,GR,16,16,0,16,2022-05-03_11-02-08,fp7d
2020-09-26,JU,6,6,0,6,2022-05-03_11-02-08,fp7d
2020-09-26,LU,54,52,2,50,2022-05-03_11-02-08,fp7d
2020-09-26,NE,10,10,0,10,2022-05-03_11-02-08,fp7d
2020-09-26,NW,6,3,0,3,2022-05-03_11-02-08,fp7d
2020-09-26,OW,0,0,0,0,2022-05-03_11-02-08,fp7d
2020-09-26,SG,54,55,1,54,2022-05-03_11-02-08,fp7d
2020-09-26,SH,8,7,0,7,2022-05-03_11-02-08,fp7d
2020-09-26,SO,17,17,0,17,2022-05-03_11-02-08,fp7d
2020-09-26,SZ,12,11,0,11,2022-05-03_11-02-08,fp7d
2020-09-26,TG,21,37,16,21,2022-05-03_11-02-08,fp7d
2020-09-26,TI,47,60,13,47,2022-05-03_11-02-08,fp7d
2020-09-26,UR,6,6,0,6,2022-05-03_11-02-08,fp7d
2020-09-26,VD,79,89,11,78,2022-05-03_11-02-08,fp7d
2020-09-26,VS,21,27,6,21,2022-05-03_11-02-08,fp7d
2020-09-26,ZG,8,8,0,8,2022-05-03_11-02-08,fp7d
2020-09-26,ZH,198,299,101,198,2022-05-03_11-02-08,fp7d
2020-09-27,AG,52,50,0,50,2022-05-03_11-02-08,fp7d
2020-09-27,AI,0,0,0,0,2022-05-03_11-02-08,fp7d
2020-09-27,AR,NA,NA,NA,NA,2022-05-03_11-02-08,fp7d
2020-09-27,BE,92,102,12,90,2022-05-03_11-02-08,fp7d
2020-09-27,BL,20,16,0,16,2022-05-03_11-02-08,fp7d
2020-09-27,BS,54,50,0,50,2022-05-03_11-02-08,fp7d
2020-09-27,FR,24,24,0,24,2022-05-03_11-02-08,fp7d
2020-09-27,GE,40,40,2,38,2022-05-03_11-02-08,fp7d
2020-09-27,GL,NA,NA,NA,NA,2022-05-03_11-02-08,fp7d
2020-09-27,GR,16,16,0,16,2022-05-03_11-02-08,fp7d
2020-09-27,JU,6,6,0,6,2022-05-03_11-02-08,fp7d
2020-09-27,LU,40,36,0,36,2022-05-03_11-02-08,fp7d
2020-09-27,NE,10,10,0,10,2022-05-03_11-02-08,fp7d
2020-09-27,NW,6,3,0,3,2022-05-03_11-02-08,fp7d
2020-09-27,OW,0,0,0,0,2022-05-03_11-02-08,fp7d
2020-09-27,SG,54,55,1,54,2022-05-03_11-02-08,fp7d
2020-09-27,SH,8,7,0,7,2022-05-03_11-02-08,fp7d
2020-09-27,SO,17,17,0,17,2022-05-03_11-02-08,fp7d
2020-09-27,SZ,12,11,0,11,2022-05-03_11-02-08,fp7d
2020-09-27,TG,21,37,16,21,2022-05-03_11-02-08,fp7d
2020-09-27,TI,47,60,13,47,2022-05-03_11-02-08,fp7d
2020-09-27,UR,6,6,0,6,2022-05-03_11-02-08,fp7d
2020-09-27,VD,79,89,11,78,2022-05-03_11-02-08,fp7d
2020-09-27,VS,21,27,6,21,2022-05-03_11-02-08,fp7d
2020-09-27,ZG,8,8,0,8,2022-05-03_11-02-08,fp7d
2020-09-27,ZH,198,299,101,198,2022-05-03_11-02-08,fp7d
2020-09-28,AG,52,50,0,50,2022-05-03_11-02-08,fp7d
2020-09-28,AI,0,0,0,0,2022-05-03_11-02-08,fp7d
2020-09-28,AR,NA,NA,NA,NA,2022-05-03_11-02-08,fp7d
2020-09-28,BE,92,102,12,90,2022-05-03_11-02-08,fp7d
2020-09-28,BL,20,16,0,16,2022-05-03_11-02-08,fp7d
2020-09-28,BS,54,50,0,50,2022-05-03_11-02-08,fp7d
2020-09-28,FR,24,24,0,24,2022-05-03_11-02-08,fp7d
2020-09-28,GE,40,40,2,38,2022-05-03_11-02-08,fp7d
2020-09-28,GL,NA,NA,NA,NA,2022-05-03_11-02-08,fp7d
2020-09-28,GR,16,16,0,16,2022-05-03_11-02-08,fp7d
2020-09-28,JU,6,6,0,6,2022-05-03_11-02-08,fp7d
2020-09-28,LU,40,36,0,36,2022-05-03_11-02-08,fp7d
2020-09-28,NE,10,10,0,10,2022-05-03_11-02-08,fp7d
2020-09-28,NW,6,3,0,3,2022-05-03_11-02-08,fp7d
2020-09-28,OW,0,0,0,0,2022-05-03_11-02-08,fp7d
2020-09-28,SG,54,55,1,54,2022-05-03_11-02-08,fp7d
2020-09-28,SH,8,7,0,7,2022-05-03_11-02-08,fp7d
2020-09-28,SO,17,17,0,17,2022-05-03_11-02-08,fp7d
2020-09-28,SZ,12,11,0,11,2022-05-03_11-02-08,fp7d
2020-09-28,TG,21,37,16,21,2022-05-03_11-02-08,fp7d
2020-09-28,TI,47,60,13,47,2022-05-03_11-02-08,fp7d
2020-09-28,UR,6,6,0,6,2022-05-03_11-02-08,fp7d
2020-09-28,VD,79,89,11,78,2022-05-03_11-02-08,fp7d
2020-09-28,VS,21,27,6,21,2022-05-03_11-02-08,fp7d
2020-09-28,ZG,8,8,0,8,2022-05-03_11-02-08,fp7d
2020-09-28,ZH,198,299,101,198,2022-05-03_11-02-08,fp7d
2020-09-29,AG,52,50,0,50,2022-05-03_11-02-08,fp7d
2020-09-29,AI,0,0,0,0,2022-05-03_11-02-08,fp7d
2020-09-29,AR,NA,NA,NA,NA,2022-05-03_11-02-08,fp7d
2020-09-29,BE,92,102,12,90,2022-05-03_11-02-08,fp7d
2020-09-29,BL,20,16,0,16,2022-05-03_11-02-08,fp7d
2020-09-29,BS,54,50,0,50,2022-05-03_11-02-08,fp7d
2020-09-29,FR,24,24,0,24,2022-05-03_11-02-08,fp7d
2020-09-29,GE,40,40,2,38,2022-05-03_11-02-08,fp7d
2020-09-29,GL,NA,NA,NA,NA,2022-05-03_11-02-08,fp7d
2020-09-29,GR,16,16,0,16,2022-05-03_11-02-08,fp7d
2020-09-29,JU,6,6,0,6,2022-05-03_11-02-08,fp7d
2020-09-29,LU,40,36,0,36,2022-05-03_11-02-08,fp7d
2020-09-29,NE,10,10,0,10,2022-05-03_11-02-08,fp7d
2020-09-29,NW,6,4,0,4,2022-05-03_11-02-08,fp7d
2020-09-29,OW,0,0,0,0,2022-05-03_11-02-08,fp7d
2020-09-29,SG,54,55,1,54,2022-05-03_11-02-08,fp7d
2020-09-29,SH,8,7,0,7,2022-05-03_11-02-08,fp7d
2020-09-29,SO,17,17,0,17,2022-05-03_11-02-08,fp7d
2020-09-29,SZ,12,11,0,11,2022-05-03_11-02-08,fp7d
2020-09-29,TG,21,37,16,21,2022-05-03_11-02-08,fp7d
2020-09-29,TI,47,60,13,47,2022-05-03_11-02-08,fp7d
2020-09-29,UR,6,6,0,6,2022-05-03_11-02-08,fp7d
2020-09-29,VD,79,93,15,78,2022-05-03_11-02-08,fp7d
2020-09-29,VS,21,27,6,21,2022-05-03_11-02-08,fp7d
2020-09-29,ZG,8,8,0,8,2022-05-03_11-02-08,fp7d
2020-09-29,ZH,198,300,102,198,2022-05-03_11-02-08,fp7d
2020-09-30,AG,52,50,0,50,2022-05-03_11-02-08,fp7d
2020-09-30,AI,0,0,0,0,2022-05-03_11-02-08,fp7d
2020-09-30,AR,NA,NA,NA,NA,2022-05-03_11-02-08,fp7d
2020-09-30,BE,92,102,12,90,2022-05-03_11-02-08,fp7d
2020-09-30,BL,20,16,0,16,2022-05-03_11-02-08,fp7d
2020-09-30,BS,54,50,0,50,2022-05-03_11-02-08,fp7d
2020-09-30,FR,24,24,0,24,2022-05-03_11-02-08,fp7d
2020-09-30,GE,40,40,2,38,2022-05-03_11-02-08,fp7d
2020-09-30,GL,NA,NA,NA,NA,2022-05-03_11-02-08,fp7d
2020-09-30,GR,16,16,0,16,2022-05-03_11-02-08,fp7d
2020-09-30,JU,6,6,0,6,2022-05-03_11-02-08,fp7d
2020-09-30,LU,40,36,0,36,2022-05-03_11-02-08,fp7d
2020-09-30,NE,10,10,0,10,2022-05-03_11-02-08,fp7d
2020-09-30,NW,6,4,0,4,2022-05-03_11-02-08,fp7d
2020-09-30,OW,0,0,0,0,2022-05-03_11-02-08,fp7d
2020-09-30,SG,48,49,1,48,2022-05-03_11-02-08,fp7d
2020-09-30,SH,8,7,0,7,2022-05-03_11-02-08,fp7d
2020-09-30,SO,17,17,0,17,2022-05-03_11-02-08,fp7d
2020-09-30,SZ,12,11,0,11,2022-05-03_11-02-08,fp7d
2020-09-30,TG,21,37,16,21,2022-05-03_11-02-08,fp7d
2020-09-30,TI,47,60,13,47,2022-05-03_11-02-08,fp7d
2020-09-30,UR,6,6,0,6,2022-05-03_11-02-08,fp7d
2020-09-30,VD,79,93,15,78,2022-05-03_11-02-08,fp7d
2020-09-30,VS,21,27,6,21,2022-05-03_11-02-08,fp7d
2020-09-30,ZG,8,8,0,8,2022-05-03_11-02-08,fp7d
2020-09-30,ZH,198,301,103,198,2022-05-03_11-02-08,fp7d
2020-10-01,AG,52,50,0,50,2022-05-03_11-02-08,fp7d
2020-10-01,AI,0,0,0,0,2022-05-03_11-02-08,fp7d
2020-10-01,AR,NA,NA,NA,NA,2022-05-03_11-02-08,fp7d
2020-10-01,BE,92,102,12,90,2022-05-03_11-02-08,fp7d
2020-10-01,BL,20,16,0,16,2022-05-03_11-02-08,fp7d
2020-10-01,BS,54,50,0,50,2022-05-03_11-02-08,fp7d
2020-10-01,FR,24,24,0,24,2022-05-03_11-02-08,fp7d
2020-10-01,GE,40,40,2,38,2022-05-03_11-02-08,fp7d
2020-10-01,GL,NA,NA,NA,NA,2022-05-03_11-02-08,fp7d
2020-10-01,GR,16,16,0,16,2022-05-03_11-02-08,fp7d
2020-10-01,JU,6,6,0,6,2022-05-03_11-02-08,fp7d
2020-10-01,LU,54,52,2,50,2022-05-03_11-02-08,fp7d
2020-10-01,NE,10,10,0,10,2022-05-03_11-02-08,fp7d
2020-10-01,NW,6,4,0,4,2022-05-03_11-02-08,fp7d
2020-10-01,OW,0,0,0,0,2022-05-03_11-02-08,fp7d
2020-10-01,SG,54,55,1,54,2022-05-03_11-02-08,fp7d
2020-10-01,SH,8,7,0,7,2022-05-03_11-02-08,fp7d
2020-10-01,SO,17,15,0,15,2022-05-03_11-02-08,fp7d
2020-10-01,SZ,12,11,0,11,2022-05-03_11-02-08,fp7d
2020-10-01,TG,21,37,16,21,2022-05-03_11-02-08,fp7d
2020-10-01,TI,47,60,13,47,2022-05-03_11-02-08,fp7d
2020-10-01,UR,6,6,0,6,2022-05-03_11-02-08,fp7d
2020-10-01,VD,79,84,6,78,2022-05-03_11-02-08,fp7d
2020-10-01,VS,21,27,6,21,2022-05-03_11-02-08,fp7d
2020-10-01,ZG,8,8,0,8,2022-05-03_11-02-08,fp7d
2020-10-01,ZH,198,301,103,198,2022-05-03_11-02-08,fp7d
2020-10-02,AG,52,50,0,50,2022-05-03_11-02-08,fp7d
2020-10-02,AI,0,0,0,0,2022-05-03_11-02-08,fp7d
2020-10-02,AR,NA,NA,NA,NA,2022-05-03_11-02-08,fp7d
2020-10-02,BE,92,102,12,90,2022-05-03_11-02-08,fp7d
2020-10-02,BL,20,16,0,16,2022-05-03_11-02-08,fp7d
2020-10-02,BS,54,50,0,50,2022-05-03_11-02-08,fp7d
2020-10-02,FR,24,24,0,24,2022-05-03_11-02-08,fp7d
2020-10-02,GE,40,40,2,38,2022-05-03_11-02-08,fp7d
2020-10-02,GL,NA,NA,NA,NA,2022-05-03_11-02-08,fp7d
2020-10-02,GR,16,16,0,16,2022-05-03_11-02-08,fp7d
2020-10-02,JU,6,6,0,6,2022-05-03_11-02-08,fp7d
2020-10-02,LU,54,52,2,50,2022-05-03_11-02-08,fp7d
2020-10-02,NE,10,10,0,10,2022-05-03_11-02-08,fp7d
2020-10-02,NW,6,4,0,4,2022-05-03_11-02-08,fp7d
2020-10-02,OW,0,0,0,0,2022-05-03_11-02-08,fp7d
2020-10-02,SG,54,55,1,54,2022-05-03_11-02-08,fp7d
2020-10-02,SH,8,7,0,7,2022-05-03_11-02-08,fp7d
2020-10-02,SO,17,15,0,15,2022-05-03_11-02-08,fp7d
2020-10-02,SZ,12,11,0,11,2022-05-03_11-02-08,fp7d
2020-10-02,TG,21,37,16,21,2022-05-03_11-02-08,fp7d
2020-10-02,TI,47,60,13,47,2022-05-03_11-02-08,fp7d
2020-10-02,UR,6,6,0,6,2022-05-03_11-02-08,fp7d
2020-10-02,VD,79,84,6,78,2022-05-03_11-02-08,fp7d
2020-10-02,VS,21,27,6,21,2022-05-03_11-02-08,fp7d
2020-10-02,ZG,8,8,0,8,2022-05-03_11-02-08,fp7d
2020-10-02,ZH,198,301,103,198,2022-05-03_11-02-08,fp7d
2020-10-03,AG,52,50,0,50,2022-05-03_11-02-08,fp7d
2020-10-03,AI,0,0,0,0,2022-05-03_11-02-08,fp7d
2020-10-03,AR,NA,NA,NA,NA,2022-05-03_11-02-08,fp7d
2020-10-03,BE,92,102,12,90,2022-05-03_11-02-08,fp7d
2020-10-03,BL,20,16,0,16,2022-05-03_11-02-08,fp7d
2020-10-03,BS,54,50,0,50,2022-05-03_11-02-08,fp7d
2020-10-03,FR,24,24,0,24,2022-05-03_11-02-08,fp7d
2020-10-03,GE,40,40,2,38,2022-05-03_11-02-08,fp7d
2020-10-03,GL,NA,NA,NA,NA,2022-05-03_11-02-08,fp7d
2020-10-03,GR,16,16,0,16,2022-05-03_11-02-08,fp7d
2020-10-03,JU,6,6,0,6,2022-05-03_11-02-08,fp7d
2020-10-03,LU,54,52,2,50,2022-05-03_11-02-08,fp7d
2020-10-03,NE,10,10,0,10,2022-05-03_11-02-08,fp7d
2020-10-03,NW,6,4,0,4,2022-05-03_11-02-08,fp7d
2020-10-03,OW,0,0,0,0,2022-05-03_11-02-08,fp7d
2020-10-03,SG,54,55,1,54,2022-05-03_11-02-08,fp7d
2020-10-03,SH,8,7,0,7,2022-05-03_11-02-08,fp7d
2020-10-03,SO,17,15,0,15,2022-05-03_11-02-08,fp7d
2020-10-03,SZ,12,11,0,11,2022-05-03_11-02-08,fp7d
2020-10-03,TG,21,37,16,21,2022-05-03_11-02-08,fp7d
2020-10-03,TI,47,60,13,47,2022-05-03_11-02-08,fp7d
2020-10-03,UR,6,6,0,6,2022-05-03_11-02-08,fp7d
2020-10-03,VD,79,84,6,78,2022-05-03_11-02-08,fp7d
2020-10-03,VS,21,27,6,21,2022-05-03_11-02-08,fp7d
2020-10-03,ZG,8,8,0,8,2022-05-03_11-02-08,fp7d
2020-10-03,ZH,198,301,103,198,2022-05-03_11-02-08,fp7d
2020-10-04,AG,52,50,0,50,2022-05-03_11-02-08,fp7d
2020-10-04,AI,0,0,0,0,2022-05-03_11-02-08,fp7d
2020-10-04,AR,NA,NA,NA,NA,2022-05-03_11-02-08,fp7d
2020-10-04,BE,92,102,12,90,2022-05-03_11-02-08,fp7d
2020-10-04,BL,20,16,0,16,2022-05-03_11-02-08,fp7d
2020-10-04,BS,54,50,0,50,2022-05-03_11-02-08,fp7d
2020-10-04,FR,24,24,0,24,2022-05-03_11-02-08,fp7d
2020-10-04,GE,40,40,2,38,2022-05-03_11-02-08,fp7d
2020-10-04,GL,NA,NA,NA,NA,2022-05-03_11-02-08,fp7d
2020-10-04,GR,16,16,0,16,2022-05-03_11-02-08,fp7d
2020-10-04,JU,6,6,0,6,2022-05-03_11-02-08,fp7d
2020-10-04,LU,54,52,2,50,2022-05-03_11-02-08,fp7d
2020-10-04,NE,10,10,0,10,2022-05-03_11-02-08,fp7d
2020-10-04,NW,6,4,0,4,2022-05-03_11-02-08,fp7d
2020-10-04,OW,0,0,0,0,2022-05-03_11-02-08,fp7d
2020-10-04,SG,54,55,1,54,2022-05-03_11-02-08,fp7d
2020-10-04,SH,8,7,0,7,2022-05-03_11-02-08,fp7d
2020-10-04,SO,17,15,0,15,2022-05-03_11-02-08,fp7d
2020-10-04,SZ,12,11,0,11,2022-05-03_11-02-08,fp7d
2020-10-04,TG,21,37,16,21,2022-05-03_11-02-08,fp7d
2020-10-04,TI,47,60,13,47,2022-05-03_11-02-08,fp7d
2020-10-04,UR,6,6,0,6,2022-05-03_11-02-08,fp7d
2020-10-04,VD,79,84,6,78,2022-05-03_11-02-08,fp7d
2020-10-04,VS,21,27,6,21,2022-05-03_11-02-08,fp7d
2020-10-04,ZG,8,8,0,8,2022-05-03_11-02-08,fp7d
2020-10-04,ZH,198,301,103,198,2022-05-03_11-02-08,fp7d
2020-10-05,AG,52,50,0,50,2022-05-03_11-02-08,fp7d
2020-10-05,AI,0,0,0,0,2022-05-03_11-02-08,fp7d
2020-10-05,AR,6,10,4,6,2022-05-03_11-02-08,fp7d
2020-10-05,BE,92,102,12,90,2022-05-03_11-02-08,fp7d
2020-10-05,BL,20,16,0,16,2022-05-03_11-02-08,fp7d
2020-10-05,BS,54,50,0,50,2022-05-03_11-02-08,fp7d
2020-10-05,FR,24,24,0,24,2022-05-03_11-02-08,fp7d
2020-10-05,GE,40,40,2,38,2022-05-03_11-02-08,fp7d
2020-10-05,GL,NA,NA,NA,NA,2022-05-03_11-02-08,fp7d
2020-10-05,GR,16,16,0,16,2022-05-03_11-02-08,fp7d
2020-10-05,JU,6,6,0,6,2022-05-03_11-02-08,fp7d
2020-10-05,LU,54,52,2,50,2022-05-03_11-02-08,fp7d
2020-10-05,NE,10,10,0,10,2022-05-03_11-02-08,fp7d
2020-10-05,NW,6,4,0,4,2022-05-03_11-02-08,fp7d
2020-10-05,OW,0,0,0,0,2022-05-03_11-02-08,fp7d
2020-10-05,SG,54,55,1,54,2022-05-03_11-02-08,fp7d
2020-10-05,SH,8,7,0,7,2022-05-03_11-02-08,fp7d
2020-10-05,SO,17,15,0,15,2022-05-03_11-02-08,fp7d
2020-10-05,SZ,12,11,0,11,2022-05-03_11-02-08,fp7d
2020-10-05,TG,21,37,16,21,2022-05-03_11-02-08,fp7d
2020-10-05,TI,47,60,13,47,2022-05-03_11-02-08,fp7d
2020-10-05,UR,6,6,0,6,2022-05-03_11-02-08,fp7d
2020-10-05,VD,79,84,6,78,2022-05-03_11-02-08,fp7d
2020-10-05,VS,15,15,0,15,2022-05-03_11-02-08,fp7d
2020-10-05,ZG,8,8,0,8,2022-05-03_11-02-08,fp7d
2020-10-05,ZH,198,301,103,198,2022-05-03_11-02-08,fp7d
2020-10-06,AG,52,50,0,50,2022-05-03_11-02-08,fp7d
2020-10-06,AI,0,0,0,0,2022-05-03_11-02-08,fp7d
2020-10-06,AR,6,10,4,6,2022-05-03_11-02-08,fp7d
2020-10-06,BE,92,102,12,90,2022-05-03_11-02-08,fp7d
2020-10-06,BL,20,16,0,16,2022-05-03_11-02-08,fp7d
2020-10-06,BS,54,50,0,50,2022-05-03_11-02-08,fp7d
2020-10-06,FR,24,24,0,24,2022-05-03_11-02-08,fp7d
2020-10-06,GE,40,40,2,38,2022-05-03_11-02-08,fp7d
2020-10-06,GL,NA,NA,NA,NA,2022-05-03_11-02-08,fp7d
2020-10-06,GR,16,16,0,16,2022-05-03_11-02-08,fp7d
2020-10-06,JU,6,6,0,6,2022-05-03_11-02-08,fp7d
2020-10-06,LU,54,52,2,50,2022-05-03_11-02-08,fp7d
2020-10-06,NE,10,10,0,10,2022-05-03_11-02-08,fp7d
2020-10-06,NW,6,4,0,4,2022-05-03_11-02-08,fp7d
2020-10-06,OW,0,0,0,0,2022-05-03_11-02-08,fp7d
2020-10-06,SG,54,55,1,54,2022-05-03_11-02-08,fp7d
2020-10-06,SH,8,7,0,7,2022-05-03_11-02-08,fp7d
2020-10-06,SO,17,15,0,15,2022-05-03_11-02-08,fp7d
2020-10-06,SZ,12,11,0,11,2022-05-03_11-02-08,fp7d
2020-10-06,TG,21,37,16,21,2022-05-03_11-02-08,fp7d
2020-10-06,TI,47,60,13,47,2022-05-03_11-02-08,fp7d
2020-10-06,UR,6,6,0,6,2022-05-03_11-02-08,fp7d
2020-10-06,VD,79,84,6,78,2022-05-03_11-02-08,fp7d
2020-10-06,VS,15,15,0,15,2022-05-03_11-02-08,fp7d
2020-10-06,ZG,8,8,0,8,2022-05-03_11-02-08,fp7d
2020-10-06,ZH,198,301,103,198,2022-05-03_11-02-08,fp7d
2020-10-07,AG,52,50,0,50,2022-05-03_11-02-08,fp7d
2020-10-07,AI,0,0,0,0,2022-05-03_11-02-08,fp7d
2020-10-07,AR,6,10,4,6,2022-05-03_11-02-08,fp7d
2020-10-07,BE,92,102,12,90,2022-05-03_11-02-08,fp7d
2020-10-07,BL,20,16,0,16,2022-05-03_11-02-08,fp7d
2020-10-07,BS,54,50,0,50,2022-05-03_11-02-08,fp7d
2020-10-07,FR,24,24,0,24,2022-05-03_11-02-08,fp7d
2020-10-07,GE,40,40,2,38,2022-05-03_11-02-08,fp7d
2020-10-07,GL,NA,NA,NA,NA,2022-05-03_11-02-08,fp7d
2020-10-07,GR,16,16,0,16,2022-05-03_11-02-08,fp7d
2020-10-07,JU,6,6,0,6,2022-05-03_11-02-08,fp7d
2020-10-07,LU,54,52,2,50,2022-05-03_11-02-08,fp7d
2020-10-07,NE,10,10,0,10,2022-05-03_11-02-08,fp7d
2020-10-07,NW,6,5,0,5,2022-05-03_11-02-08,fp7d
2020-10-07,OW,0,0,0,0,2022-05-03_11-02-08,fp7d
2020-10-07,SG,54,55,1,54,2022-05-03_11-02-08,fp7d
2020-10-07,SH,8,7,0,7,2022-05-03_11-02-08,fp7d
2020-10-07,SO,17,15,0,15,2022-05-03_11-02-08,fp7d
2020-10-07,SZ,12,11,0,11,2022-05-03_11-02-08,fp7d
2020-10-07,TG,21,37,16,21,2022-05-03_11-02-08,fp7d
2020-10-07,TI,47,60,13,47,2022-05-03_11-02-08,fp7d
2020-10-07,UR,6,6,0,6,2022-05-03_11-02-08,fp7d
2020-10-07,VD,79,84,6,78,2022-05-03_11-02-08,fp7d
2020-10-07,VS,15,15,0,15,2022-05-03_11-02-08,fp7d
2020-10-07,ZG,8,8,0,8,2022-05-03_11-02-08,fp7d
2020-10-07,ZH,198,301,103,198,2022-05-03_11-02-08,fp7d
2020-10-08,AG,52,50,0,50,2022-05-03_11-02-08,fp7d
2020-10-08,AI,0,0,0,0,2022-05-03_11-02-08,fp7d
2020-10-08,AR,6,10,4,6,2022-05-03_11-02-08,fp7d
2020-10-08,BE,104,112,12,100,2022-05-03_11-02-08,fp7d
2020-10-08,BL,20,16,0,16,2022-05-03_11-02-08,fp7d
2020-10-08,BS,54,50,0,50,2022-05-03_11-02-08,fp7d
2020-10-08,FR,24,24,0,24,2022-05-03_11-02-08,fp7d
2020-10-08,GE,40,40,2,38,2022-05-03_11-02-08,fp7d
2020-10-08,GL,NA,NA,NA,NA,2022-05-03_11-02-08,fp7d
2020-10-08,GR,16,16,0,16,2022-05-03_11-02-08,fp7d
2020-10-08,JU,6,6,0,6,2022-05-03_11-02-08,fp7d
2020-10-08,LU,54,52,2,50,2022-05-03_11-02-08,fp7d
2020-10-08,NE,10,10,0,10,2022-05-03_11-02-08,fp7d
2020-10-08,NW,6,4,0,4,2022-05-03_11-02-08,fp7d
2020-10-08,OW,0,0,0,0,2022-05-03_11-02-08,fp7d
2020-10-08,SG,54,55,1,54,2022-05-03_11-02-08,fp7d
2020-10-08,SH,8,7,0,7,2022-05-03_11-02-08,fp7d
2020-10-08,SO,17,15,0,15,2022-05-03_11-02-08,fp7d
2020-10-08,SZ,12,11,0,11,2022-05-03_11-02-08,fp7d
2020-10-08,TG,21,37,16,21,2022-05-03_11-02-08,fp7d
2020-10-08,TI,38,51,13,38,2022-05-03_11-02-08,fp7d
2020-10-08,UR,6,6,0,6,2022-05-03_11-02-08,fp7d
2020-10-08,VD,79,84,6,78,2022-05-03_11-02-08,fp7d
2020-10-08,VS,15,15,0,15,2022-05-03_11-02-08,fp7d
2020-10-08,ZG,8,8,0,8,2022-05-03_11-02-08,fp7d
2020-10-08,ZH,198,301,103,198,2022-05-03_11-02-08,fp7d
2020-10-09,AG,52,50,0,50,2022-05-03_11-02-08,fp7d
2020-10-09,AI,0,0,0,0,2022-05-03_11-02-08,fp7d
2020-10-09,AR,6,10,4,6,2022-05-03_11-02-08,fp7d
2020-10-09,BE,104,112,12,100,2022-05-03_11-02-08,fp7d
2020-10-09,BL,20,16,0,16,2022-05-03_11-02-08,fp7d
2020-10-09,BS,46,42,0,42,2022-05-03_11-02-08,fp7d
2020-10-09,FR,24,24,0,24,2022-05-03_11-02-08,fp7d
2020-10-09,GE,40,40,2,38,2022-05-03_11-02-08,fp7d
2020-10-09,GL,NA,NA,NA,NA,2022-05-03_11-02-08,fp7d
2020-10-09,GR,16,16,0,16,2022-05-03_11-02-08,fp7d
2020-10-09,JU,6,6,0,6,2022-05-03_11-02-08,fp7d
2020-10-09,LU,54,52,2,50,2022-05-03_11-02-08,fp7d
2020-10-09,NE,10,10,0,10,2022-05-03_11-02-08,fp7d
2020-10-09,NW,6,4,0,4,2022-05-03_11-02-08,fp7d
2020-10-09,OW,0,0,0,0,2022-05-03_11-02-08,fp7d
2020-10-09,SG,54,55,1,54,2022-05-03_11-02-08,fp7d
2020-10-09,SH,8,7,0,7,2022-05-03_11-02-08,fp7d
2020-10-09,SO,17,15,0,15,2022-05-03_11-02-08,fp7d
2020-10-09,SZ,12,11,0,11,2022-05-03_11-02-08,fp7d
2020-10-09,TG,21,37,16,21,2022-05-03_11-02-08,fp7d
2020-10-09,TI,38,51,13,38,2022-05-03_11-02-08,fp7d
2020-10-09,UR,6,6,0,6,2022-05-03_11-02-08,fp7d
2020-10-09,VD,79,84,6,78,2022-05-03_11-02-08,fp7d
2020-10-09,VS,15,15,0,15,2022-05-03_11-02-08,fp7d
2020-10-09,ZG,8,8,0,8,2022-05-03_11-02-08,fp7d
2020-10-09,ZH,198,299,101,198,2022-05-03_11-02-08,fp7d
2020-10-10,AG,52,50,0,50,2022-05-03_11-02-08,fp7d
2020-10-10,AI,0,0,0,0,2022-05-03_11-02-08,fp7d
2020-10-10,AR,6,10,4,6,2022-05-03_11-02-08,fp7d
2020-10-10,BE,104,112,12,100,2022-05-03_11-02-08,fp7d
2020-10-10,BL,20,16,0,16,2022-05-03_11-02-08,fp7d
2020-10-10,BS,46,42,0,42,2022-05-03_11-02-08,fp7d
2020-10-10,FR,24,24,0,24,2022-05-03_11-02-08,fp7d
2020-10-10,GE,40,40,2,38,2022-05-03_11-02-08,fp7d
2020-10-10,GL,NA,NA,NA,NA,2022-05-03_11-02-08,fp7d
2020-10-10,GR,16,16,0,16,2022-05-03_11-02-08,fp7d
2020-10-10,JU,6,6,0,6,2022-05-03_11-02-08,fp7d
2020-10-10,LU,54,52,2,50,2022-05-03_11-02-08,fp7d
2020-10-10,NE,10,10,0,10,2022-05-03_11-02-08,fp7d
2020-10-10,NW,6,4,0,4,2022-05-03_11-02-08,fp7d
2020-10-10,OW,0,0,0,0,2022-05-03_11-02-08,fp7d
2020-10-10,SG,54,55,1,54,2022-05-03_11-02-08,fp7d
2020-10-10,SH,8,7,0,7,2022-05-03_11-02-08,fp7d
2020-10-10,SO,17,15,0,15,2022-05-03_11-02-08,fp7d
2020-10-10,SZ,12,11,0,11,2022-05-03_11-02-08,fp7d
2020-10-10,TG,21,37,16,21,2022-05-03_11-02-08,fp7d
2020-10-10,TI,38,51,13,38,2022-05-03_11-02-08,fp7d
2020-10-10,UR,6,6,0,6,2022-05-03_11-02-08,fp7d
2020-10-10,VD,79,84,6,78,2022-05-03_11-02-08,fp7d
2020-10-10,VS,15,15,0,15,2022-05-03_11-02-08,fp7d
2020-10-10,ZG,8,8,0,8,2022-05-03_11-02-08,fp7d
2020-10-10,ZH,198,299,101,198,2022-05-03_11-02-08,fp7d
2020-10-11,AG,52,50,0,50,2022-05-03_11-02-08,fp7d
2020-10-11,AI,0,0,0,0,2022-05-03_11-02-08,fp7d
2020-10-11,AR,6,10,4,6,2022-05-03_11-02-08,fp7d
2020-10-11,BE,104,112,12,100,2022-05-03_11-02-08,fp7d
2020-10-11,BL,20,16,0,16,2022-05-03_11-02-08,fp7d
2020-10-11,BS,46,42,0,42,2022-05-03_11-02-08,fp7d
2020-10-11,FR,24,24,0,24,2022-05-03_11-02-08,fp7d
2020-10-11,GE,40,40,2,38,2022-05-03_11-02-08,fp7d
2020-10-11,GL,NA,NA,NA,NA,2022-05-03_11-02-08,fp7d
2020-10-11,GR,16,16,0,16,2022-05-03_11-02-08,fp7d
2020-10-11,JU,6,6,0,6,2022-05-03_11-02-08,fp7d
2020-10-11,LU,54,52,2,50,2022-05-03_11-02-08,fp7d
2020-10-11,NE,10,10,0,10,2022-05-03_11-02-08,fp7d
2020-10-11,NW,6,4,0,4,2022-05-03_11-02-08,fp7d
2020-10-11,OW,0,0,0,0,2022-05-03_11-02-08,fp7d
2020-10-11,SG,54,55,1,54,2022-05-03_11-02-08,fp7d
2020-10-11,SH,8,7,0,7,2022-05-03_11-02-08,fp7d
2020-10-11,SO,17,15,0,15,2022-05-03_11-02-08,fp7d
2020-10-11,SZ,12,11,0,11,2022-05-03_11-02-08,fp7d
2020-10-11,TG,21,37,16,21,2022-05-03_11-02-08,fp7d
2020-10-11,TI,38,51,13,38,2022-05-03_11-02-08,fp7d
2020-10-11,UR,6,6,0,6,2022-05-03_11-02-08,fp7d
2020-10-11,VD,79,90,12,78,2022-05-03_11-02-08,fp7d
2020-10-11,VS,15,15,0,15,2022-05-03_11-02-08,fp7d
2020-10-11,ZG,8,8,0,8,2022-05-03_11-02-08,fp7d
2020-10-11,ZH,198,299,101,198,2022-05-03_11-02-08,fp7d
2020-10-12,AG,52,50,0,50,2022-05-03_11-02-08,fp7d
2020-10-12,AI,0,0,0,0,2022-05-03_11-02-08,fp7d
2020-10-12,AR,6,10,4,6,2022-05-03_11-02-08,fp7d
2020-10-12,BE,104,112,12,100,2022-05-03_11-02-08,fp7d
2020-10-12,BL,20,16,0,16,2022-05-03_11-02-08,fp7d
2020-10-12,BS,54,50,0,50,2022-05-03_11-02-08,fp7d
2020-10-12,FR,24,24,0,24,2022-05-03_11-02-08,fp7d
2020-10-12,GE,40,40,2,38,2022-05-03_11-02-08,fp7d
2020-10-12,GL,NA,NA,NA,NA,2022-05-03_11-02-08,fp7d
2020-10-12,GR,16,16,0,16,2022-05-03_11-02-08,fp7d
2020-10-12,JU,6,6,0,6,2022-05-03_11-02-08,fp7d
2020-10-12,LU,54,52,2,50,2022-05-03_11-02-08,fp7d
2020-10-12,NE,10,10,0,10,2022-05-03_11-02-08,fp7d
2020-10-12,NW,6,4,0,4,2022-05-03_11-02-08,fp7d
2020-10-12,OW,0,0,0,0,2022-05-03_11-02-08,fp7d
2020-10-12,SG,48,49,1,48,2022-05-03_11-02-08,fp7d
2020-10-12,SH,8,7,0,7,2022-05-03_11-02-08,fp7d
2020-10-12,SO,17,15,0,15,2022-05-03_11-02-08,fp7d
2020-10-12,SZ,12,11,0,11,2022-05-03_11-02-08,fp7d
2020-10-12,TG,21,37,16,21,2022-05-03_11-02-08,fp7d
2020-10-12,TI,38,51,13,38,2022-05-03_11-02-08,fp7d
2020-10-12,UR,6,6,0,6,2022-05-03_11-02-08,fp7d
2020-10-12,VD,79,90,12,78,2022-05-03_11-02-08,fp7d
2020-10-12,VS,21,27,6,21,2022-05-03_11-02-08,fp7d
2020-10-12,ZG,8,8,0,8,2022-05-03_11-02-08,fp7d
2020-10-12,ZH,198,299,101,198,2022-05-03_11-02-08,fp7d
2020-10-13,AG,52,50,0,50,2022-05-03_11-02-08,fp7d
2020-10-13,AI,0,0,0,0,2022-05-03_11-02-08,fp7d
2020-10-13,AR,6,10,4,6,2022-05-03_11-02-08,fp7d
2020-10-13,BE,104,112,12,100,2022-05-03_11-02-08,fp7d
2020-10-13,BL,20,16,0,16,2022-05-03_11-02-08,fp7d
2020-10-13,BS,54,50,0,50,2022-05-03_11-02-08,fp7d
2020-10-13,FR,24,24,0,24,2022-05-03_11-02-08,fp7d
2020-10-13,GE,40,40,2,38,2022-05-03_11-02-08,fp7d
2020-10-13,GL,NA,NA,NA,NA,2022-05-03_11-02-08,fp7d
2020-10-13,GR,16,16,0,16,2022-05-03_11-02-08,fp7d
2020-10-13,JU,6,6,0,6,2022-05-03_11-02-08,fp7d
2020-10-13,LU,54,52,2,50,2022-05-03_11-02-08,fp7d
2020-10-13,NE,10,10,0,10,2022-05-03_11-02-08,fp7d
2020-10-13,NW,6,6,0,6,2022-05-03_11-02-08,fp7d
2020-10-13,OW,0,0,0,0,2022-05-03_11-02-08,fp7d
2020-10-13,SG,48,49,1,48,2022-05-03_11-02-08,fp7d
2020-10-13,SH,8,7,0,7,2022-05-03_11-02-08,fp7d
2020-10-13,SO,17,15,0,15,2022-05-03_11-02-08,fp7d
2020-10-13,SZ,12,11,0,11,2022-05-03_11-02-08,fp7d
2020-10-13,TG,21,37,16,21,2022-05-03_11-02-08,fp7d
2020-10-13,TI,38,51,13,38,2022-05-03_11-02-08,fp7d
2020-10-13,UR,6,6,0,6,2022-05-03_11-02-08,fp7d
2020-10-13,VD,79,90,12,78,2022-05-03_11-02-08,fp7d
2020-10-13,VS,21,27,6,21,2022-05-03_11-02-08,fp7d
2020-10-13,ZG,8,8,0,8,2022-05-03_11-02-08,fp7d
2020-10-13,ZH,198,299,101,198,2022-05-03_11-02-08,fp7d
2020-10-14,AG,52,50,0,50,2022-05-03_11-02-08,fp7d
2020-10-14,AI,0,0,0,0,2022-05-03_11-02-08,fp7d
2020-10-14,AR,6,10,4,6,2022-05-03_11-02-08,fp7d
2020-10-14,BE,104,112,12,100,2022-05-03_11-02-08,fp7d
2020-10-14,BL,20,16,0,16,2022-05-03_11-02-08,fp7d
2020-10-14,BS,54,50,0,50,2022-05-03_11-02-08,fp7d
2020-10-14,FR,24,24,0,24,2022-05-03_11-02-08,fp7d
2020-10-14,GE,40,40,2,38,2022-05-03_11-02-08,fp7d
2020-10-14,GL,NA,NA,NA,NA,2022-05-03_11-02-08,fp7d
2020-10-14,GR,16,16,0,16,2022-05-03_11-02-08,fp7d
2020-10-14,JU,6,6,0,6,2022-05-03_11-02-08,fp7d
2020-10-14,LU,54,54,2,52,2022-05-03_11-02-08,fp7d
2020-10-14,NE,10,10,0,10,2022-05-03_11-02-08,fp7d
2020-10-14,NW,6,6,0,6,2022-05-03_11-02-08,fp7d
2020-10-14,OW,0,0,0,0,2022-05-03_11-02-08,fp7d
2020-10-14,SG,54,55,1,54,2022-05-03_11-02-08,fp7d
2020-10-14,SH,8,8,0,8,2022-05-03_11-02-08,fp7d
2020-10-14,SO,17,15,0,15,2022-05-03_11-02-08,fp7d
2020-10-14,SZ,12,11,0,11,2022-05-03_11-02-08,fp7d
2020-10-14,TG,21,37,16,21,2022-05-03_11-02-08,fp7d
2020-10-14,TI,47,60,13,47,2022-05-03_11-02-08,fp7d
2020-10-14,UR,6,6,0,6,2022-05-03_11-02-08,fp7d
2020-10-14,VD,79,90,12,78,2022-05-03_11-02-08,fp7d
2020-10-14,VS,21,27,6,21,2022-05-03_11-02-08,fp7d
2020-10-14,ZG,8,8,0,8,2022-05-03_11-02-08,fp7d
2020-10-14,ZH,198,299,101,198,2022-05-03_11-02-08,fp7d
2020-10-15,AG,52,50,0,50,2022-05-03_11-02-08,fp7d
2020-10-15,AI,0,0,0,0,2022-05-03_11-02-08,fp7d
2020-10-15,AR,6,10,4,6,2022-05-03_11-02-08,fp7d
2020-10-15,BE,104,112,12,100,2022-05-03_11-02-08,fp7d
2020-10-15,BL,20,16,0,16,2022-05-03_11-02-08,fp7d
2020-10-15,BS,54,50,0,50,2022-05-03_11-02-08,fp7d
2020-10-15,FR,24,24,0,24,2022-05-03_11-02-08,fp7d
2020-10-15,GE,40,40,2,38,2022-05-03_11-02-08,fp7d
2020-10-15,GL,NA,NA,NA,NA,2022-05-03_11-02-08,fp7d
2020-10-15,GR,16,16,0,16,2022-05-03_11-02-08,fp7d
2020-10-15,JU,6,6,0,6,2022-05-03_11-02-08,fp7d
2020-10-15,LU,54,54,2,52,2022-05-03_11-02-08,fp7d
2020-10-15,NE,10,10,0,10,2022-05-03_11-02-08,fp7d
2020-10-15,NW,6,6,0,6,2022-05-03_11-02-08,fp7d
2020-10-15,OW,0,0,0,0,2022-05-03_11-02-08,fp7d
2020-10-15,SG,54,55,1,54,2022-05-03_11-02-08,fp7d
2020-10-15,SH,8,7,0,7,2022-05-03_11-02-08,fp7d
2020-10-15,SO,17,15,0,15,2022-05-03_11-02-08,fp7d
2020-10-15,SZ,12,11,0,11,2022-05-03_11-02-08,fp7d
2020-10-15,TG,21,37,16,21,2022-05-03_11-02-08,fp7d
2020-10-15,TI,47,60,13,47,2022-05-03_11-02-08,fp7d
2020-10-15,UR,6,6,0,6,2022-05-03_11-02-08,fp7d
2020-10-15,VD,79,86,8,78,2022-05-03_11-02-08,fp7d
2020-10-15,VS,21,27,6,21,2022-05-03_11-02-08,fp7d
2020-10-15,ZG,8,8,0,8,2022-05-03_11-02-08,fp7d
2020-10-15,ZH,198,301,103,198,2022-05-03_11-02-08,fp7d
2020-10-16,AG,52,50,0,50,2022-05-03_11-02-08,fp7d
2020-10-16,AI,0,0,0,0,2022-05-03_11-02-08,fp7d
2020-10-16,AR,6,10,4,6,2022-05-03_11-02-08,fp7d
2020-10-16,BE,95,103,12,91,2022-05-03_11-02-08,fp7d
2020-10-16,BL,20,16,0,16,2022-05-03_11-02-08,fp7d
2020-10-16,BS,54,50,0,50,2022-05-03_11-02-08,fp7d
2020-10-16,FR,24,24,0,24,2022-05-03_11-02-08,fp7d
2020-10-16,GE,40,40,2,38,2022-05-03_11-02-08,fp7d
2020-10-16,GL,NA,NA,NA,NA,2022-05-03_11-02-08,fp7d
2020-10-16,GR,16,16,0,16,2022-05-03_11-02-08,fp7d
2020-10-16,JU,6,6,0,6,2022-05-03_11-02-08,fp7d
2020-10-16,LU,54,54,2,52,2022-05-03_11-02-08,fp7d
2020-10-16,NE,10,10,0,10,2022-05-03_11-02-08,fp7d
2020-10-16,NW,6,6,0,6,2022-05-03_11-02-08,fp7d
2020-10-16,OW,0,0,0,0,2022-05-03_11-02-08,fp7d
2020-10-16,SG,54,55,1,54,2022-05-03_11-02-08,fp7d
2020-10-16,SH,8,7,0,7,2022-05-03_11-02-08,fp7d
2020-10-16,SO,17,15,0,15,2022-05-03_11-02-08,fp7d
2020-10-16,SZ,12,11,0,11,2022-05-03_11-02-08,fp7d
2020-10-16,TG,21,37,16,21,2022-05-03_11-02-08,fp7d
2020-10-16,TI,47,60,13,47,2022-05-03_11-02-08,fp7d
2020-10-16,UR,6,6,0,6,2022-05-03_11-02-08,fp7d
2020-10-16,VD,79,86,8,78,2022-05-03_11-02-08,fp7d
2020-10-16,VS,21,27,6,21,2022-05-03_11-02-08,fp7d
2020-10-16,ZG,8,8,0,8,2022-05-03_11-02-08,fp7d
2020-10-16,ZH,198,301,103,198,2022-05-03_11-02-08,fp7d
2020-10-17,AG,52,50,0,50,2022-05-03_11-02-08,fp7d
2020-10-17,AI,0,0,0,0,2022-05-03_11-02-08,fp7d
2020-10-17,AR,6,10,4,6,2022-05-03_11-02-08,fp7d
2020-10-17,BE,95,103,12,91,2022-05-03_11-02-08,fp7d
2020-10-17,BL,20,16,0,16,2022-05-03_11-02-08,fp7d
2020-10-17,BS,54,50,0,50,2022-05-03_11-02-08,fp7d
2020-10-17,FR,24,24,0,24,2022-05-03_11-02-08,fp7d
2020-10-17,GE,40,40,2,38,2022-05-03_11-02-08,fp7d
2020-10-17,GL,NA,NA,NA,NA,2022-05-03_11-02-08,fp7d
2020-10-17,GR,16,16,0,16,2022-05-03_11-02-08,fp7d
2020-10-17,JU,6,6,0,6,2022-05-03_11-02-08,fp7d
2020-10-17,LU,54,54,2,52,2022-05-03_11-02-08,fp7d
2020-10-17,NE,10,10,0,10,2022-05-03_11-02-08,fp7d
2020-10-17,NW,6,6,0,6,2022-05-03_11-02-08,fp7d
2020-10-17,OW,0,0,0,0,2022-05-03_11-02-08,fp7d
2020-10-17,SG,54,55,1,54,2022-05-03_11-02-08,fp7d
2020-10-17,SH,8,8,0,8,2022-05-03_11-02-08,fp7d
2020-10-17,SO,17,15,0,15,2022-05-03_11-02-08,fp7d
2020-10-17,SZ,12,11,0,11,2022-05-03_11-02-08,fp7d
2020-10-17,TG,21,37,16,21,2022-05-03_11-02-08,fp7d
2020-10-17,TI,47,60,13,47,2022-05-03_11-02-08,fp7d
2020-10-17,UR,6,6,0,6,2022-05-03_11-02-08,fp7d
2020-10-17,VD,79,86,8,78,2022-05-03_11-02-08,fp7d
2020-10-17,VS,21,27,6,21,2022-05-03_11-02-08,fp7d
2020-10-17,ZG,8,8,0,8,2022-05-03_11-02-08,fp7d
2020-10-17,ZH,198,301,103,198,2022-05-03_11-02-08,fp7d
2020-10-18,AG,52,50,0,50,2022-05-03_11-02-08,fp7d
2020-10-18,AI,0,0,0,0,2022-05-03_11-02-08,fp7d
2020-10-18,AR,6,10,4,6,2022-05-03_11-02-08,fp7d
2020-10-18,BE,104,112,12,100,2022-05-03_11-02-08,fp7d
2020-10-18,BL,20,16,0,16,2022-05-03_11-02-08,fp7d
2020-10-18,BS,54,50,0,50,2022-05-03_11-02-08,fp7d
2020-10-18,FR,24,24,0,24,2022-05-03_11-02-08,fp7d
2020-10-18,GE,40,40,2,38,2022-05-03_11-02-08,fp7d
2020-10-18,GL,NA,NA,NA,NA,2022-05-03_11-02-08,fp7d
2020-10-18,GR,16,16,0,16,2022-05-03_11-02-08,fp7d
2020-10-18,JU,6,6,0,6,2022-05-03_11-02-08,fp7d
2020-10-18,LU,54,54,2,52,2022-05-03_11-02-08,fp7d
2020-10-18,NE,10,10,0,10,2022-05-03_11-02-08,fp7d
2020-10-18,NW,6,6,0,6,2022-05-03_11-02-08,fp7d
2020-10-18,OW,0,0,0,0,2022-05-03_11-02-08,fp7d
2020-10-18,SG,54,55,1,54,2022-05-03_11-02-08,fp7d
2020-10-18,SH,8,8,0,8,2022-05-03_11-02-08,fp7d
2020-10-18,SO,17,15,0,15,2022-05-03_11-02-08,fp7d
2020-10-18,SZ,12,11,0,11,2022-05-03_11-02-08,fp7d
2020-10-18,TG,21,37,16,21,2022-05-03_11-02-08,fp7d
2020-10-18,TI,47,60,13,47,2022-05-03_11-02-08,fp7d
2020-10-18,UR,6,6,0,6,2022-05-03_11-02-08,fp7d
2020-10-18,VD,79,86,8,78,2022-05-03_11-02-08,fp7d
2020-10-18,VS,21,27,6,21,2022-05-03_11-02-08,fp7d
2020-10-18,ZG,8,8,0,8,2022-05-03_11-02-08,fp7d
2020-10-18,ZH,198,301,103,198,2022-05-03_11-02-08,fp7d
2020-10-19,AG,52,50,0,50,2022-05-03_11-02-08,fp7d
2020-10-19,AI,0,0,0,0,2022-05-03_11-02-08,fp7d
2020-10-19,AR,6,10,4,6,2022-05-03_11-02-08,fp7d
2020-10-19,BE,104,112,12,100,2022-05-03_11-02-08,fp7d
2020-10-19,BL,20,16,0,16,2022-05-03_11-02-08,fp7d
2020-10-19,BS,54,50,0,50,2022-05-03_11-02-08,fp7d
2020-10-19,FR,24,24,0,24,2022-05-03_11-02-08,fp7d
2020-10-19,GE,40,40,2,38,2022-05-03_11-02-08,fp7d
2020-10-19,GL,NA,NA,NA,NA,2022-05-03_11-02-08,fp7d
2020-10-19,GR,16,16,0,16,2022-05-03_11-02-08,fp7d
2020-10-19,JU,6,6,0,6,2022-05-03_11-02-08,fp7d
2020-10-19,LU,54,54,2,52,2022-05-03_11-02-08,fp7d
2020-10-19,NE,10,10,0,10,2022-05-03_11-02-08,fp7d
2020-10-19,NW,6,6,0,6,2022-05-03_11-02-08,fp7d
2020-10-19,OW,0,0,0,0,2022-05-03_11-02-08,fp7d
2020-10-19,SG,54,55,1,54,2022-05-03_11-02-08,fp7d
2020-10-19,SH,8,8,0,8,2022-05-03_11-02-08,fp7d
2020-10-19,SO,17,15,0,15,2022-05-03_11-02-08,fp7d
2020-10-19,SZ,12,11,0,11,2022-05-03_11-02-08,fp7d
2020-10-19,TG,21,37,16,21,2022-05-03_11-02-08,fp7d
2020-10-19,TI,47,60,13,47,2022-05-03_11-02-08,fp7d
2020-10-19,UR,6,6,0,6,2022-05-03_11-02-08,fp7d
2020-10-19,VD,79,86,8,78,2022-05-03_11-02-08,fp7d
2020-10-19,VS,21,25,4,21,2022-05-03_11-02-08,fp7d
2020-10-19,ZG,8,8,0,8,2022-05-03_11-02-08,fp7d
2020-10-19,ZH,198,301,103,198,2022-05-03_11-02-08,fp7d
2020-10-20,AG,52,50,0,50,2022-05-03_11-02-08,fp7d
2020-10-20,AI,0,0,0,0,2022-05-03_11-02-08,fp7d
2020-10-20,AR,6,10,4,6,2022-05-03_11-02-08,fp7d
2020-10-20,BE,104,112,12,100,2022-05-03_11-02-08,fp7d
2020-10-20,BL,20,16,0,16,2022-05-03_11-02-08,fp7d
2020-10-20,BS,54,50,0,50,2022-05-03_11-02-08,fp7d
2020-10-20,FR,24,24,0,24,2022-05-03_11-02-08,fp7d
2020-10-20,GE,40,40,2,38,2022-05-03_11-02-08,fp7d
2020-10-20,GL,NA,NA,NA,NA,2022-05-03_11-02-08,fp7d
2020-10-20,GR,16,16,0,16,2022-05-03_11-02-08,fp7d
2020-10-20,JU,6,6,0,6,2022-05-03_11-02-08,fp7d
2020-10-20,LU,54,54,2,52,2022-05-03_11-02-08,fp7d
2020-10-20,NE,10,12,2,10,2022-05-03_11-02-08,fp7d
2020-10-20,NW,6,6,0,6,2022-05-03_11-02-08,fp7d
2020-10-20,OW,0,0,0,0,2022-05-03_11-02-08,fp7d
2020-10-20,SG,54,55,1,54,2022-05-03_11-02-08,fp7d
2020-10-20,SH,8,8,0,8,2022-05-03_11-02-08,fp7d
2020-10-20,SO,17,15,0,15,2022-05-03_11-02-08,fp7d
2020-10-20,SZ,12,11,0,11,2022-05-03_11-02-08,fp7d
2020-10-20,TG,21,37,16,21,2022-05-03_11-02-08,fp7d
2020-10-20,TI,47,60,13,47,2022-05-03_11-02-08,fp7d
2020-10-20,UR,6,6,0,6,2022-05-03_11-02-08,fp7d
2020-10-20,VD,79,86,8,78,2022-05-03_11-02-08,fp7d
2020-10-20,VS,21,25,4,21,2022-05-03_11-02-08,fp7d
2020-10-20,ZG,8,8,0,8,2022-05-03_11-02-08,fp7d
2020-10-20,ZH,198,301,103,198,2022-05-03_11-02-08,fp7d
2020-10-21,AG,52,50,0,50,2022-05-03_11-02-08,fp7d
2020-10-21,AI,0,0,0,0,2022-05-03_11-02-08,fp7d
2020-10-21,AR,6,10,4,6,2022-05-03_11-02-08,fp7d
2020-10-21,BE,104,112,12,100,2022-05-03_11-02-08,fp7d
2020-10-21,BL,20,16,0,16,2022-05-03_11-02-08,fp7d
2020-10-21,BS,54,50,0,50,2022-05-03_11-02-08,fp7d
2020-10-21,FR,24,24,0,24,2022-05-03_11-02-08,fp7d
2020-10-21,GE,40,40,2,38,2022-05-03_11-02-08,fp7d
2020-10-21,GL,NA,NA,NA,NA,2022-05-03_11-02-08,fp7d
2020-10-21,GR,16,16,0,16,2022-05-03_11-02-08,fp7d
2020-10-21,JU,6,6,0,6,2022-05-03_11-02-08,fp7d
2020-10-21,LU,54,54,2,52,2022-05-03_11-02-08,fp7d
2020-10-21,NE,10,12,2,10,2022-05-03_11-02-08,fp7d
2020-10-21,NW,6,6,0,6,2022-05-03_11-02-08,fp7d
2020-10-21,OW,0,0,0,0,2022-05-03_11-02-08,fp7d
2020-10-21,SG,54,55,1,54,2022-05-03_11-02-08,fp7d
2020-10-21,SH,8,8,0,8,2022-05-03_11-02-08,fp7d
2020-10-21,SO,17,15,0,15,2022-05-03_11-02-08,fp7d
2020-10-21,SZ,12,11,0,11,2022-05-03_11-02-08,fp7d
2020-10-21,TG,21,37,16,21,2022-05-03_11-02-08,fp7d
2020-10-21,TI,47,60,13,47,2022-05-03_11-02-08,fp7d
2020-10-21,UR,6,6,0,6,2022-05-03_11-02-08,fp7d
2020-10-21,VD,79,86,8,78,2022-05-03_11-02-08,fp7d
2020-10-21,VS,21,25,4,21,2022-05-03_11-02-08,fp7d
2020-10-21,ZG,8,8,0,8,2022-05-03_11-02-08,fp7d
2020-10-21,ZH,198,300,102,198,2022-05-03_11-02-08,fp7d
2020-10-22,AG,52,50,0,50,2022-05-03_11-02-08,fp7d
2020-10-22,AI,0,0,0,0,2022-05-03_11-02-08,fp7d
2020-10-22,AR,6,6,0,6,2022-05-03_11-02-08,fp7d
2020-10-22,BE,104,112,12,100,2022-05-03_11-02-08,fp7d
2020-10-22,BL,20,16,0,16,2022-05-03_11-02-08,fp7d
2020-10-22,BS,54,50,0,50,2022-05-03_11-02-08,fp7d
2020-10-22,FR,24,24,0,24,2022-05-03_11-02-08,fp7d
2020-10-22,GE,40,40,2,38,2022-05-03_11-02-08,fp7d
2020-10-22,GL,NA,NA,NA,NA,2022-05-03_11-02-08,fp7d
2020-10-22,GR,16,16,0,16,2022-05-03_11-02-08,fp7d
2020-10-22,JU,6,6,0,6,2022-05-03_11-02-08,fp7d
2020-10-22,LU,54,54,2,52,2022-05-03_11-02-08,fp7d
2020-10-22,NE,10,14,4,10,2022-05-03_11-02-08,fp7d
2020-10-22,NW,6,6,0,6,2022-05-03_11-02-08,fp7d
2020-10-22,OW,0,0,0,0,2022-05-03_11-02-08,fp7d
2020-10-22,SG,54,55,1,54,2022-05-03_11-02-08,fp7d
2020-10-22,SH,8,8,0,8,2022-05-03_11-02-08,fp7d
2020-10-22,SO,17,15,0,15,2022-05-03_11-02-08,fp7d
2020-10-22,SZ,12,11,0,11,2022-05-03_11-02-08,fp7d
2020-10-22,TG,21,37,16,21,2022-05-03_11-02-08,fp7d
2020-10-22,TI,47,60,13,47,2022-05-03_11-02-08,fp7d
2020-10-22,UR,6,6,0,6,2022-05-03_11-02-08,fp7d
2020-10-22,VD,79,86,14,72,2022-05-03_11-02-08,fp7d
2020-10-22,VS,21,25,4,21,2022-05-03_11-02-08,fp7d
2020-10-22,ZG,8,8,0,8,2022-05-03_11-02-08,fp7d
2020-10-22,ZH,198,302,104,198,2022-05-03_11-02-08,fp7d
2020-10-23,AG,52,50,0,50,2022-05-03_11-02-08,fp7d
2020-10-23,AI,0,0,0,0,2022-05-03_11-02-08,fp7d
2020-10-23,AR,6,6,0,6,2022-05-03_11-02-08,fp7d
2020-10-23,BE,104,108,12,96,2022-05-03_11-02-08,fp7d
2020-10-23,BL,20,16,0,16,2022-05-03_11-02-08,fp7d
2020-10-23,BS,54,50,0,50,2022-05-03_11-02-08,fp7d
2020-10-23,FR,24,24,0,24,2022-05-03_11-02-08,fp7d
2020-10-23,GE,40,50,10,40,2022-05-03_11-02-08,fp7d
2020-10-23,GL,NA,NA,NA,NA,2022-05-03_11-02-08,fp7d
2020-10-23,GR,16,16,0,16,2022-05-03_11-02-08,fp7d
2020-10-23,JU,6,6,0,6,2022-05-03_11-02-08,fp7d
2020-10-23,LU,54,54,2,52,2022-05-03_11-02-08,fp7d
2020-10-23,NE,10,14,4,10,2022-05-03_11-02-08,fp7d
2020-10-23,NW,6,6,0,6,2022-05-03_11-02-08,fp7d
2020-10-23,OW,0,0,0,0,2022-05-03_11-02-08,fp7d
2020-10-23,SG,54,55,1,54,2022-05-03_11-02-08,fp7d
2020-10-23,SH,8,8,0,8,2022-05-03_11-02-08,fp7d
2020-10-23,SO,17,15,0,15,2022-05-03_11-02-08,fp7d
2020-10-23,SZ,12,11,0,11,2022-05-03_11-02-08,fp7d
2020-10-23,TG,21,37,16,21,2022-05-03_11-02-08,fp7d
2020-10-23,TI,47,60,13,47,2022-05-03_11-02-08,fp7d
2020-10-23,UR,6,6,0,6,2022-05-03_11-02-08,fp7d
2020-10-23,VD,79,89,16,73,2022-05-03_11-02-08,fp7d
2020-10-23,VS,21,25,4,21,2022-05-03_11-02-08,fp7d
2020-10-23,ZG,8,8,0,8,2022-05-03_11-02-08,fp7d
2020-10-23,ZH,198,305,107,198,2022-05-03_11-02-08,fp7d
2020-10-24,AG,52,50,0,50,2022-05-03_11-02-08,fp7d
2020-10-24,AI,0,0,0,0,2022-05-03_11-02-08,fp7d
2020-10-24,AR,6,6,0,6,2022-05-03_11-02-08,fp7d
2020-10-24,BE,104,108,12,96,2022-05-03_11-02-08,fp7d
2020-10-24,BL,20,16,0,16,2022-05-03_11-02-08,fp7d
2020-10-24,BS,54,50,0,50,2022-05-03_11-02-08,fp7d
2020-10-24,FR,24,24,0,24,2022-05-03_11-02-08,fp7d
2020-10-24,GE,40,50,10,40,2022-05-03_11-02-08,fp7d
2020-10-24,GL,NA,NA,NA,NA,2022-05-03_11-02-08,fp7d
2020-10-24,GR,16,16,0,16,2022-05-03_11-02-08,fp7d
2020-10-24,JU,6,7,1,6,2022-05-03_11-02-08,fp7d
2020-10-24,LU,54,54,2,52,2022-05-03_11-02-08,fp7d
2020-10-24,NE,10,14,4,10,2022-05-03_11-02-08,fp7d
2020-10-24,NW,6,6,0,6,2022-05-03_11-02-08,fp7d
2020-10-24,OW,0,0,0,0,2022-05-03_11-02-08,fp7d
2020-10-24,SG,54,55,1,54,2022-05-03_11-02-08,fp7d
2020-10-24,SH,8,8,0,8,2022-05-03_11-02-08,fp7d
2020-10-24,SO,17,15,0,15,2022-05-03_11-02-08,fp7d
2020-10-24,SZ,12,11,0,11,2022-05-03_11-02-08,fp7d
2020-10-24,TG,21,37,16,21,2022-05-03_11-02-08,fp7d
2020-10-24,TI,47,60,13,47,2022-05-03_11-02-08,fp7d
2020-10-24,UR,6,6,0,6,2022-05-03_11-02-08,fp7d
2020-10-24,VD,79,89,16,73,2022-05-03_11-02-08,fp7d
2020-10-24,VS,21,25,4,21,2022-05-03_11-02-08,fp7d
2020-10-24,ZG,8,8,0,8,2022-05-03_11-02-08,fp7d
2020-10-24,ZH,198,305,107,198,2022-05-03_11-02-08,fp7d
2020-10-25,AG,52,50,0,50,2022-05-03_11-02-08,fp7d
2020-10-25,AI,0,0,0,0,2022-05-03_11-02-08,fp7d
2020-10-25,AR,6,6,0,6,2022-05-03_11-02-08,fp7d
2020-10-25,BE,104,108,12,96,2022-05-03_11-02-08,fp7d
2020-10-25,BL,20,16,0,16,2022-05-03_11-02-08,fp7d
2020-10-25,BS,54,50,0,50,2022-05-03_11-02-08,fp7d
2020-10-25,FR,24,24,0,24,2022-05-03_11-02-08,fp7d
2020-10-25,GE,40,50,10,40,2022-05-03_11-02-08,fp7d
2020-10-25,GL,NA,NA,NA,NA,2022-05-03_11-02-08,fp7d
2020-10-25,GR,16,16,0,16,2022-05-03_11-02-08,fp7d
2020-10-25,JU,6,8,2,6,2022-05-03_11-02-08,fp7d
2020-10-25,LU,54,54,2,52,2022-05-03_11-02-08,fp7d
2020-10-25,NE,10,14,4,10,2022-05-03_11-02-08,fp7d
2020-10-25,NW,6,6,0,6,2022-05-03_11-02-08,fp7d
2020-10-25,OW,0,0,0,0,2022-05-03_11-02-08,fp7d
2020-10-25,SG,54,55,1,54,2022-05-03_11-02-08,fp7d
2020-10-25,SH,8,8,0,8,2022-05-03_11-02-08,fp7d
2020-10-25,SO,17,15,0,15,2022-05-03_11-02-08,fp7d
2020-10-25,SZ,12,11,0,11,2022-05-03_11-02-08,fp7d
2020-10-25,TG,21,37,16,21,2022-05-03_11-02-08,fp7d
2020-10-25,TI,47,60,13,47,2022-05-03_11-02-08,fp7d
2020-10-25,UR,6,6,0,6,2022-05-03_11-02-08,fp7d
2020-10-25,VD,83,89,12,77,2022-05-03_11-02-08,fp7d
2020-10-25,VS,21,25,4,21,2022-05-03_11-02-08,fp7d
2020-10-25,ZG,8,8,0,8,2022-05-03_11-02-08,fp7d
2020-10-25,ZH,198,305,107,198,2022-05-03_11-02-08,fp7d
2020-10-26,AG,52,52,2,50,2022-05-03_11-02-08,fp7d
2020-10-26,AI,0,0,0,0,2022-05-03_11-02-08,fp7d
2020-10-26,AR,6,6,0,6,2022-05-03_11-02-08,fp7d
2020-10-26,BE,104,108,12,96,2022-05-03_11-02-08,fp7d
2020-10-26,BL,20,16,0,16,2022-05-03_11-02-08,fp7d
2020-10-26,BS,54,50,0,50,2022-05-03_11-02-08,fp7d
2020-10-26,FR,24,24,0,24,2022-05-03_11-02-08,fp7d
2020-10-26,GE,40,50,10,40,2022-05-03_11-02-08,fp7d
2020-10-26,GL,NA,NA,NA,NA,2022-05-03_11-02-08,fp7d
2020-10-26,GR,16,16,0,16,2022-05-03_11-02-08,fp7d
2020-10-26,JU,6,8,2,6,2022-05-03_11-02-08,fp7d
2020-10-26,LU,54,54,2,52,2022-05-03_11-02-08,fp7d
2020-10-26,NE,10,14,4,10,2022-05-03_11-02-08,fp7d
2020-10-26,NW,6,6,0,6,2022-05-03_11-02-08,fp7d
2020-10-26,OW,0,0,0,0,2022-05-03_11-02-08,fp7d
2020-10-26,SG,54,55,1,54,2022-05-03_11-02-08,fp7d
2020-10-26,SH,8,8,0,8,2022-05-03_11-02-08,fp7d
2020-10-26,SO,17,15,0,15,2022-05-03_11-02-08,fp7d
2020-10-26,SZ,12,11,0,11,2022-05-03_11-02-08,fp7d
2020-10-26,TG,21,37,16,21,2022-05-03_11-02-08,fp7d
2020-10-26,TI,47,60,13,47,2022-05-03_11-02-08,fp7d
2020-10-26,UR,6,6,0,6,2022-05-03_11-02-08,fp7d
2020-10-26,VD,79,87,14,73,2022-05-03_11-02-08,fp7d
2020-10-26,VS,21,25,4,21,2022-05-03_11-02-08,fp7d
2020-10-26,ZG,8,8,0,8,2022-05-03_11-02-08,fp7d
2020-10-26,ZH,198,300,102,198,2022-05-03_11-02-08,fp7d
2020-10-27,AG,52,52,2,50,2022-05-03_11-02-08,fp7d
2020-10-27,AI,0,0,0,0,2022-05-03_11-02-08,fp7d
2020-10-27,AR,6,6,0,6,2022-05-03_11-02-08,fp7d
2020-10-27,BE,104,108,12,96,2022-05-03_11-02-08,fp7d
2020-10-27,BL,20,16,0,16,2022-05-03_11-02-08,fp7d
2020-10-27,BS,54,50,0,50,2022-05-03_11-02-08,fp7d
2020-10-27,FR,24,24,0,24,2022-05-03_11-02-08,fp7d
2020-10-27,GE,40,50,10,40,2022-05-03_11-02-08,fp7d
2020-10-27,GL,NA,NA,NA,NA,2022-05-03_11-02-08,fp7d
2020-10-27,GR,16,16,0,16,2022-05-03_11-02-08,fp7d
2020-10-27,JU,6,8,2,6,2022-05-03_11-02-08,fp7d
2020-10-27,LU,54,51,2,49,2022-05-03_11-02-08,fp7d
2020-10-27,NE,10,14,4,10,2022-05-03_11-02-08,fp7d
2020-10-27,NW,6,6,0,6,2022-05-03_11-02-08,fp7d
2020-10-27,OW,0,0,0,0,2022-05-03_11-02-08,fp7d
2020-10-27,SG,54,55,1,54,2022-05-03_11-02-08,fp7d
2020-10-27,SH,8,8,0,8,2022-05-03_11-02-08,fp7d
2020-10-27,SO,17,15,0,15,2022-05-03_11-02-08,fp7d
2020-10-27,SZ,12,11,0,11,2022-05-03_11-02-08,fp7d
2020-10-27,TG,21,37,16,21,2022-05-03_11-02-08,fp7d
2020-10-27,TI,47,60,13,47,2022-05-03_11-02-08,fp7d
2020-10-27,UR,6,6,0,6,2022-05-03_11-02-08,fp7d
2020-10-27,VD,79,89,15,74,2022-05-03_11-02-08,fp7d
2020-10-27,VS,21,27,6,21,2022-05-03_11-02-08,fp7d
2020-10-27,ZG,8,8,0,8,2022-05-03_11-02-08,fp7d
2020-10-27,ZH,198,299,101,198,2022-05-03_11-02-08,fp7d
2020-10-28,AG,52,52,2,50,2022-05-03_11-02-08,fp7d
2020-10-28,AI,0,0,0,0,2022-05-03_11-02-08,fp7d
2020-10-28,AR,6,6,0,6,2022-05-03_11-02-08,fp7d
2020-10-28,BE,104,108,12,96,2022-05-03_11-02-08,fp7d
2020-10-28,BL,20,16,0,16,2022-05-03_11-02-08,fp7d
2020-10-28,BS,54,50,0,50,2022-05-03_11-02-08,fp7d
2020-10-28,FR,24,24,0,24,2022-05-03_11-02-08,fp7d
2020-10-28,GE,40,58,18,40,2022-05-03_11-02-08,fp7d
2020-10-28,GL,NA,NA,NA,NA,2022-05-03_11-02-08,fp7d
2020-10-28,GR,16,16,0,16,2022-05-03_11-02-08,fp7d
2020-10-28,JU,6,8,2,6,2022-05-03_11-02-08,fp7d
2020-10-28,LU,54,51,2,49,2022-05-03_11-02-08,fp7d
2020-10-28,NE,10,14,4,10,2022-05-03_11-02-08,fp7d
2020-10-28,NW,6,6,0,6,2022-05-03_11-02-08,fp7d
2020-10-28,OW,0,0,0,0,2022-05-03_11-02-08,fp7d
2020-10-28,SG,54,55,1,54,2022-05-03_11-02-08,fp7d
2020-10-28,SH,8,8,0,8,2022-05-03_11-02-08,fp7d
2020-10-28,SO,17,15,0,15,2022-05-03_11-02-08,fp7d
2020-10-28,SZ,12,11,0,11,2022-05-03_11-02-08,fp7d
2020-10-28,TG,21,37,16,21,2022-05-03_11-02-08,fp7d
2020-10-28,TI,47,60,13,47,2022-05-03_11-02-08,fp7d
2020-10-28,UR,6,6,0,6,2022-05-03_11-02-08,fp7d
2020-10-28,VD,79,98,24,74,2022-05-03_11-02-08,fp7d
2020-10-28,VS,21,27,6,21,2022-05-03_11-02-08,fp7d
2020-10-28,ZG,8,8,0,8,2022-05-03_11-02-08,fp7d
2020-10-28,ZH,198,299,101,198,2022-05-03_11-02-08,fp7d
2020-10-29,AG,52,52,2,50,2022-05-03_11-02-08,fp7d
2020-10-29,AI,0,0,0,0,2022-05-03_11-02-08,fp7d
2020-10-29,AR,6,6,0,6,2022-05-03_11-02-08,fp7d
2020-10-29,BE,104,108,12,96,2022-05-03_11-02-08,fp7d
2020-10-29,BL,20,16,0,16,2022-05-03_11-02-08,fp7d
2020-10-29,BS,54,50,0,50,2022-05-03_11-02-08,fp7d
2020-10-29,FR,24,24,0,24,2022-05-03_11-02-08,fp7d
2020-10-29,GE,40,60,20,40,2022-05-03_11-02-08,fp7d
2020-10-29,GL,NA,NA,NA,NA,2022-05-03_11-02-08,fp7d
2020-10-29,GR,16,16,0,16,2022-05-03_11-02-08,fp7d
2020-10-29,JU,6,8,2,6,2022-05-03_11-02-08,fp7d
2020-10-29,LU,54,51,2,49,2022-05-03_11-02-08,fp7d
2020-10-29,NE,10,18,8,10,2022-05-03_11-02-08,fp7d
2020-10-29,NW,6,6,0,6,2022-05-03_11-02-08,fp7d
2020-10-29,OW,0,0,0,0,2022-05-03_11-02-08,fp7d
2020-10-29,SG,54,59,5,54,2022-05-03_11-02-08,fp7d
2020-10-29,SH,8,8,0,8,2022-05-03_11-02-08,fp7d
2020-10-29,SO,17,15,0,15,2022-05-03_11-02-08,fp7d
2020-10-29,SZ,12,11,0,11,2022-05-03_11-02-08,fp7d
2020-10-29,TG,21,37,16,21,2022-05-03_11-02-08,fp7d
2020-10-29,TI,47,53,6,47,2022-05-03_11-02-08,fp7d
2020-10-29,UR,6,6,0,6,2022-05-03_11-02-08,fp7d
2020-10-29,VD,79,98,24,74,2022-05-03_11-02-08,fp7d
2020-10-29,VS,21,27,6,21,2022-05-03_11-02-08,fp7d
2020-10-29,ZG,8,8,0,8,2022-05-03_11-02-08,fp7d
2020-10-29,ZH,198,300,102,198,2022-05-03_11-02-08,fp7d
2020-10-30,AG,52,52,2,50,2022-05-03_11-02-08,fp7d
2020-10-30,AI,0,0,0,0,2022-05-03_11-02-08,fp7d
2020-10-30,AR,6,6,0,6,2022-05-03_11-02-08,fp7d
2020-10-30,BE,104,108,12,96,2022-05-03_11-02-08,fp7d
2020-10-30,BL,20,16,0,16,2022-05-03_11-02-08,fp7d
2020-10-30,BS,54,50,0,50,2022-05-03_11-02-08,fp7d
2020-10-30,FR,24,24,0,24,2022-05-03_11-02-08,fp7d
2020-10-30,GE,40,61,21,40,2022-05-03_11-02-08,fp7d
2020-10-30,GL,NA,NA,NA,NA,2022-05-03_11-02-08,fp7d
2020-10-30,GR,16,16,0,16,2022-05-03_11-02-08,fp7d
2020-10-30,JU,6,8,2,6,2022-05-03_11-02-08,fp7d
2020-10-30,LU,40,31,0,31,2022-05-03_11-02-08,fp7d
2020-10-30,NE,10,18,8,10,2022-05-03_11-02-08,fp7d
2020-10-30,NW,6,6,0,6,2022-05-03_11-02-08,fp7d
2020-10-30,OW,0,0,0,0,2022-05-03_11-02-08,fp7d
2020-10-30,SG,54,59,5,54,2022-05-03_11-02-08,fp7d
2020-10-30,SH,8,8,0,8,2022-05-03_11-02-08,fp7d
2020-10-30,SO,17,16,1,15,2022-05-03_11-02-08,fp7d
2020-10-30,SZ,12,11,0,11,2022-05-03_11-02-08,fp7d
2020-10-30,TG,21,37,16,21,2022-05-03_11-02-08,fp7d
2020-10-30,TI,47,51,6,45,2022-05-03_11-02-08,fp7d
2020-10-30,UR,6,6,0,6,2022-05-03_11-02-08,fp7d
2020-10-30,VD,79,98,24,74,2022-05-03_11-02-08,fp7d
2020-10-30,VS,21,27,6,21,2022-05-03_11-02-08,fp7d
2020-10-30,ZG,8,8,0,8,2022-05-03_11-02-08,fp7d
2020-10-30,ZH,198,301,103,198,2022-05-03_11-02-08,fp7d
2020-10-31,AG,52,52,2,50,2022-05-03_11-02-08,fp7d
2020-10-31,AI,0,0,0,0,2022-05-03_11-02-08,fp7d
2020-10-31,AR,6,6,0,6,2022-05-03_11-02-08,fp7d
2020-10-31,BE,104,107,12,95,2022-05-03_11-02-08,fp7d
2020-10-31,BL,20,17,0,17,2022-05-03_11-02-08,fp7d
2020-10-31,BS,54,50,0,50,2022-05-03_11-02-08,fp7d
2020-10-31,FR,24,24,0,24,2022-05-03_11-02-08,fp7d
2020-10-31,GE,40,61,21,40,2022-05-03_11-02-08,fp7d
2020-10-31,GL,NA,NA,NA,NA,2022-05-03_11-02-08,fp7d
2020-10-31,GR,16,16,0,16,2022-05-03_11-02-08,fp7d
2020-10-31,JU,6,8,2,6,2022-05-03_11-02-08,fp7d
2020-10-31,LU,40,31,0,31,2022-05-03_11-02-08,fp7d
2020-10-31,NE,10,20,10,10,2022-05-03_11-02-08,fp7d
2020-10-31,NW,6,6,0,6,2022-05-03_11-02-08,fp7d
2020-10-31,OW,0,0,0,0,2022-05-03_11-02-08,fp7d
2020-10-31,SG,54,59,5,54,2022-05-03_11-02-08,fp7d
2020-10-31,SH,8,8,0,8,2022-05-03_11-02-08,fp7d
2020-10-31,SO,17,16,1,15,2022-05-03_11-02-08,fp7d
2020-10-31,SZ,12,11,0,11,2022-05-03_11-02-08,fp7d
2020-10-31,TG,21,35,14,21,2022-05-03_11-02-08,fp7d
2020-10-31,TI,47,51,6,45,2022-05-03_11-02-08,fp7d
2020-10-31,UR,6,6,0,6,2022-05-03_11-02-08,fp7d
2020-10-31,VD,85,101,21,80,2022-05-03_11-02-08,fp7d
2020-10-31,VS,21,33,12,21,2022-05-03_11-02-08,fp7d
2020-10-31,ZG,8,8,0,8,2022-05-03_11-02-08,fp7d
2020-10-31,ZH,198,301,103,198,2022-05-03_11-02-08,fp7d
2020-11-01,AG,52,52,2,50,2022-05-03_11-02-08,fp7d
2020-11-01,AI,0,0,0,0,2022-05-03_11-02-08,fp7d
2020-11-01,AR,6,6,0,6,2022-05-03_11-02-08,fp7d
2020-11-01,BE,104,110,12,98,2022-05-03_11-02-08,fp7d
2020-11-01,BL,20,17,0,17,2022-05-03_11-02-08,fp7d
2020-11-01,BS,54,50,0,50,2022-05-03_11-02-08,fp7d
2020-11-01,FR,24,24,0,24,2022-05-03_11-02-08,fp7d
2020-11-01,GE,40,61,21,40,2022-05-03_11-02-08,fp7d
2020-11-01,GL,NA,NA,NA,NA,2022-05-03_11-02-08,fp7d
2020-11-01,GR,16,16,0,16,2022-05-03_11-02-08,fp7d
2020-11-01,JU,6,8,2,6,2022-05-03_11-02-08,fp7d
2020-11-01,LU,40,31,0,31,2022-05-03_11-02-08,fp7d
2020-11-01,NE,10,21,11,10,2022-05-03_11-02-08,fp7d
2020-11-01,NW,6,6,0,6,2022-05-03_11-02-08,fp7d
2020-11-01,OW,0,0,0,0,2022-05-03_11-02-08,fp7d
2020-11-01,SG,54,59,5,54,2022-05-03_11-02-08,fp7d
2020-11-01,SH,8,8,0,8,2022-05-03_11-02-08,fp7d
2020-11-01,SO,17,18,1,17,2022-05-03_11-02-08,fp7d
2020-11-01,SZ,12,11,0,11,2022-05-03_11-02-08,fp7d
2020-11-01,TG,21,33,12,21,2022-05-03_11-02-08,fp7d
2020-11-01,TI,47,51,6,45,2022-05-03_11-02-08,fp7d
2020-11-01,UR,6,6,0,6,2022-05-03_11-02-08,fp7d
2020-11-01,VD,85,106,26,80,2022-05-03_11-02-08,fp7d
2020-11-01,VS,21,33,12,21,2022-05-03_11-02-08,fp7d
2020-11-01,ZG,8,8,0,8,2022-05-03_11-02-08,fp7d
2020-11-01,ZH,198,301,103,198,2022-05-03_11-02-08,fp7d
2020-11-02,AG,52,52,2,50,2022-05-03_11-02-08,fp7d
2020-11-02,AI,0,0,0,0,2022-05-03_11-02-08,fp7d
2020-11-02,AR,6,6,0,6,2022-05-03_11-02-08,fp7d
2020-11-02,BE,104,105,12,93,2022-05-03_11-02-08,fp7d
2020-11-02,BL,20,17,0,17,2022-05-03_11-02-08,fp7d
2020-11-02,BS,54,50,0,50,2022-05-03_11-02-08,fp7d
2020-11-02,FR,24,24,0,24,2022-05-03_11-02-08,fp7d
2020-11-02,GE,40,61,21,40,2022-05-03_11-02-08,fp7d
2020-11-02,GL,NA,NA,NA,NA,2022-05-03_11-02-08,fp7d
2020-11-02,GR,16,19,3,16,2022-05-03_11-02-08,fp7d
2020-11-02,JU,6,8,2,6,2022-05-03_11-02-08,fp7d
2020-11-02,LU,40,33,0,33,2022-05-03_11-02-08,fp7d
2020-11-02,NE,10,18,8,10,2022-05-03_11-02-08,fp7d
2020-11-02,NW,6,6,0,6,2022-05-03_11-02-08,fp7d
2020-11-02,OW,0,0,0,0,2022-05-03_11-02-08,fp7d
2020-11-02,SG,54,60,6,54,2022-05-03_11-02-08,fp7d
2020-11-02,SH,8,8,0,8,2022-05-03_11-02-08,fp7d
2020-11-02,SO,17,20,3,17,2022-05-03_11-02-08,fp7d
2020-11-02,SZ,12,11,0,11,2022-05-03_11-02-08,fp7d
2020-11-02,TG,21,31,10,21,2022-05-03_11-02-08,fp7d
2020-11-02,TI,55,63,12,51,2022-05-03_11-02-08,fp7d
2020-11-02,UR,6,6,0,6,2022-05-03_11-02-08,fp7d
2020-11-02,VD,85,114,29,85,2022-05-03_11-02-08,fp7d
2020-11-02,VS,21,33,12,21,2022-05-03_11-02-08,fp7d
2020-11-02,ZG,8,8,0,8,2022-05-03_11-02-08,fp7d
2020-11-02,ZH,198,301,103,198,2022-05-03_11-02-08,fp7d
2020-11-03,AG,52,52,2,50,2022-05-03_11-02-08,fp7d
2020-11-03,AI,0,0,0,0,2022-05-03_11-02-08,fp7d
2020-11-03,AR,6,6,0,6,2022-05-03_11-02-08,fp7d
2020-11-03,BE,104,101,10,91,2022-05-03_11-02-08,fp7d
2020-11-03,BL,20,17,0,17,2022-05-03_11-02-08,fp7d
2020-11-03,BS,54,50,0,50,2022-05-03_11-02-08,fp7d
2020-11-03,FR,24,24,0,24,2022-05-03_11-02-08,fp7d
2020-11-03,GE,40,61,21,40,2022-05-03_11-02-08,fp7d
2020-11-03,GL,6,6,0,6,2022-05-03_11-02-08,fp7d
2020-11-03,GR,16,20,4,16,2022-05-03_11-02-08,fp7d
2020-11-03,JU,6,8,2,6,2022-05-03_11-02-08,fp7d
2020-11-03,LU,54,49,2,47,2022-05-03_11-02-08,fp7d
2020-11-03,NE,10,20,10,10,2022-05-03_11-02-08,fp7d
2020-11-03,NW,6,6,0,6,2022-05-03_11-02-08,fp7d
2020-11-03,OW,0,0,0,0,2022-05-03_11-02-08,fp7d
2020-11-03,SG,54,60,6,54,2022-05-03_11-02-08,fp7d
2020-11-03,SH,8,8,0,8,2022-05-03_11-02-08,fp7d
2020-11-03,SO,17,25,8,17,2022-05-03_11-02-08,fp7d
2020-11-03,SZ,12,11,0,11,2022-05-03_11-02-08,fp7d
2020-11-03,TG,21,31,10,21,2022-05-03_11-02-08,fp7d
2020-11-03,TI,55,59,12,47,2022-05-03_11-02-08,fp7d
2020-11-03,UR,6,6,0,6,2022-05-03_11-02-08,fp7d
2020-11-03,VD,85,124,39,85,2022-05-03_11-02-08,fp7d
2020-11-03,VS,21,33,12,21,2022-05-03_11-02-08,fp7d
2020-11-03,ZG,8,8,0,8,2022-05-03_11-02-08,fp7d
2020-11-03,ZH,198,301,103,198,2022-05-03_11-02-08,fp7d
2020-11-04,AG,52,52,2,50,2022-05-03_11-02-08,fp7d
2020-11-04,AI,0,0,0,0,2022-05-03_11-02-08,fp7d
2020-11-04,AR,6,6,0,6,2022-05-03_11-02-08,fp7d
2020-11-04,BE,104,102,11,91,2022-05-03_11-02-08,fp7d
2020-11-04,BL,20,17,0,17,2022-05-03_11-02-08,fp7d
2020-11-04,BS,54,50,0,50,2022-05-03_11-02-08,fp7d
2020-11-04,FR,24,24,0,24,2022-05-03_11-02-08,fp7d
2020-11-04,GE,40,62,22,40,2022-05-03_11-02-08,fp7d
2020-11-04,GL,6,6,0,6,2022-05-03_11-02-08,fp7d
2020-11-04,GR,16,20,4,16,2022-05-03_11-02-08,fp7d
2020-11-04,JU,6,8,2,6,2022-05-03_11-02-08,fp7d
2020-11-04,LU,54,49,2,47,2022-05-03_11-02-08,fp7d
2020-11-04,NE,10,20,10,10,2022-05-03_11-02-08,fp7d
2020-11-04,NW,6,6,0,6,2022-05-03_11-02-08,fp7d
2020-11-04,OW,0,0,0,0,2022-05-03_11-02-08,fp7d
2020-11-04,SG,54,60,6,54,2022-05-03_11-02-08,fp7d
2020-11-04,SH,8,8,0,8,2022-05-03_11-02-08,fp7d
2020-11-04,SO,17,25,8,17,2022-05-03_11-02-08,fp7d
2020-11-04,SZ,12,11,0,11,2022-05-03_11-02-08,fp7d
2020-11-04,TG,21,31,10,21,2022-05-03_11-02-08,fp7d
2020-11-04,TI,55,59,12,47,2022-05-03_11-02-08,fp7d
2020-11-04,UR,6,6,0,6,2022-05-03_11-02-08,fp7d
2020-11-04,VD,85,131,46,85,2022-05-03_11-02-08,fp7d
2020-11-04,VS,21,33,12,21,2022-05-03_11-02-08,fp7d
2020-11-04,ZG,8,8,0,8,2022-05-03_11-02-08,fp7d
2020-11-04,ZH,198,211,30,181,2022-05-03_11-02-08,fp7d
2020-11-05,AG,52,52,2,50,2022-05-03_11-02-08,fp7d
2020-11-05,AI,0,0,0,0,2022-05-03_11-02-08,fp7d
2020-11-05,AR,6,6,0,6,2022-05-03_11-02-08,fp7d
2020-11-05,BE,104,105,11,94,2022-05-03_11-02-08,fp7d
2020-11-05,BL,20,17,0,17,2022-05-03_11-02-08,fp7d
2020-11-05,BS,54,51,1,50,2022-05-03_11-02-08,fp7d
2020-11-05,FR,24,26,2,24,2022-05-03_11-02-08,fp7d
2020-11-05,GE,40,62,22,40,2022-05-03_11-02-08,fp7d
2020-11-05,GL,6,6,0,6,2022-05-03_11-02-08,fp7d
2020-11-05,GR,16,20,4,16,2022-05-03_11-02-08,fp7d
2020-11-05,JU,6,8,2,6,2022-05-03_11-02-08,fp7d
2020-11-05,LU,54,49,2,47,2022-05-03_11-02-08,fp7d
2020-11-05,NE,10,26,16,10,2022-05-03_11-02-08,fp7d
2020-11-05,NW,6,6,0,6,2022-05-03_11-02-08,fp7d
2020-11-05,OW,0,0,0,0,2022-05-03_11-02-08,fp7d
2020-11-05,SG,54,60,6,54,2022-05-03_11-02-08,fp7d
2020-11-05,SH,8,8,0,8,2022-05-03_11-02-08,fp7d
2020-11-05,SO,17,25,8,17,2022-05-03_11-02-08,fp7d
2020-11-05,SZ,12,11,0,11,2022-05-03_11-02-08,fp7d
2020-11-05,TG,21,32,11,21,2022-05-03_11-02-08,fp7d
2020-11-05,TI,55,62,15,47,2022-05-03_11-02-08,fp7d
2020-11-05,UR,6,6,0,6,2022-05-03_11-02-08,fp7d
2020-11-05,VD,85,144,59,85,2022-05-03_11-02-08,fp7d
2020-11-05,VS,21,33,12,21,2022-05-03_11-02-08,fp7d
2020-11-05,ZG,8,8,0,8,2022-05-03_11-02-08,fp7d
2020-11-05,ZH,190,211,30,181,2022-05-03_11-02-08,fp7d
2020-11-06,AG,52,52,2,50,2022-05-03_11-02-08,fp7d
2020-11-06,AI,0,0,0,0,2022-05-03_11-02-08,fp7d
2020-11-06,AR,6,6,0,6,2022-05-03_11-02-08,fp7d
2020-11-06,BE,104,106,11,95,2022-05-03_11-02-08,fp7d
2020-11-06,BL,20,17,0,17,2022-05-03_11-02-08,fp7d
2020-11-06,BS,54,51,1,50,2022-05-03_11-02-08,fp7d
2020-11-06,FR,24,27,3,24,2022-05-03_11-02-08,fp7d
2020-11-06,GE,40,63,23,40,2022-05-03_11-02-08,fp7d
2020-11-06,GL,6,6,0,6,2022-05-03_11-02-08,fp7d
2020-11-06,GR,16,20,4,16,2022-05-03_11-02-08,fp7d
2020-11-06,JU,6,8,2,6,2022-05-03_11-02-08,fp7d
2020-11-06,LU,54,62,8,54,2022-05-03_11-02-08,fp7d
2020-11-06,NE,10,26,16,10,2022-05-03_11-02-08,fp7d
2020-11-06,NW,6,6,0,6,2022-05-03_11-02-08,fp7d
2020-11-06,OW,0,0,0,0,2022-05-03_11-02-08,fp7d
2020-11-06,SG,54,60,6,54,2022-05-03_11-02-08,fp7d
2020-11-06,SH,8,8,0,8,2022-05-03_11-02-08,fp7d
2020-11-06,SO,17,25,8,17,2022-05-03_11-02-08,fp7d
2020-11-06,SZ,12,11,0,11,2022-05-03_11-02-08,fp7d
2020-11-06,TG,21,32,11,21,2022-05-03_11-02-08,fp7d
2020-11-06,TI,55,61,12,49,2022-05-03_11-02-08,fp7d
2020-11-06,UR,6,6,0,6,2022-05-03_11-02-08,fp7d
2020-11-06,VD,85,144,59,85,2022-05-03_11-02-08,fp7d
2020-11-06,VS,21,33,12,21,2022-05-03_11-02-08,fp7d
2020-11-06,ZG,8,8,0,8,2022-05-03_11-02-08,fp7d
2020-11-06,ZH,198,213,30,183,2022-05-03_11-02-08,fp7d
2020-11-07,AG,52,52,2,50,2022-05-03_11-02-08,fp7d
2020-11-07,AI,0,0,0,0,2022-05-03_11-02-08,fp7d
2020-11-07,AR,6,6,0,6,2022-05-03_11-02-08,fp7d
2020-11-07,BE,104,110,12,98,2022-05-03_11-02-08,fp7d
2020-11-07,BL,20,17,0,17,2022-05-03_11-02-08,fp7d
2020-11-07,BS,54,50,0,50,2022-05-03_11-02-08,fp7d
2020-11-07,FR,24,27,3,24,2022-05-03_11-02-08,fp7d
2020-11-07,GE,40,63,23,40,2022-05-03_11-02-08,fp7d
2020-11-07,GL,6,6,0,6,2022-05-03_11-02-08,fp7d
2020-11-07,GR,16,20,4,16,2022-05-03_11-02-08,fp7d
2020-11-07,JU,6,8,2,6,2022-05-03_11-02-08,fp7d
2020-11-07,LU,54,62,8,54,2022-05-03_11-02-08,fp7d
2020-11-07,NE,10,26,16,10,2022-05-03_11-02-08,fp7d
2020-11-07,NW,6,6,0,6,2022-05-03_11-02-08,fp7d
2020-11-07,OW,0,0,0,0,2022-05-03_11-02-08,fp7d
2020-11-07,SG,54,60,6,54,2022-05-03_11-02-08,fp7d
2020-11-07,SH,8,8,0,8,2022-05-03_11-02-08,fp7d
2020-11-07,SO,17,25,8,17,2022-05-03_11-02-08,fp7d
2020-11-07,SZ,12,11,0,11,2022-05-03_11-02-08,fp7d
2020-11-07,TG,21,32,11,21,2022-05-03_11-02-08,fp7d
2020-11-07,TI,55,61,12,49,2022-05-03_11-02-08,fp7d
2020-11-07,UR,6,6,0,6,2022-05-03_11-02-08,fp7d
2020-11-07,VD,85,144,59,85,2022-05-03_11-02-08,fp7d
2020-11-07,VS,21,35,14,21,2022-05-03_11-02-08,fp7d
2020-11-07,ZG,8,8,0,8,2022-05-03_11-02-08,fp7d
2020-11-07,ZH,198,213,30,183,2022-05-03_11-02-08,fp7d
2020-11-08,AG,52,52,2,50,2022-05-03_11-02-08,fp7d
2020-11-08,AI,0,0,0,0,2022-05-03_11-02-08,fp7d
2020-11-08,AR,6,6,0,6,2022-05-03_11-02-08,fp7d
2020-11-08,BE,104,111,12,99,2022-05-03_11-02-08,fp7d
2020-11-08,BL,20,17,0,17,2022-05-03_11-02-08,fp7d
2020-11-08,BS,54,50,0,50,2022-05-03_11-02-08,fp7d
2020-11-08,FR,24,27,3,24,2022-05-03_11-02-08,fp7d
2020-11-08,GE,40,65,25,40,2022-05-03_11-02-08,fp7d
2020-11-08,GL,6,6,0,6,2022-05-03_11-02-08,fp7d
2020-11-08,GR,16,20,4,16,2022-05-03_11-02-08,fp7d
2020-11-08,JU,6,8,2,6,2022-05-03_11-02-08,fp7d
2020-11-08,LU,54,62,8,54,2022-05-03_11-02-08,fp7d
2020-11-08,NE,10,26,16,10,2022-05-03_11-02-08,fp7d
2020-11-08,NW,6,6,0,6,2022-05-03_11-02-08,fp7d
2020-11-08,OW,0,0,0,0,2022-05-03_11-02-08,fp7d
2020-11-08,SG,54,60,6,54,2022-05-03_11-02-08,fp7d
2020-11-08,SH,8,8,0,8,2022-05-03_11-02-08,fp7d
2020-11-08,SO,17,25,8,17,2022-05-03_11-02-08,fp7d
2020-11-08,SZ,12,11,0,11,2022-05-03_11-02-08,fp7d
2020-11-08,TG,21,32,11,21,2022-05-03_11-02-08,fp7d
2020-11-08,TI,55,61,12,49,2022-05-03_11-02-08,fp7d
2020-11-08,UR,6,6,0,6,2022-05-03_11-02-08,fp7d
2020-11-08,VD,85,144,59,85,2022-05-03_11-02-08,fp7d
2020-11-08,VS,21,35,14,21,2022-05-03_11-02-08,fp7d
2020-11-08,ZG,8,8,0,8,2022-05-03_11-02-08,fp7d
2020-11-08,ZH,198,212,30,182,2022-05-03_11-02-08,fp7d
2020-11-09,AG,52,52,2,50,2022-05-03_11-02-08,fp7d
2020-11-09,AI,0,0,0,0,2022-05-03_11-02-08,fp7d
2020-11-09,AR,6,6,0,6,2022-05-03_11-02-08,fp7d
2020-11-09,BE,104,111,12,99,2022-05-03_11-02-08,fp7d
2020-11-09,BL,20,17,0,17,2022-05-03_11-02-08,fp7d
2020-11-09,BS,54,50,0,50,2022-05-03_11-02-08,fp7d
2020-11-09,FR,24,29,5,24,2022-05-03_11-02-08,fp7d
2020-11-09,GE,40,65,25,40,2022-05-03_11-02-08,fp7d
2020-11-09,GL,6,6,0,6,2022-05-03_11-02-08,fp7d
2020-11-09,GR,16,20,4,16,2022-05-03_11-02-08,fp7d
2020-11-09,JU,6,8,2,6,2022-05-03_11-02-08,fp7d
2020-11-09,LU,54,62,8,54,2022-05-03_11-02-08,fp7d
2020-11-09,NE,10,26,16,10,2022-05-03_11-02-08,fp7d
2020-11-09,NW,6,6,0,6,2022-05-03_11-02-08,fp7d
2020-11-09,OW,0,0,0,0,2022-05-03_11-02-08,fp7d
2020-11-09,SG,54,68,14,54,2022-05-03_11-02-08,fp7d
2020-11-09,SH,8,8,0,8,2022-05-03_11-02-08,fp7d
2020-11-09,SO,17,25,8,17,2022-05-03_11-02-08,fp7d
2020-11-09,SZ,12,11,0,11,2022-05-03_11-02-08,fp7d
2020-11-09,TG,21,32,11,21,2022-05-03_11-02-08,fp7d
2020-11-09,TI,55,64,15,49,2022-05-03_11-02-08,fp7d
2020-11-09,UR,6,6,0,6,2022-05-03_11-02-08,fp7d
2020-11-09,VD,85,144,59,85,2022-05-03_11-02-08,fp7d
2020-11-09,VS,21,35,14,21,2022-05-03_11-02-08,fp7d
2020-11-09,ZG,8,8,0,8,2022-05-03_11-02-08,fp7d
2020-11-09,ZH,190,212,30,182,2022-05-03_11-02-08,fp7d
2020-11-10,AG,52,52,2,50,2022-05-03_11-02-08,fp7d
2020-11-10,AI,0,0,0,0,2022-05-03_11-02-08,fp7d
2020-11-10,AR,6,6,0,6,2022-05-03_11-02-08,fp7d
2020-11-10,BE,104,122,20,102,2022-05-03_11-02-08,fp7d
2020-11-10,BL,20,17,0,17,2022-05-03_11-02-08,fp7d
2020-11-10,BS,54,50,0,50,2022-05-03_11-02-08,fp7d
2020-11-10,FR,24,29,5,24,2022-05-03_11-02-08,fp7d
2020-11-10,GE,40,66,26,40,2022-05-03_11-02-08,fp7d
2020-11-10,GL,6,6,0,6,2022-05-03_11-02-08,fp7d
2020-11-10,GR,16,20,4,16,2022-05-03_11-02-08,fp7d
2020-11-10,JU,6,8,2,6,2022-05-03_11-02-08,fp7d
2020-11-10,LU,54,56,6,50,2022-05-03_11-02-08,fp7d
2020-11-10,NE,10,26,16,10,2022-05-03_11-02-08,fp7d
2020-11-10,NW,6,6,0,6,2022-05-03_11-02-08,fp7d
2020-11-10,OW,0,0,0,0,2022-05-03_11-02-08,fp7d
2020-11-10,SG,54,66,12,54,2022-05-03_11-02-08,fp7d
2020-11-10,SH,8,8,0,8,2022-05-03_11-02-08,fp7d
2020-11-10,SO,17,25,8,17,2022-05-03_11-02-08,fp7d
2020-11-10,SZ,12,11,0,11,2022-05-03_11-02-08,fp7d
2020-11-10,TG,21,32,11,21,2022-05-03_11-02-08,fp7d
2020-11-10,TI,55,64,15,49,2022-05-03_11-02-08,fp7d
2020-11-10,UR,6,6,0,6,2022-05-03_11-02-08,fp7d
2020-11-10,VD,85,159,74,85,2022-05-03_11-02-08,fp7d
2020-11-10,VS,21,35,14,21,2022-05-03_11-02-08,fp7d
2020-11-10,ZG,8,8,0,8,2022-05-03_11-02-08,fp7d
2020-11-10,ZH,190,212,30,182,2022-05-03_11-02-08,fp7d
2020-11-11,AG,52,54,4,50,2022-05-03_11-02-08,fp7d
2020-11-11,AI,0,0,0,0,2022-05-03_11-02-08,fp7d
2020-11-11,AR,6,6,0,6,2022-05-03_11-02-08,fp7d
2020-11-11,BE,104,123,20,103,2022-05-03_11-02-08,fp7d
2020-11-11,BL,20,17,0,17,2022-05-03_11-02-08,fp7d
2020-11-11,BS,54,50,0,50,2022-05-03_11-02-08,fp7d
2020-11-11,FR,24,29,5,24,2022-05-03_11-02-08,fp7d
2020-11-11,GE,40,66,26,40,2022-05-03_11-02-08,fp7d
2020-11-11,GL,6,6,0,6,2022-05-03_11-02-08,fp7d
2020-11-11,GR,16,20,4,16,2022-05-03_11-02-08,fp7d
2020-11-11,JU,6,8,2,6,2022-05-03_11-02-08,fp7d
2020-11-11,LU,54,56,6,50,2022-05-03_11-02-08,fp7d
2020-11-11,NE,10,22,12,10,2022-05-03_11-02-08,fp7d
2020-11-11,NW,6,6,0,6,2022-05-03_11-02-08,fp7d
2020-11-11,OW,0,0,0,0,2022-05-03_11-02-08,fp7d
2020-11-11,SG,54,66,12,54,2022-05-03_11-02-08,fp7d
2020-11-11,SH,8,8,0,8,2022-05-03_11-02-08,fp7d
2020-11-11,SO,17,25,8,17,2022-05-03_11-02-08,fp7d
2020-11-11,SZ,12,11,0,11,2022-05-03_11-02-08,fp7d
2020-11-11,TG,21,32,11,21,2022-05-03_11-02-08,fp7d
2020-11-11,TI,54,68,20,48,2022-05-03_11-02-08,fp7d
2020-11-11,UR,6,6,0,6,2022-05-03_11-02-08,fp7d
2020-11-11,VD,85,159,74,85,2022-05-03_11-02-08,fp7d
2020-11-11,VS,21,35,14,21,2022-05-03_11-02-08,fp7d
2020-11-11,ZG,8,8,0,8,2022-05-03_11-02-08,fp7d
2020-11-11,ZH,190,216,33,183,2022-05-03_11-02-08,fp7d
2020-11-12,AG,52,54,4,50,2022-05-03_11-02-08,fp7d
2020-11-12,AI,0,0,0,0,2022-05-03_11-02-08,fp7d
2020-11-12,AR,6,6,0,6,2022-05-03_11-02-08,fp7d
2020-11-12,BE,104,123,20,103,2022-05-03_11-02-08,fp7d
2020-11-12,BL,20,17,0,17,2022-05-03_11-02-08,fp7d
2020-11-12,BS,54,50,0,50,2022-05-03_11-02-08,fp7d
2020-11-12,FR,24,29,5,24,2022-05-03_11-02-08,fp7d
2020-11-12,GE,40,66,26,40,2022-05-03_11-02-08,fp7d
2020-11-12,GL,6,6,0,6,2022-05-03_11-02-08,fp7d
2020-11-12,GR,16,20,4,16,2022-05-03_11-02-08,fp7d
2020-11-12,JU,6,8,2,6,2022-05-03_11-02-08,fp7d
2020-11-12,LU,54,56,6,50,2022-05-03_11-02-08,fp7d
2020-11-12,NE,10,26,16,10,2022-05-03_11-02-08,fp7d
2020-11-12,NW,6,6,0,6,2022-05-03_11-02-08,fp7d
2020-11-12,OW,0,0,0,0,2022-05-03_11-02-08,fp7d
2020-11-12,SG,54,66,12,54,2022-05-03_11-02-08,fp7d
2020-11-12,SH,8,8,0,8,2022-05-03_11-02-08,fp7d
2020-11-12,SO,17,25,8,17,2022-05-03_11-02-08,fp7d
2020-11-12,SZ,12,11,0,11,2022-05-03_11-02-08,fp7d
2020-11-12,TG,21,32,11,21,2022-05-03_11-02-08,fp7d
2020-11-12,TI,56,70,20,50,2022-05-03_11-02-08,fp7d
2020-11-12,UR,6,6,0,6,2022-05-03_11-02-08,fp7d
2020-11-12,VD,85,159,74,85,2022-05-03_11-02-08,fp7d
2020-11-12,VS,21,35,14,21,2022-05-03_11-02-08,fp7d
2020-11-12,ZG,8,8,0,8,2022-05-03_11-02-08,fp7d
2020-11-12,ZH,190,216,33,183,2022-05-03_11-02-08,fp7d
2020-11-13,AG,52,52,2,50,2022-05-03_11-02-08,fp7d
2020-11-13,AI,0,0,0,0,2022-05-03_11-02-08,fp7d
2020-11-13,AR,6,6,0,6,2022-05-03_11-02-08,fp7d
2020-11-13,BE,104,126,22,104,2022-05-03_11-02-08,fp7d
2020-11-13,BL,20,17,0,17,2022-05-03_11-02-08,fp7d
2020-11-13,BS,54,54,4,50,2022-05-03_11-02-08,fp7d
2020-11-13,FR,24,29,5,24,2022-05-03_11-02-08,fp7d
2020-11-13,GE,40,66,26,40,2022-05-03_11-02-08,fp7d
2020-11-13,GL,6,6,0,6,2022-05-03_11-02-08,fp7d
2020-11-13,GR,16,20,4,16,2022-05-03_11-02-08,fp7d
2020-11-13,JU,6,8,2,6,2022-05-03_11-02-08,fp7d
2020-11-13,LU,54,56,6,50,2022-05-03_11-02-08,fp7d
2020-11-13,NE,10,26,16,10,2022-05-03_11-02-08,fp7d
2020-11-13,NW,6,6,0,6,2022-05-03_11-02-08,fp7d
2020-11-13,OW,0,0,0,0,2022-05-03_11-02-08,fp7d
2020-11-13,SG,54,66,12,54,2022-05-03_11-02-08,fp7d
2020-11-13,SH,8,8,0,8,2022-05-03_11-02-08,fp7d
2020-11-13,SO,17,25,8,17,2022-05-03_11-02-08,fp7d
2020-11-13,SZ,12,11,0,11,2022-05-03_11-02-08,fp7d
2020-11-13,TG,21,33,12,21,2022-05-03_11-02-08,fp7d
2020-11-13,TI,56,70,20,50,2022-05-03_11-02-08,fp7d
2020-11-13,UR,6,6,0,6,2022-05-03_11-02-08,fp7d
2020-11-13,VD,85,159,74,85,2022-05-03_11-02-08,fp7d
2020-11-13,VS,21,35,14,21,2022-05-03_11-02-08,fp7d
2020-11-13,ZG,8,8,0,8,2022-05-03_11-02-08,fp7d
2020-11-13,ZH,190,219,35,184,2022-05-03_11-02-08,fp7d
2020-11-14,AG,52,53,3,50,2022-05-03_11-02-08,fp7d
2020-11-14,AI,0,0,0,0,2022-05-03_11-02-08,fp7d
2020-11-14,AR,6,6,0,6,2022-05-03_11-02-08,fp7d
2020-11-14,BE,104,126,22,104,2022-05-03_11-02-08,fp7d
2020-11-14,BL,20,17,0,17,2022-05-03_11-02-08,fp7d
2020-11-14,BS,54,54,4,50,2022-05-03_11-02-08,fp7d
2020-11-14,FR,24,29,5,24,2022-05-03_11-02-08,fp7d
2020-11-14,GE,40,66,26,40,2022-05-03_11-02-08,fp7d
2020-11-14,GL,6,6,0,6,2022-05-03_11-02-08,fp7d
2020-11-14,GR,16,20,4,16,2022-05-03_11-02-08,fp7d
2020-11-14,JU,6,8,2,6,2022-05-03_11-02-08,fp7d
2020-11-14,LU,54,54,6,48,2022-05-03_11-02-08,fp7d
2020-11-14,NE,10,26,16,10,2022-05-03_11-02-08,fp7d
2020-11-14,NW,6,6,0,6,2022-05-03_11-02-08,fp7d
2020-11-14,OW,0,0,0,0,2022-05-03_11-02-08,fp7d
2020-11-14,SG,54,66,12,54,2022-05-03_11-02-08,fp7d
2020-11-14,SH,8,8,0,8,2022-05-03_11-02-08,fp7d
2020-11-14,SO,17,25,8,17,2022-05-03_11-02-08,fp7d
2020-11-14,SZ,12,11,0,11,2022-05-03_11-02-08,fp7d
2020-11-14,TG,21,33,12,21,2022-05-03_11-02-08,fp7d
2020-11-14,TI,56,78,28,50,2022-05-03_11-02-08,fp7d
2020-11-14,UR,6,6,0,6,2022-05-03_11-02-08,fp7d
2020-11-14,VD,85,159,74,85,2022-05-03_11-02-08,fp7d
2020-11-14,VS,21,35,14,21,2022-05-03_11-02-08,fp7d
2020-11-14,ZG,8,8,0,8,2022-05-03_11-02-08,fp7d
2020-11-14,ZH,190,225,35,190,2022-05-03_11-02-08,fp7d
2020-11-15,AG,52,53,3,50,2022-05-03_11-02-08,fp7d
2020-11-15,AI,0,0,0,0,2022-05-03_11-02-08,fp7d
2020-11-15,AR,6,6,0,6,2022-05-03_11-02-08,fp7d
2020-11-15,BE,104,126,22,104,2022-05-03_11-02-08,fp7d
2020-11-15,BL,20,17,0,17,2022-05-03_11-02-08,fp7d
2020-11-15,BS,54,54,4,50,2022-05-03_11-02-08,fp7d
2020-11-15,FR,24,29,5,24,2022-05-03_11-02-08,fp7d
2020-11-15,GE,40,71,31,40,2022-05-03_11-02-08,fp7d
2020-11-15,GL,6,6,0,6,2022-05-03_11-02-08,fp7d
2020-11-15,GR,16,20,4,16,2022-05-03_11-02-08,fp7d
2020-11-15,JU,6,8,2,6,2022-05-03_11-02-08,fp7d
2020-11-15,LU,54,54,6,48,2022-05-03_11-02-08,fp7d
2020-11-15,NE,10,26,16,10,2022-05-03_11-02-08,fp7d
2020-11-15,NW,6,6,0,6,2022-05-03_11-02-08,fp7d
2020-11-15,OW,0,0,0,0,2022-05-03_11-02-08,fp7d
2020-11-15,SG,54,66,12,54,2022-05-03_11-02-08,fp7d
2020-11-15,SH,8,8,0,8,2022-05-03_11-02-08,fp7d
2020-11-15,SO,17,25,8,17,2022-05-03_11-02-08,fp7d
2020-11-15,SZ,12,11,0,11,2022-05-03_11-02-08,fp7d
2020-11-15,TG,21,33,12,21,2022-05-03_11-02-08,fp7d
2020-11-15,TI,56,78,28,50,2022-05-03_11-02-08,fp7d
2020-11-15,UR,6,6,0,6,2022-05-03_11-02-08,fp7d
2020-11-15,VD,85,159,74,85,2022-05-03_11-02-08,fp7d
2020-11-15,VS,21,35,14,21,2022-05-03_11-02-08,fp7d
2020-11-15,ZG,8,8,0,8,2022-05-03_11-02-08,fp7d
2020-11-15,ZH,190,223,35,188,2022-05-03_11-02-08,fp7d
2020-11-16,AG,52,54,4,50,2022-05-03_11-02-08,fp7d
2020-11-16,AI,0,0,0,0,2022-05-03_11-02-08,fp7d
2020-11-16,AR,6,6,0,6,2022-05-03_11-02-08,fp7d
2020-11-16,BE,104,126,22,104,2022-05-03_11-02-08,fp7d
2020-11-16,BL,20,17,0,17,2022-05-03_11-02-08,fp7d
2020-11-16,BS,54,50,0,50,2022-05-03_11-02-08,fp7d
2020-11-16,FR,24,29,5,24,2022-05-03_11-02-08,fp7d
2020-11-16,GE,40,71,31,40,2022-05-03_11-02-08,fp7d
2020-11-16,GL,6,6,0,6,2022-05-03_11-02-08,fp7d
2020-11-16,GR,16,20,4,16,2022-05-03_11-02-08,fp7d
2020-11-16,JU,6,8,2,6,2022-05-03_11-02-08,fp7d
2020-11-16,LU,54,56,6,50,2022-05-03_11-02-08,fp7d
2020-11-16,NE,10,26,16,10,2022-05-03_11-02-08,fp7d
2020-11-16,NW,6,6,0,6,2022-05-03_11-02-08,fp7d
2020-11-16,OW,0,0,0,0,2022-05-03_11-02-08,fp7d
2020-11-16,SG,54,73,19,54,2022-05-03_11-02-08,fp7d
2020-11-16,SH,8,8,0,8,2022-05-03_11-02-08,fp7d
2020-11-16,SO,17,25,8,17,2022-05-03_11-02-08,fp7d
2020-11-16,SZ,12,11,0,11,2022-05-03_11-02-08,fp7d
2020-11-16,TG,21,33,12,21,2022-05-03_11-02-08,fp7d
2020-11-16,TI,55,79,30,49,2022-05-03_11-02-08,fp7d
2020-11-16,UR,6,6,0,6,2022-05-03_11-02-08,fp7d
2020-11-16,VD,85,159,74,85,2022-05-03_11-02-08,fp7d
2020-11-16,VS,21,37,16,21,2022-05-03_11-02-08,fp7d
2020-11-16,ZG,8,8,0,8,2022-05-03_11-02-08,fp7d
2020-11-16,ZH,190,225,35,190,2022-05-03_11-02-08,fp7d
2020-11-17,AG,52,54,4,50,2022-05-03_11-02-08,fp7d
2020-11-17,AI,0,0,0,0,2022-05-03_11-02-08,fp7d
2020-11-17,AR,6,6,0,6,2022-05-03_11-02-08,fp7d
2020-11-17,BE,104,129,25,104,2022-05-03_11-02-08,fp7d
2020-11-17,BL,20,17,0,17,2022-05-03_11-02-08,fp7d
2020-11-17,BS,54,50,0,50,2022-05-03_11-02-08,fp7d
2020-11-17,FR,24,29,5,24,2022-05-03_11-02-08,fp7d
2020-11-17,GE,40,71,31,40,2022-05-03_11-02-08,fp7d
2020-11-17,GL,6,6,0,6,2022-05-03_11-02-08,fp7d
2020-11-17,GR,16,20,4,16,2022-05-03_11-02-08,fp7d
2020-11-17,JU,6,8,2,6,2022-05-03_11-02-08,fp7d
2020-11-17,LU,54,56,6,50,2022-05-03_11-02-08,fp7d
2020-11-17,NE,10,26,16,10,2022-05-03_11-02-08,fp7d
2020-11-17,NW,6,6,0,6,2022-05-03_11-02-08,fp7d
2020-11-17,OW,0,0,0,0,2022-05-03_11-02-08,fp7d
2020-11-17,SG,54,73,19,54,2022-05-03_11-02-08,fp7d
2020-11-17,SH,8,8,0,8,2022-05-03_11-02-08,fp7d
2020-11-17,SO,17,25,8,17,2022-05-03_11-02-08,fp7d
2020-11-17,SZ,12,11,0,11,2022-05-03_11-02-08,fp7d
2020-11-17,TG,21,33,12,21,2022-05-03_11-02-08,fp7d
2020-11-17,TI,55,79,30,49,2022-05-03_11-02-08,fp7d
2020-11-17,UR,6,6,0,6,2022-05-03_11-02-08,fp7d
2020-11-17,VD,85,159,74,85,2022-05-03_11-02-08,fp7d
2020-11-17,VS,21,37,16,21,2022-05-03_11-02-08,fp7d
2020-11-17,ZG,8,8,0,8,2022-05-03_11-02-08,fp7d
2020-11-17,ZH,190,225,35,190,2022-05-03_11-02-08,fp7d
2020-11-18,AG,52,54,4,50,2022-05-03_11-02-08,fp7d
2020-11-18,AI,0,0,0,0,2022-05-03_11-02-08,fp7d
2020-11-18,AR,6,6,0,6,2022-05-03_11-02-08,fp7d
2020-11-18,BE,104,131,27,104,2022-05-03_11-02-08,fp7d
2020-11-18,BL,20,17,0,17,2022-05-03_11-02-08,fp7d
2020-11-18,BS,54,50,0,50,2022-05-03_11-02-08,fp7d
2020-11-18,FR,24,29,5,24,2022-05-03_11-02-08,fp7d
2020-11-18,GE,40,71,31,40,2022-05-03_11-02-08,fp7d
2020-11-18,GL,6,6,0,6,2022-05-03_11-02-08,fp7d
2020-11-18,GR,16,20,4,16,2022-05-03_11-02-08,fp7d
2020-11-18,JU,6,8,2,6,2022-05-03_11-02-08,fp7d
2020-11-18,LU,54,56,6,50,2022-05-03_11-02-08,fp7d
2020-11-18,NE,10,26,16,10,2022-05-03_11-02-08,fp7d
2020-11-18,NW,6,6,0,6,2022-05-03_11-02-08,fp7d
2020-11-18,OW,0,0,0,0,2022-05-03_11-02-08,fp7d
2020-11-18,SG,54,73,19,54,2022-05-03_11-02-08,fp7d
2020-11-18,SH,8,8,0,8,2022-05-03_11-02-08,fp7d
2020-11-18,SO,17,25,8,17,2022-05-03_11-02-08,fp7d
2020-11-18,SZ,12,11,0,11,2022-05-03_11-02-08,fp7d
2020-11-18,TG,21,33,12,21,2022-05-03_11-02-08,fp7d
2020-11-18,TI,55,79,30,49,2022-05-03_11-02-08,fp7d
2020-11-18,UR,6,6,0,6,2022-05-03_11-02-08,fp7d
2020-11-18,VD,85,159,74,85,2022-05-03_11-02-08,fp7d
2020-11-18,VS,21,35,14,21,2022-05-03_11-02-08,fp7d
2020-11-18,ZG,8,8,0,8,2022-05-03_11-02-08,fp7d
2020-11-18,ZH,190,225,35,190,2022-05-03_11-02-08,fp7d
2020-11-19,AG,52,54,4,50,2022-05-03_11-02-08,fp7d
2020-11-19,AI,0,0,0,0,2022-05-03_11-02-08,fp7d
2020-11-19,AR,6,6,0,6,2022-05-03_11-02-08,fp7d
2020-11-19,BE,104,133,29,104,2022-05-03_11-02-08,fp7d
2020-11-19,BL,20,17,0,17,2022-05-03_11-02-08,fp7d
2020-11-19,BS,54,52,2,50,2022-05-03_11-02-08,fp7d
2020-11-19,FR,24,29,5,24,2022-05-03_11-02-08,fp7d
2020-11-19,GE,38,64,26,38,2022-05-03_11-02-08,fp7d
2020-11-19,GL,6,6,0,6,2022-05-03_11-02-08,fp7d
2020-11-19,GR,16,20,4,16,2022-05-03_11-02-08,fp7d
2020-11-19,JU,6,8,2,6,2022-05-03_11-02-08,fp7d
2020-11-19,LU,54,56,6,50,2022-05-03_11-02-08,fp7d
2020-11-19,NE,10,26,16,10,2022-05-03_11-02-08,fp7d
2020-11-19,NW,6,6,0,6,2022-05-03_11-02-08,fp7d
2020-11-19,OW,0,0,0,0,2022-05-03_11-02-08,fp7d
2020-11-19,SG,54,73,19,54,2022-05-03_11-02-08,fp7d
2020-11-19,SH,8,8,0,8,2022-05-03_11-02-08,fp7d
2020-11-19,SO,17,25,8,17,2022-05-03_11-02-08,fp7d
2020-11-19,SZ,12,11,0,11,2022-05-03_11-02-08,fp7d
2020-11-19,TG,21,33,12,21,2022-05-03_11-02-08,fp7d
2020-11-19,TI,55,79,30,49,2022-05-03_11-02-08,fp7d
2020-11-19,UR,6,6,0,6,2022-05-03_11-02-08,fp7d
2020-11-19,VD,85,159,74,85,2022-05-03_11-02-08,fp7d
2020-11-19,VS,21,35,14,21,2022-05-03_11-02-08,fp7d
2020-11-19,ZG,8,8,0,8,2022-05-03_11-02-08,fp7d
2020-11-19,ZH,190,218,31,187,2022-05-03_11-02-08,fp7d
2020-11-20,AG,52,56,6,50,2022-05-03_11-02-08,fp7d
2020-11-20,AI,0,0,0,0,2022-05-03_11-02-08,fp7d
2020-11-20,AR,6,6,0,6,2022-05-03_11-02-08,fp7d
2020-11-20,BE,104,133,29,104,2022-05-03_11-02-08,fp7d
2020-11-20,BL,20,17,0,17,2022-05-03_11-02-08,fp7d
2020-11-20,BS,54,52,2,50,2022-05-03_11-02-08,fp7d
2020-11-20,FR,24,29,5,24,2022-05-03_11-02-08,fp7d
2020-11-20,GE,38,64,26,38,2022-05-03_11-02-08,fp7d
2020-11-20,GL,6,6,0,6,2022-05-03_11-02-08,fp7d
2020-11-20,GR,16,20,4,16,2022-05-03_11-02-08,fp7d
2020-11-20,JU,6,8,2,6,2022-05-03_11-02-08,fp7d
2020-11-20,LU,54,56,6,50,2022-05-03_11-02-08,fp7d
2020-11-20,NE,10,26,16,10,2022-05-03_11-02-08,fp7d
2020-11-20,NW,6,6,0,6,2022-05-03_11-02-08,fp7d
2020-11-20,OW,0,0,0,0,2022-05-03_11-02-08,fp7d
2020-11-20,SG,54,73,19,54,2022-05-03_11-02-08,fp7d
2020-11-20,SH,8,8,0,8,2022-05-03_11-02-08,fp7d
2020-11-20,SO,17,25,8,17,2022-05-03_11-02-08,fp7d
2020-11-20,SZ,12,11,0,11,2022-05-03_11-02-08,fp7d
2020-11-20,TG,21,33,12,21,2022-05-03_11-02-08,fp7d
2020-11-20,TI,55,79,30,49,2022-05-03_11-02-08,fp7d
2020-11-20,UR,6,6,0,6,2022-05-03_11-02-08,fp7d
2020-11-20,VD,85,159,74,85,2022-05-03_11-02-08,fp7d
2020-11-20,VS,21,33,12,21,2022-05-03_11-02-08,fp7d
2020-11-20,ZG,8,8,0,8,2022-05-03_11-02-08,fp7d
2020-11-20,ZH,190,218,31,187,2022-05-03_11-02-08,fp7d
2020-11-21,AG,52,55,6,49,2022-05-03_11-02-08,fp7d
2020-11-21,AI,0,0,0,0,2022-05-03_11-02-08,fp7d
2020-11-21,AR,6,6,0,6,2022-05-03_11-02-08,fp7d
2020-11-21,BE,104,133,29,104,2022-05-03_11-02-08,fp7d
2020-11-21,BL,20,17,0,17,2022-05-03_11-02-08,fp7d
2020-11-21,BS,54,52,2,50,2022-05-03_11-02-08,fp7d
2020-11-21,FR,24,29,5,24,2022-05-03_11-02-08,fp7d
2020-11-21,GE,38,64,26,38,2022-05-03_11-02-08,fp7d
2020-11-21,GL,6,6,0,6,2022-05-03_11-02-08,fp7d
2020-11-21,GR,16,21,5,16,2022-05-03_11-02-08,fp7d
2020-11-21,JU,6,8,2,6,2022-05-03_11-02-08,fp7d
2020-11-21,LU,54,56,6,50,2022-05-03_11-02-08,fp7d
2020-11-21,NE,10,26,16,10,2022-05-03_11-02-08,fp7d
2020-11-21,NW,6,6,0,6,2022-05-03_11-02-08,fp7d
2020-11-21,OW,0,0,0,0,2022-05-03_11-02-08,fp7d
2020-11-21,SG,54,73,19,54,2022-05-03_11-02-08,fp7d
2020-11-21,SH,8,8,0,8,2022-05-03_11-02-08,fp7d
2020-11-21,SO,17,25,8,17,2022-05-03_11-02-08,fp7d
2020-11-21,SZ,12,11,0,11,2022-05-03_11-02-08,fp7d
2020-11-21,TG,21,34,13,21,2022-05-03_11-02-08,fp7d
2020-11-21,TI,55,79,30,49,2022-05-03_11-02-08,fp7d
2020-11-21,UR,6,6,0,6,2022-05-03_11-02-08,fp7d
2020-11-21,VD,85,159,74,85,2022-05-03_11-02-08,fp7d
2020-11-21,VS,21,33,12,21,2022-05-03_11-02-08,fp7d
2020-11-21,ZG,8,7,0,7,2022-05-03_11-02-08,fp7d
2020-11-21,ZH,190,217,31,186,2022-05-03_11-02-08,fp7d
2020-11-22,AG,52,55,6,49,2022-05-03_11-02-08,fp7d
2020-11-22,AI,0,0,0,0,2022-05-03_11-02-08,fp7d
2020-11-22,AR,6,6,0,6,2022-05-03_11-02-08,fp7d
2020-11-22,BE,104,133,29,104,2022-05-03_11-02-08,fp7d
2020-11-22,BL,20,17,0,17,2022-05-03_11-02-08,fp7d
2020-11-22,BS,54,52,2,50,2022-05-03_11-02-08,fp7d
2020-11-22,FR,24,29,5,24,2022-05-03_11-02-08,fp7d
2020-11-22,GE,38,64,26,38,2022-05-03_11-02-08,fp7d
2020-11-22,GL,6,6,0,6,2022-05-03_11-02-08,fp7d
2020-11-22,GR,16,21,5,16,2022-05-03_11-02-08,fp7d
2020-11-22,JU,6,8,2,6,2022-05-03_11-02-08,fp7d
2020-11-22,LU,54,56,6,50,2022-05-03_11-02-08,fp7d
2020-11-22,NE,10,26,16,10,2022-05-03_11-02-08,fp7d
2020-11-22,NW,6,6,0,6,2022-05-03_11-02-08,fp7d
2020-11-22,OW,0,0,0,0,2022-05-03_11-02-08,fp7d
2020-11-22,SG,54,73,19,54,2022-05-03_11-02-08,fp7d
2020-11-22,SH,8,8,0,8,2022-05-03_11-02-08,fp7d
2020-11-22,SO,17,25,8,17,2022-05-03_11-02-08,fp7d
2020-11-22,SZ,12,11,0,11,2022-05-03_11-02-08,fp7d
2020-11-22,TG,21,33,12,21,2022-05-03_11-02-08,fp7d
2020-11-22,TI,55,83,34,49,2022-05-03_11-02-08,fp7d
2020-11-22,UR,6,6,0,6,2022-05-03_11-02-08,fp7d
2020-11-22,VD,85,159,74,85,2022-05-03_11-02-08,fp7d
2020-11-22,VS,21,33,12,21,2022-05-03_11-02-08,fp7d
2020-11-22,ZG,8,8,0,8,2022-05-03_11-02-08,fp7d
2020-11-22,ZH,190,218,33,185,2022-05-03_11-02-08,fp7d
2020-11-23,AG,52,54,6,48,2022-05-03_11-02-08,fp7d
2020-11-23,AI,0,0,0,0,2022-05-03_11-02-08,fp7d
2020-11-23,AR,6,6,0,6,2022-05-03_11-02-08,fp7d
2020-11-23,BE,104,125,21,104,2022-05-03_11-02-08,fp7d
2020-11-23,BL,20,17,0,17,2022-05-03_11-02-08,fp7d
2020-11-23,BS,54,52,2,50,2022-05-03_11-02-08,fp7d
2020-11-23,FR,24,29,5,24,2022-05-03_11-02-08,fp7d
2020-11-23,GE,38,64,26,38,2022-05-03_11-02-08,fp7d
2020-11-23,GL,6,6,0,6,2022-05-03_11-02-08,fp7d
2020-11-23,GR,16,21,5,16,2022-05-03_11-02-08,fp7d
2020-11-23,JU,6,7,1,6,2022-05-03_11-02-08,fp7d
2020-11-23,LU,54,55,6,49,2022-05-03_11-02-08,fp7d
2020-11-23,NE,10,26,16,10,2022-05-03_11-02-08,fp7d
2020-11-23,NW,6,6,0,6,2022-05-03_11-02-08,fp7d
2020-11-23,OW,0,0,0,0,2022-05-03_11-02-08,fp7d
2020-11-23,SG,54,73,19,54,2022-05-03_11-02-08,fp7d
2020-11-23,SH,8,8,0,8,2022-05-03_11-02-08,fp7d
2020-11-23,SO,17,25,8,17,2022-05-03_11-02-08,fp7d
2020-11-23,SZ,12,11,0,11,2022-05-03_11-02-08,fp7d
2020-11-23,TG,21,33,12,21,2022-05-03_11-02-08,fp7d
2020-11-23,TI,55,83,34,49,2022-05-03_11-02-08,fp7d
2020-11-23,UR,6,6,0,6,2022-05-03_11-02-08,fp7d
2020-11-23,VD,85,159,74,85,2022-05-03_11-02-08,fp7d
2020-11-23,VS,21,33,12,21,2022-05-03_11-02-08,fp7d
2020-11-23,ZG,8,8,0,8,2022-05-03_11-02-08,fp7d
2020-11-23,ZH,190,217,33,184,2022-05-03_11-02-08,fp7d
2020-11-24,AG,52,54,6,48,2022-05-03_11-02-08,fp7d
2020-11-24,AI,0,0,0,0,2022-05-03_11-02-08,fp7d
2020-11-24,AR,6,6,0,6,2022-05-03_11-02-08,fp7d
2020-11-24,BE,104,125,21,104,2022-05-03_11-02-08,fp7d
2020-11-24,BL,20,18,0,18,2022-05-03_11-02-08,fp7d
2020-11-24,BS,54,52,2,50,2022-05-03_11-02-08,fp7d
2020-11-24,FR,24,29,5,24,2022-05-03_11-02-08,fp7d
2020-11-24,GE,38,64,26,38,2022-05-03_11-02-08,fp7d
2020-11-24,GL,6,6,0,6,2022-05-03_11-02-08,fp7d
2020-11-24,GR,16,21,5,16,2022-05-03_11-02-08,fp7d
2020-11-24,JU,6,7,1,6,2022-05-03_11-02-08,fp7d
2020-11-24,LU,54,56,6,50,2022-05-03_11-02-08,fp7d
2020-11-24,NE,10,26,16,10,2022-05-03_11-02-08,fp7d
2020-11-24,NW,6,6,0,6,2022-05-03_11-02-08,fp7d
2020-11-24,OW,0,0,0,0,2022-05-03_11-02-08,fp7d
2020-11-24,SG,54,73,19,54,2022-05-03_11-02-08,fp7d
2020-11-24,SH,8,8,0,8,2022-05-03_11-02-08,fp7d
2020-11-24,SO,17,25,8,17,2022-05-03_11-02-08,fp7d
2020-11-24,SZ,12,11,0,11,2022-05-03_11-02-08,fp7d
2020-11-24,TG,21,35,14,21,2022-05-03_11-02-08,fp7d
2020-11-24,TI,55,83,34,49,2022-05-03_11-02-08,fp7d
2020-11-24,UR,6,6,0,6,2022-05-03_11-02-08,fp7d
2020-11-24,VD,85,159,74,85,2022-05-03_11-02-08,fp7d
2020-11-24,VS,21,33,12,21,2022-05-03_11-02-08,fp7d
2020-11-24,ZG,8,6,0,6,2022-05-03_11-02-08,fp7d
2020-11-24,ZH,190,217,33,184,2022-05-03_11-02-08,fp7d
2020-11-25,AG,52,55,6,49,2022-05-03_11-02-08,fp7d
2020-11-25,AI,0,0,0,0,2022-05-03_11-02-08,fp7d
2020-11-25,AR,6,6,0,6,2022-05-03_11-02-08,fp7d
2020-11-25,BE,104,125,21,104,2022-05-03_11-02-08,fp7d
2020-11-25,BL,20,18,0,18,2022-05-03_11-02-08,fp7d
2020-11-25,BS,54,50,0,50,2022-05-03_11-02-08,fp7d
2020-11-25,FR,24,29,5,24,2022-05-03_11-02-08,fp7d
2020-11-25,GE,38,64,26,38,2022-05-03_11-02-08,fp7d
2020-11-25,GL,6,6,0,6,2022-05-03_11-02-08,fp7d
2020-11-25,GR,16,21,5,16,2022-05-03_11-02-08,fp7d
2020-11-25,JU,6,7,1,6,2022-05-03_11-02-08,fp7d
2020-11-25,LU,54,56,6,50,2022-05-03_11-02-08,fp7d
2020-11-25,NE,10,26,16,10,2022-05-03_11-02-08,fp7d
2020-11-25,NW,6,6,0,6,2022-05-03_11-02-08,fp7d
2020-11-25,OW,0,0,0,0,2022-05-03_11-02-08,fp7d
2020-11-25,SG,54,73,19,54,2022-05-03_11-02-08,fp7d
2020-11-25,SH,8,8,0,8,2022-05-03_11-02-08,fp7d
2020-11-25,SO,17,27,10,17,2022-05-03_11-02-08,fp7d
2020-11-25,SZ,12,11,0,11,2022-05-03_11-02-08,fp7d
2020-11-25,TG,21,35,14,21,2022-05-03_11-02-08,fp7d
2020-11-25,TI,55,83,34,49,2022-05-03_11-02-08,fp7d
2020-11-25,UR,6,6,0,6,2022-05-03_11-02-08,fp7d
2020-11-25,VD,85,159,74,85,2022-05-03_11-02-08,fp7d
2020-11-25,VS,21,33,12,21,2022-05-03_11-02-08,fp7d
2020-11-25,ZG,8,8,0,8,2022-05-03_11-02-08,fp7d
2020-11-25,ZH,190,215,30,185,2022-05-03_11-02-08,fp7d
2020-11-26,AG,52,54,6,48,2022-05-03_11-02-08,fp7d
2020-11-26,AI,0,0,0,0,2022-05-03_11-02-08,fp7d
2020-11-26,AR,6,6,0,6,2022-05-03_11-02-08,fp7d
2020-11-26,BE,104,125,21,104,2022-05-03_11-02-08,fp7d
2020-11-26,BL,20,18,0,18,2022-05-03_11-02-08,fp7d
2020-11-26,BS,54,51,1,50,2022-05-03_11-02-08,fp7d
2020-11-26,FR,24,29,5,24,2022-05-03_11-02-08,fp7d
2020-11-26,GE,38,64,26,38,2022-05-03_11-02-08,fp7d
2020-11-26,GL,6,6,0,6,2022-05-03_11-02-08,fp7d
2020-11-26,GR,16,21,5,16,2022-05-03_11-02-08,fp7d
2020-11-26,JU,6,7,1,6,2022-05-03_11-02-08,fp7d
2020-11-26,LU,54,56,6,50,2022-05-03_11-02-08,fp7d
2020-11-26,NE,10,24,14,10,2022-05-03_11-02-08,fp7d
2020-11-26,NW,6,5,0,5,2022-05-03_11-02-08,fp7d
2020-11-26,OW,0,0,0,0,2022-05-03_11-02-08,fp7d
2020-11-26,SG,54,73,19,54,2022-05-03_11-02-08,fp7d
2020-11-26,SH,8,8,0,8,2022-05-03_11-02-08,fp7d
2020-11-26,SO,17,27,10,17,2022-05-03_11-02-08,fp7d
2020-11-26,SZ,12,11,0,11,2022-05-03_11-02-08,fp7d
2020-11-26,TG,21,35,14,21,2022-05-03_11-02-08,fp7d
2020-11-26,TI,55,83,34,49,2022-05-03_11-02-08,fp7d
2020-11-26,UR,6,6,0,6,2022-05-03_11-02-08,fp7d
2020-11-26,VD,85,159,74,85,2022-05-03_11-02-08,fp7d
2020-11-26,VS,21,33,12,21,2022-05-03_11-02-08,fp7d
2020-11-26,ZG,8,8,0,8,2022-05-03_11-02-08,fp7d
2020-11-26,ZH,190,216,31,185,2022-05-03_11-02-08,fp7d
2020-11-27,AG,52,54,6,48,2022-05-03_11-02-08,fp7d
2020-11-27,AI,0,0,0,0,2022-05-03_11-02-08,fp7d
2020-11-27,AR,6,6,0,6,2022-05-03_11-02-08,fp7d
2020-11-27,BE,104,125,21,104,2022-05-03_11-02-08,fp7d
2020-11-27,BL,20,18,0,18,2022-05-03_11-02-08,fp7d
2020-11-27,BS,54,50,0,50,2022-05-03_11-02-08,fp7d
2020-11-27,FR,24,29,5,24,2022-05-03_11-02-08,fp7d
2020-11-27,GE,38,64,26,38,2022-05-03_11-02-08,fp7d
2020-11-27,GL,6,6,0,6,2022-05-03_11-02-08,fp7d
2020-11-27,GR,16,21,5,16,2022-05-03_11-02-08,fp7d
2020-11-27,JU,6,7,1,6,2022-05-03_11-02-08,fp7d
2020-11-27,LU,54,56,6,50,2022-05-03_11-02-08,fp7d
2020-11-27,NE,10,21,11,10,2022-05-03_11-02-08,fp7d
2020-11-27,NW,6,5,0,5,2022-05-03_11-02-08,fp7d
2020-11-27,OW,0,0,0,0,2022-05-03_11-02-08,fp7d
2020-11-27,SG,54,73,19,54,2022-05-03_11-02-08,fp7d
2020-11-27,SH,8,8,0,8,2022-05-03_11-02-08,fp7d
2020-11-27,SO,17,27,10,17,2022-05-03_11-02-08,fp7d
2020-11-27,SZ,12,11,0,11,2022-05-03_11-02-08,fp7d
2020-11-27,TG,21,33,12,21,2022-05-03_11-02-08,fp7d
2020-11-27,TI,53,81,34,47,2022-05-03_11-02-08,fp7d
2020-11-27,UR,6,6,0,6,2022-05-03_11-02-08,fp7d
2020-11-27,VD,85,159,74,85,2022-05-03_11-02-08,fp7d
2020-11-27,VS,20,33,13,20,2022-05-03_11-02-08,fp7d
2020-11-27,ZG,8,8,0,8,2022-05-03_11-02-08,fp7d
2020-11-27,ZH,190,217,32,185,2022-05-03_11-02-08,fp7d
2020-11-28,AG,52,55,6,49,2022-05-03_11-02-08,fp7d
2020-11-28,AI,0,0,0,0,2022-05-03_11-02-08,fp7d
2020-11-28,AR,6,6,0,6,2022-05-03_11-02-08,fp7d
2020-11-28,BE,104,125,21,104,2022-05-03_11-02-08,fp7d
2020-11-28,BL,20,18,0,18,2022-05-03_11-02-08,fp7d
2020-11-28,BS,54,50,0,50,2022-05-03_11-02-08,fp7d
2020-11-28,FR,24,29,5,24,2022-05-03_11-02-08,fp7d
2020-11-28,GE,38,64,26,38,2022-05-03_11-02-08,fp7d
2020-11-28,GL,6,6,0,6,2022-05-03_11-02-08,fp7d
2020-11-28,GR,16,21,5,16,2022-05-03_11-02-08,fp7d
2020-11-28,JU,6,7,1,6,2022-05-03_11-02-08,fp7d
2020-11-28,LU,54,56,6,50,2022-05-03_11-02-08,fp7d
2020-11-28,NE,10,21,11,10,2022-05-03_11-02-08,fp7d
2020-11-28,NW,6,5,0,5,2022-05-03_11-02-08,fp7d
2020-11-28,OW,0,0,0,0,2022-05-03_11-02-08,fp7d
2020-11-28,SG,54,73,19,54,2022-05-03_11-02-08,fp7d
2020-11-28,SH,8,8,0,8,2022-05-03_11-02-08,fp7d
2020-11-28,SO,17,27,10,17,2022-05-03_11-02-08,fp7d
2020-11-28,SZ,12,11,0,11,2022-05-03_11-02-08,fp7d
2020-11-28,TG,21,33,12,21,2022-05-03_11-02-08,fp7d
2020-11-28,TI,53,81,34,47,2022-05-03_11-02-08,fp7d
2020-11-28,UR,6,6,0,6,2022-05-03_11-02-08,fp7d
2020-11-28,VD,85,157,72,85,2022-05-03_11-02-08,fp7d
2020-11-28,VS,20,33,13,20,2022-05-03_11-02-08,fp7d
2020-11-28,ZG,8,8,0,8,2022-05-03_11-02-08,fp7d
2020-11-28,ZH,190,215,30,185,2022-05-03_11-02-08,fp7d
2020-11-29,AG,52,55,6,49,2022-05-03_11-02-08,fp7d
2020-11-29,AI,0,0,0,0,2022-05-03_11-02-08,fp7d
2020-11-29,AR,6,6,0,6,2022-05-03_11-02-08,fp7d
2020-11-29,BE,104,125,21,104,2022-05-03_11-02-08,fp7d
2020-11-29,BL,20,18,0,18,2022-05-03_11-02-08,fp7d
2020-11-29,BS,54,50,0,50,2022-05-03_11-02-08,fp7d
2020-11-29,FR,24,29,5,24,2022-05-03_11-02-08,fp7d
2020-11-29,GE,38,64,26,38,2022-05-03_11-02-08,fp7d
2020-11-29,GL,6,6,0,6,2022-05-03_11-02-08,fp7d
2020-11-29,GR,16,21,5,16,2022-05-03_11-02-08,fp7d
2020-11-29,JU,6,7,1,6,2022-05-03_11-02-08,fp7d
2020-11-29,LU,54,56,6,50,2022-05-03_11-02-08,fp7d
2020-11-29,NE,10,21,11,10,2022-05-03_11-02-08,fp7d
2020-11-29,NW,6,5,0,5,2022-05-03_11-02-08,fp7d
2020-11-29,OW,0,0,0,0,2022-05-03_11-02-08,fp7d
2020-11-29,SG,54,73,19,54,2022-05-03_11-02-08,fp7d
2020-11-29,SH,8,8,0,8,2022-05-03_11-02-08,fp7d
2020-11-29,SO,17,27,10,17,2022-05-03_11-02-08,fp7d
2020-11-29,SZ,12,11,0,11,2022-05-03_11-02-08,fp7d
2020-11-29,TG,21,33,12,21,2022-05-03_11-02-08,fp7d
2020-11-29,TI,53,81,34,47,2022-05-03_11-02-08,fp7d
2020-11-29,UR,6,6,0,6,2022-05-03_11-02-08,fp7d
2020-11-29,VD,85,157,72,85,2022-05-03_11-02-08,fp7d
2020-11-29,VS,20,33,13,20,2022-05-03_11-02-08,fp7d
2020-11-29,ZG,8,8,0,8,2022-05-03_11-02-08,fp7d
2020-11-29,ZH,190,217,32,185,2022-05-03_11-02-08,fp7d
2020-11-30,AG,52,55,6,49,2022-05-03_11-02-08,fp7d
2020-11-30,AI,0,0,0,0,2022-05-03_11-02-08,fp7d
2020-11-30,AR,6,6,0,6,2022-05-03_11-02-08,fp7d
2020-11-30,BE,104,125,21,104,2022-05-03_11-02-08,fp7d
2020-11-30,BL,20,18,0,18,2022-05-03_11-02-08,fp7d
2020-11-30,BS,54,50,0,50,2022-05-03_11-02-08,fp7d
2020-11-30,FR,24,29,5,24,2022-05-03_11-02-08,fp7d
2020-11-30,GE,38,64,26,38,2022-05-03_11-02-08,fp7d
2020-11-30,GL,6,6,0,6,2022-05-03_11-02-08,fp7d
2020-11-30,GR,16,21,5,16,2022-05-03_11-02-08,fp7d
2020-11-30,JU,6,7,1,6,2022-05-03_11-02-08,fp7d
2020-11-30,LU,54,56,6,50,2022-05-03_11-02-08,fp7d
2020-11-30,NE,10,21,11,10,2022-05-03_11-02-08,fp7d
2020-11-30,NW,6,5,0,5,2022-05-03_11-02-08,fp7d
2020-11-30,OW,0,0,0,0,2022-05-03_11-02-08,fp7d
2020-11-30,SG,54,73,19,54,2022-05-03_11-02-08,fp7d
2020-11-30,SH,8,8,0,8,2022-05-03_11-02-08,fp7d
2020-11-30,SO,17,27,10,17,2022-05-03_11-02-08,fp7d
2020-11-30,SZ,12,11,0,11,2022-05-03_11-02-08,fp7d
2020-11-30,TG,21,33,12,21,2022-05-03_11-02-08,fp7d
2020-11-30,TI,53,80,35,45,2022-05-03_11-02-08,fp7d
2020-11-30,UR,6,6,0,6,2022-05-03_11-02-08,fp7d
2020-11-30,VD,85,157,72,85,2022-05-03_11-02-08,fp7d
2020-11-30,VS,20,33,13,20,2022-05-03_11-02-08,fp7d
2020-11-30,ZG,8,8,0,8,2022-05-03_11-02-08,fp7d
2020-11-30,ZH,190,215,30,185,2022-05-03_11-02-08,fp7d
2020-12-01,AG,52,55,6,49,2022-05-03_11-02-08,fp7d
2020-12-01,AI,0,0,0,0,2022-05-03_11-02-08,fp7d
2020-12-01,AR,6,6,0,6,2022-05-03_11-02-08,fp7d
2020-12-01,BE,104,125,21,104,2022-05-03_11-02-08,fp7d
2020-12-01,BL,20,18,0,18,2022-05-03_11-02-08,fp7d
2020-12-01,BS,54,50,0,50,2022-05-03_11-02-08,fp7d
2020-12-01,FR,24,29,5,24,2022-05-03_11-02-08,fp7d
2020-12-01,GE,38,64,26,38,2022-05-03_11-02-08,fp7d
2020-12-01,GL,6,6,0,6,2022-05-03_11-02-08,fp7d
2020-12-01,GR,16,21,5,16,2022-05-03_11-02-08,fp7d
2020-12-01,JU,6,7,1,6,2022-05-03_11-02-08,fp7d
2020-12-01,LU,54,56,6,50,2022-05-03_11-02-08,fp7d
2020-12-01,NE,10,21,11,10,2022-05-03_11-02-08,fp7d
2020-12-01,NW,6,5,0,5,2022-05-03_11-02-08,fp7d
2020-12-01,OW,0,0,0,0,2022-05-03_11-02-08,fp7d
2020-12-01,SG,54,73,19,54,2022-05-03_11-02-08,fp7d
2020-12-01,SH,8,8,0,8,2022-05-03_11-02-08,fp7d
2020-12-01,SO,17,27,10,17,2022-05-03_11-02-08,fp7d
2020-12-01,SZ,12,10,0,10,2022-05-03_11-02-08,fp7d
2020-12-01,TG,21,33,12,21,2022-05-03_11-02-08,fp7d
2020-12-01,TI,53,80,35,45,2022-05-03_11-02-08,fp7d
2020-12-01,UR,6,6,0,6,2022-05-03_11-02-08,fp7d
2020-12-01,VD,85,157,72,85,2022-05-03_11-02-08,fp7d
2020-12-01,VS,20,33,13,20,2022-05-03_11-02-08,fp7d
2020-12-01,ZG,8,8,0,8,2022-05-03_11-02-08,fp7d
2020-12-01,ZH,190,217,29,188,2022-05-03_11-02-08,fp7d
2020-12-02,AG,52,55,6,49,2022-05-03_11-02-08,fp7d
2020-12-02,AI,0,0,0,0,2022-05-03_11-02-08,fp7d
2020-12-02,AR,6,6,0,6,2022-05-03_11-02-08,fp7d
2020-12-02,BE,104,125,21,104,2022-05-03_11-02-08,fp7d
2020-12-02,BL,20,18,0,18,2022-05-03_11-02-08,fp7d
2020-12-02,BS,54,50,0,50,2022-05-03_11-02-08,fp7d
2020-12-02,FR,24,29,5,24,2022-05-03_11-02-08,fp7d
2020-12-02,GE,38,61,23,38,2022-05-03_11-02-08,fp7d
2020-12-02,GL,6,6,0,6,2022-05-03_11-02-08,fp7d
2020-12-02,GR,16,22,6,16,2022-05-03_11-02-08,fp7d
2020-12-02,JU,6,7,1,6,2022-05-03_11-02-08,fp7d
2020-12-02,LU,54,56,6,50,2022-05-03_11-02-08,fp7d
2020-12-02,NE,10,21,11,10,2022-05-03_11-02-08,fp7d
2020-12-02,NW,6,5,0,5,2022-05-03_11-02-08,fp7d
2020-12-02,OW,0,0,0,0,2022-05-03_11-02-08,fp7d
2020-12-02,SG,54,73,19,54,2022-05-03_11-02-08,fp7d
2020-12-02,SH,8,8,0,8,2022-05-03_11-02-08,fp7d
2020-12-02,SO,17,27,10,17,2022-05-03_11-02-08,fp7d
2020-12-02,SZ,12,10,0,10,2022-05-03_11-02-08,fp7d
2020-12-02,TG,21,35,14,21,2022-05-03_11-02-08,fp7d
2020-12-02,TI,53,80,35,45,2022-05-03_11-02-08,fp7d
2020-12-02,UR,6,6,0,6,2022-05-03_11-02-08,fp7d
2020-12-02,VD,85,154,69,85,2022-05-03_11-02-08,fp7d
2020-12-02,VS,20,33,13,20,2022-05-03_11-02-08,fp7d
2020-12-02,ZG,8,8,0,8,2022-05-03_11-02-08,fp7d
2020-12-02,ZH,190,218,30,188,2022-05-03_11-02-08,fp7d
2020-12-03,AG,52,55,6,49,2022-05-03_11-02-08,fp7d
2020-12-03,AI,0,0,0,0,2022-05-03_11-02-08,fp7d
2020-12-03,AR,6,6,0,6,2022-05-03_11-02-08,fp7d
2020-12-03,BE,104,125,21,104,2022-05-03_11-02-08,fp7d
2020-12-03,BL,20,18,0,18,2022-05-03_11-02-08,fp7d
2020-12-03,BS,54,50,0,50,2022-05-03_11-02-08,fp7d
2020-12-03,FR,24,29,5,24,2022-05-03_11-02-08,fp7d
2020-12-03,GE,38,61,23,38,2022-05-03_11-02-08,fp7d
2020-12-03,GL,6,6,0,6,2022-05-03_11-02-08,fp7d
2020-12-03,GR,16,22,6,16,2022-05-03_11-02-08,fp7d
2020-12-03,JU,6,7,1,6,2022-05-03_11-02-08,fp7d
2020-12-03,LU,54,56,6,50,2022-05-03_11-02-08,fp7d
2020-12-03,NE,10,21,11,10,2022-05-03_11-02-08,fp7d
2020-12-03,NW,6,5,0,5,2022-05-03_11-02-08,fp7d
2020-12-03,OW,0,0,0,0,2022-05-03_11-02-08,fp7d
2020-12-03,SG,54,73,19,54,2022-05-03_11-02-08,fp7d
2020-12-03,SH,8,8,0,8,2022-05-03_11-02-08,fp7d
2020-12-03,SO,17,27,10,17,2022-05-03_11-02-08,fp7d
2020-12-03,SZ,12,10,0,10,2022-05-03_11-02-08,fp7d
2020-12-03,TG,21,35,14,21,2022-05-03_11-02-08,fp7d
2020-12-03,TI,53,80,35,45,2022-05-03_11-02-08,fp7d
2020-12-03,UR,6,6,0,6,2022-05-03_11-02-08,fp7d
2020-12-03,VD,85,154,69,85,2022-05-03_11-02-08,fp7d
2020-12-03,VS,20,33,13,20,2022-05-03_11-02-08,fp7d
2020-12-03,ZG,8,8,0,8,2022-05-03_11-02-08,fp7d
2020-12-03,ZH,190,217,29,188,2022-05-03_11-02-08,fp7d
2020-12-04,AG,52,55,6,49,2022-05-03_11-02-08,fp7d
2020-12-04,AI,0,0,0,0,2022-05-03_11-02-08,fp7d
2020-12-04,AR,6,6,0,6,2022-05-03_11-02-08,fp7d
2020-12-04,BE,104,125,21,104,2022-05-03_11-02-08,fp7d
2020-12-04,BL,20,18,0,18,2022-05-03_11-02-08,fp7d
2020-12-04,BS,54,50,0,50,2022-05-03_11-02-08,fp7d
2020-12-04,FR,24,29,5,24,2022-05-03_11-02-08,fp7d
2020-12-04,GE,38,61,23,38,2022-05-03_11-02-08,fp7d
2020-12-04,GL,6,6,0,6,2022-05-03_11-02-08,fp7d
2020-12-04,GR,16,22,6,16,2022-05-03_11-02-08,fp7d
2020-12-04,JU,6,7,1,6,2022-05-03_11-02-08,fp7d
2020-12-04,LU,54,56,6,50,2022-05-03_11-02-08,fp7d
2020-12-04,NE,10,19,9,10,2022-05-03_11-02-08,fp7d
2020-12-04,NW,6,5,0,5,2022-05-03_11-02-08,fp7d
2020-12-04,OW,0,0,0,0,2022-05-03_11-02-08,fp7d
2020-12-04,SG,54,70,16,54,2022-05-03_11-02-08,fp7d
2020-12-04,SH,8,8,0,8,2022-05-03_11-02-08,fp7d
2020-12-04,SO,17,27,10,17,2022-05-03_11-02-08,fp7d
2020-12-04,SZ,12,10,0,10,2022-05-03_11-02-08,fp7d
2020-12-04,TG,21,35,14,21,2022-05-03_11-02-08,fp7d
2020-12-04,TI,53,82,35,47,2022-05-03_11-02-08,fp7d
2020-12-04,UR,6,6,0,6,2022-05-03_11-02-08,fp7d
2020-12-04,VD,85,154,69,85,2022-05-03_11-02-08,fp7d
2020-12-04,VS,20,31,11,20,2022-05-03_11-02-08,fp7d
2020-12-04,ZG,8,8,0,8,2022-05-03_11-02-08,fp7d
2020-12-04,ZH,190,220,31,189,2022-05-03_11-02-08,fp7d
2020-12-05,AG,52,55,6,49,2022-05-03_11-02-08,fp7d
2020-12-05,AI,0,0,0,0,2022-05-03_11-02-08,fp7d
2020-12-05,AR,6,6,0,6,2022-05-03_11-02-08,fp7d
2020-12-05,BE,104,125,21,104,2022-05-03_11-02-08,fp7d
2020-12-05,BL,20,18,0,18,2022-05-03_11-02-08,fp7d
2020-12-05,BS,54,50,0,50,2022-05-03_11-02-08,fp7d
2020-12-05,FR,24,29,5,24,2022-05-03_11-02-08,fp7d
2020-12-05,GE,38,61,23,38,2022-05-03_11-02-08,fp7d
2020-12-05,GL,6,6,0,6,2022-05-03_11-02-08,fp7d
2020-12-05,GR,16,22,6,16,2022-05-03_11-02-08,fp7d
2020-12-05,JU,6,7,1,6,2022-05-03_11-02-08,fp7d
2020-12-05,LU,54,56,6,50,2022-05-03_11-02-08,fp7d
2020-12-05,NE,10,19,9,10,2022-05-03_11-02-08,fp7d
2020-12-05,NW,6,5,0,5,2022-05-03_11-02-08,fp7d
2020-12-05,OW,0,0,0,0,2022-05-03_11-02-08,fp7d
2020-12-05,SG,54,70,16,54,2022-05-03_11-02-08,fp7d
2020-12-05,SH,8,8,0,8,2022-05-03_11-02-08,fp7d
2020-12-05,SO,17,27,10,17,2022-05-03_11-02-08,fp7d
2020-12-05,SZ,12,10,0,10,2022-05-03_11-02-08,fp7d
2020-12-05,TG,21,35,14,21,2022-05-03_11-02-08,fp7d
2020-12-05,TI,53,82,35,47,2022-05-03_11-02-08,fp7d
2020-12-05,UR,6,6,0,6,2022-05-03_11-02-08,fp7d
2020-12-05,VD,85,151,66,85,2022-05-03_11-02-08,fp7d
2020-12-05,VS,20,31,11,20,2022-05-03_11-02-08,fp7d
2020-12-05,ZG,8,8,0,8,2022-05-03_11-02-08,fp7d
2020-12-05,ZH,190,218,31,187,2022-05-03_11-02-08,fp7d
2020-12-06,AG,52,54,6,48,2022-05-03_11-02-08,fp7d
2020-12-06,AI,0,0,0,0,2022-05-03_11-02-08,fp7d
2020-12-06,AR,6,6,0,6,2022-05-03_11-02-08,fp7d
2020-12-06,BE,104,123,19,104,2022-05-03_11-02-08,fp7d
2020-12-06,BL,20,18,0,18,2022-05-03_11-02-08,fp7d
2020-12-06,BS,54,50,0,50,2022-05-03_11-02-08,fp7d
2020-12-06,FR,24,29,5,24,2022-05-03_11-02-08,fp7d
2020-12-06,GE,38,61,23,38,2022-05-03_11-02-08,fp7d
2020-12-06,GL,6,6,0,6,2022-05-03_11-02-08,fp7d
2020-12-06,GR,16,22,6,16,2022-05-03_11-02-08,fp7d
2020-12-06,JU,6,7,1,6,2022-05-03_11-02-08,fp7d
2020-12-06,LU,54,56,6,50,2022-05-03_11-02-08,fp7d
2020-12-06,NE,10,19,9,10,2022-05-03_11-02-08,fp7d
2020-12-06,NW,6,5,0,5,2022-05-03_11-02-08,fp7d
2020-12-06,OW,0,0,0,0,2022-05-03_11-02-08,fp7d
2020-12-06,SG,54,70,16,54,2022-05-03_11-02-08,fp7d
2020-12-06,SH,8,8,0,8,2022-05-03_11-02-08,fp7d
2020-12-06,SO,17,27,10,17,2022-05-03_11-02-08,fp7d
2020-12-06,SZ,12,10,0,10,2022-05-03_11-02-08,fp7d
2020-12-06,TG,21,35,14,21,2022-05-03_11-02-08,fp7d
2020-12-06,TI,53,81,34,47,2022-05-03_11-02-08,fp7d
2020-12-06,UR,6,6,0,6,2022-05-03_11-02-08,fp7d
2020-12-06,VD,85,151,66,85,2022-05-03_11-02-08,fp7d
2020-12-06,VS,20,31,11,20,2022-05-03_11-02-08,fp7d
2020-12-06,ZG,8,8,0,8,2022-05-03_11-02-08,fp7d
2020-12-06,ZH,190,219,31,188,2022-05-03_11-02-08,fp7d
2020-12-07,AG,52,55,6,49,2022-05-03_11-02-08,fp7d
2020-12-07,AI,0,0,0,0,2022-05-03_11-02-08,fp7d
2020-12-07,AR,6,6,0,6,2022-05-03_11-02-08,fp7d
2020-12-07,BE,104,122,19,103,2022-05-03_11-02-08,fp7d
2020-12-07,BL,20,18,0,18,2022-05-03_11-02-08,fp7d
2020-12-07,BS,54,50,0,50,2022-05-03_11-02-08,fp7d
2020-12-07,FR,24,27,3,24,2022-05-03_11-02-08,fp7d
2020-12-07,GE,38,59,21,38,2022-05-03_11-02-08,fp7d
2020-12-07,GL,6,6,0,6,2022-05-03_11-02-08,fp7d
2020-12-07,GR,16,22,6,16,2022-05-03_11-02-08,fp7d
2020-12-07,JU,6,7,1,6,2022-05-03_11-02-08,fp7d
2020-12-07,LU,54,56,6,50,2022-05-03_11-02-08,fp7d
2020-12-07,NE,10,19,9,10,2022-05-03_11-02-08,fp7d
2020-12-07,NW,6,5,0,5,2022-05-03_11-02-08,fp7d
2020-12-07,OW,0,0,0,0,2022-05-03_11-02-08,fp7d
2020-12-07,SG,54,70,16,54,2022-05-03_11-02-08,fp7d
2020-12-07,SH,8,8,0,8,2022-05-03_11-02-08,fp7d
2020-12-07,SO,17,27,10,17,2022-05-03_11-02-08,fp7d
2020-12-07,SZ,12,10,0,10,2022-05-03_11-02-08,fp7d
2020-12-07,TG,21,35,14,21,2022-05-03_11-02-08,fp7d
2020-12-07,TI,53,82,35,47,2022-05-03_11-02-08,fp7d
2020-12-07,UR,6,6,0,6,2022-05-03_11-02-08,fp7d
2020-12-07,VD,85,151,66,85,2022-05-03_11-02-08,fp7d
2020-12-07,VS,20,31,11,20,2022-05-03_11-02-08,fp7d
2020-12-07,ZG,8,8,0,8,2022-05-03_11-02-08,fp7d
2020-12-07,ZH,190,219,31,188,2022-05-03_11-02-08,fp7d
2020-12-08,AG,52,55,6,49,2022-05-03_11-02-08,fp7d
2020-12-08,AI,0,0,0,0,2022-05-03_11-02-08,fp7d
2020-12-08,AR,6,6,0,6,2022-05-03_11-02-08,fp7d
2020-12-08,BE,104,122,18,104,2022-05-03_11-02-08,fp7d
2020-12-08,BL,20,18,0,18,2022-05-03_11-02-08,fp7d
2020-12-08,BS,54,50,0,50,2022-05-03_11-02-08,fp7d
2020-12-08,FR,24,27,3,24,2022-05-03_11-02-08,fp7d
2020-12-08,GE,38,59,21,38,2022-05-03_11-02-08,fp7d
2020-12-08,GL,6,6,0,6,2022-05-03_11-02-08,fp7d
2020-12-08,GR,16,22,6,16,2022-05-03_11-02-08,fp7d
2020-12-08,JU,6,7,1,6,2022-05-03_11-02-08,fp7d
2020-12-08,LU,54,56,6,50,2022-05-03_11-02-08,fp7d
2020-12-08,NE,10,15,5,10,2022-05-03_11-02-08,fp7d
2020-12-08,NW,6,5,0,5,2022-05-03_11-02-08,fp7d
2020-12-08,OW,0,0,0,0,2022-05-03_11-02-08,fp7d
2020-12-08,SG,54,70,16,54,2022-05-03_11-02-08,fp7d
2020-12-08,SH,8,8,0,8,2022-05-03_11-02-08,fp7d
2020-12-08,SO,17,27,10,17,2022-05-03_11-02-08,fp7d
2020-12-08,SZ,12,10,0,10,2022-05-03_11-02-08,fp7d
2020-12-08,TG,21,35,14,21,2022-05-03_11-02-08,fp7d
2020-12-08,TI,53,82,35,47,2022-05-03_11-02-08,fp7d
2020-12-08,UR,6,6,0,6,2022-05-03_11-02-08,fp7d
2020-12-08,VD,85,151,66,85,2022-05-03_11-02-08,fp7d
2020-12-08,VS,20,31,11,20,2022-05-03_11-02-08,fp7d
2020-12-08,ZG,8,8,0,8,2022-05-03_11-02-08,fp7d
2020-12-08,ZH,190,221,33,188,2022-05-03_11-02-08,fp7d
2020-12-09,AG,52,52,4,48,2022-05-03_11-02-08,fp7d
2020-12-09,AI,0,0,0,0,2022-05-03_11-02-08,fp7d
2020-12-09,AR,6,6,0,6,2022-05-03_11-02-08,fp7d
2020-12-09,BE,104,122,18,104,2022-05-03_11-02-08,fp7d
2020-12-09,BL,20,18,0,18,2022-05-03_11-02-08,fp7d
2020-12-09,BS,54,50,0,50,2022-05-03_11-02-08,fp7d
2020-12-09,FR,24,27,3,24,2022-05-03_11-02-08,fp7d
2020-12-09,GE,38,59,21,38,2022-05-03_11-02-08,fp7d
2020-12-09,GL,6,6,0,6,2022-05-03_11-02-08,fp7d
2020-12-09,GR,16,22,6,16,2022-05-03_11-02-08,fp7d
2020-12-09,JU,6,7,1,6,2022-05-03_11-02-08,fp7d
2020-12-09,LU,54,56,6,50,2022-05-03_11-02-08,fp7d
2020-12-09,NE,10,15,5,10,2022-05-03_11-02-08,fp7d
2020-12-09,NW,6,5,0,5,2022-05-03_11-02-08,fp7d
2020-12-09,OW,0,0,0,0,2022-05-03_11-02-08,fp7d
2020-12-09,SG,54,70,16,54,2022-05-03_11-02-08,fp7d
2020-12-09,SH,8,8,0,8,2022-05-03_11-02-08,fp7d
2020-12-09,SO,17,27,10,17,2022-05-03_11-02-08,fp7d
2020-12-09,SZ,12,9,0,9,2022-05-03_11-02-08,fp7d
2020-12-09,TG,21,35,14,21,2022-05-03_11-02-08,fp7d
2020-12-09,TI,53,82,35,47,2022-05-03_11-02-08,fp7d
2020-12-09,UR,6,6,0,6,2022-05-03_11-02-08,fp7d
2020-12-09,VD,85,151,66,85,2022-05-03_11-02-08,fp7d
2020-12-09,VS,20,29,9,20,2022-05-03_11-02-08,fp7d
2020-12-09,ZG,8,8,0,8,2022-05-03_11-02-08,fp7d
2020-12-09,ZH,190,220,32,188,2022-05-03_11-02-08,fp7d
2020-12-10,AG,52,53,4,49,2022-05-03_11-02-08,fp7d
2020-12-10,AI,0,0,0,0,2022-05-03_11-02-08,fp7d
2020-12-10,AR,6,6,0,6,2022-05-03_11-02-08,fp7d
2020-12-10,BE,104,122,18,104,2022-05-03_11-02-08,fp7d
2020-12-10,BL,20,18,0,18,2022-05-03_11-02-08,fp7d
2020-12-10,BS,54,50,0,50,2022-05-03_11-02-08,fp7d
2020-12-10,FR,24,27,3,24,2022-05-03_11-02-08,fp7d
2020-12-10,GE,38,59,21,38,2022-05-03_11-02-08,fp7d
2020-12-10,GL,6,5,0,5,2022-05-03_11-02-08,fp7d
2020-12-10,GR,16,22,6,16,2022-05-03_11-02-08,fp7d
2020-12-10,JU,6,7,1,6,2022-05-03_11-02-08,fp7d
2020-12-10,LU,54,56,6,50,2022-05-03_11-02-08,fp7d
2020-12-10,NE,10,15,5,10,2022-05-03_11-02-08,fp7d
2020-12-10,NW,6,6,0,6,2022-05-03_11-02-08,fp7d
2020-12-10,OW,0,0,0,0,2022-05-03_11-02-08,fp7d
2020-12-10,SG,54,70,16,54,2022-05-03_11-02-08,fp7d
2020-12-10,SH,8,8,0,8,2022-05-03_11-02-08,fp7d
2020-12-10,SO,17,27,10,17,2022-05-03_11-02-08,fp7d
2020-12-10,SZ,12,9,0,9,2022-05-03_11-02-08,fp7d
2020-12-10,TG,21,35,14,21,2022-05-03_11-02-08,fp7d
2020-12-10,TI,53,77,35,42,2022-05-03_11-02-08,fp7d
2020-12-10,UR,6,6,0,6,2022-05-03_11-02-08,fp7d
2020-12-10,VD,85,151,66,85,2022-05-03_11-02-08,fp7d
2020-12-10,VS,20,29,9,20,2022-05-03_11-02-08,fp7d
2020-12-10,ZG,8,8,0,8,2022-05-03_11-02-08,fp7d
2020-12-10,ZH,190,221,31,190,2022-05-03_11-02-08,fp7d
2020-12-11,AG,52,53,4,49,2022-05-03_11-02-08,fp7d
2020-12-11,AI,0,0,0,0,2022-05-03_11-02-08,fp7d
2020-12-11,AR,6,6,0,6,2022-05-03_11-02-08,fp7d
2020-12-11,BE,104,122,18,104,2022-05-03_11-02-08,fp7d
2020-12-11,BL,20,18,0,18,2022-05-03_11-02-08,fp7d
2020-12-11,BS,54,50,0,50,2022-05-03_11-02-08,fp7d
2020-12-11,FR,24,26,2,24,2022-05-03_11-02-08,fp7d
2020-12-11,GE,38,59,21,38,2022-05-03_11-02-08,fp7d
2020-12-11,GL,6,5,0,5,2022-05-03_11-02-08,fp7d
2020-12-11,GR,16,22,6,16,2022-05-03_11-02-08,fp7d
2020-12-11,JU,6,7,1,6,2022-05-03_11-02-08,fp7d
2020-12-11,LU,54,56,6,50,2022-05-03_11-02-08,fp7d
2020-12-11,NE,10,15,5,10,2022-05-03_11-02-08,fp7d
2020-12-11,NW,6,5,0,5,2022-05-03_11-02-08,fp7d
2020-12-11,OW,0,0,0,0,2022-05-03_11-02-08,fp7d
2020-12-11,SG,54,70,16,54,2022-05-03_11-02-08,fp7d
2020-12-11,SH,8,8,0,8,2022-05-03_11-02-08,fp7d
2020-12-11,SO,17,27,10,17,2022-05-03_11-02-08,fp7d
2020-12-11,SZ,12,9,0,9,2022-05-03_11-02-08,fp7d
2020-12-11,TG,21,36,15,21,2022-05-03_11-02-08,fp7d
2020-12-11,TI,53,76,35,41,2022-05-03_11-02-08,fp7d
2020-12-11,UR,6,6,0,6,2022-05-03_11-02-08,fp7d
2020-12-11,VD,79,145,66,79,2022-05-03_11-02-08,fp7d
2020-12-11,VS,20,28,8,20,2022-05-03_11-02-08,fp7d
2020-12-11,ZG,8,8,0,8,2022-05-03_11-02-08,fp7d
2020-12-11,ZH,190,222,32,190,2022-05-03_11-02-08,fp7d
2020-12-12,AG,52,53,4,49,2022-05-03_11-02-08,fp7d
2020-12-12,AI,0,0,0,0,2022-05-03_11-02-08,fp7d
2020-12-12,AR,6,6,0,6,2022-05-03_11-02-08,fp7d
2020-12-12,BE,104,121,18,103,2022-05-03_11-02-08,fp7d
2020-12-12,BL,20,18,0,18,2022-05-03_11-02-08,fp7d
2020-12-12,BS,54,50,0,50,2022-05-03_11-02-08,fp7d
2020-12-12,FR,24,26,2,24,2022-05-03_11-02-08,fp7d
2020-12-12,GE,38,59,21,38,2022-05-03_11-02-08,fp7d
2020-12-12,GL,6,6,0,6,2022-05-03_11-02-08,fp7d
2020-12-12,GR,16,22,6,16,2022-05-03_11-02-08,fp7d
2020-12-12,JU,6,7,1,6,2022-05-03_11-02-08,fp7d
2020-12-12,LU,54,56,6,50,2022-05-03_11-02-08,fp7d
2020-12-12,NE,10,15,5,10,2022-05-03_11-02-08,fp7d
2020-12-12,NW,6,5,0,5,2022-05-03_11-02-08,fp7d
2020-12-12,OW,0,0,0,0,2022-05-03_11-02-08,fp7d
2020-12-12,SG,54,70,16,54,2022-05-03_11-02-08,fp7d
2020-12-12,SH,8,8,0,8,2022-05-03_11-02-08,fp7d
2020-12-12,SO,17,27,10,17,2022-05-03_11-02-08,fp7d
2020-12-12,SZ,12,9,0,9,2022-05-03_11-02-08,fp7d
2020-12-12,TG,21,36,15,21,2022-05-03_11-02-08,fp7d
2020-12-12,TI,53,82,35,47,2022-05-03_11-02-08,fp7d
2020-12-12,UR,6,6,0,6,2022-05-03_11-02-08,fp7d
2020-12-12,VD,79,145,66,79,2022-05-03_11-02-08,fp7d
2020-12-12,VS,20,28,8,20,2022-05-03_11-02-08,fp7d
2020-12-12,ZG,8,8,0,8,2022-05-03_11-02-08,fp7d
2020-12-12,ZH,190,219,31,188,2022-05-03_11-02-08,fp7d
2020-12-13,AG,52,53,4,49,2022-05-03_11-02-08,fp7d
2020-12-13,AI,0,0,0,0,2022-05-03_11-02-08,fp7d
2020-12-13,AR,6,6,0,6,2022-05-03_11-02-08,fp7d
2020-12-13,BE,104,118,16,102,2022-05-03_11-02-08,fp7d
2020-12-13,BL,20,18,0,18,2022-05-03_11-02-08,fp7d
2020-12-13,BS,54,50,0,50,2022-05-03_11-02-08,fp7d
2020-12-13,FR,24,26,2,24,2022-05-03_11-02-08,fp7d
2020-12-13,GE,38,59,21,38,2022-05-03_11-02-08,fp7d
2020-12-13,GL,6,6,0,6,2022-05-03_11-02-08,fp7d
2020-12-13,GR,16,22,6,16,2022-05-03_11-02-08,fp7d
2020-12-13,JU,6,7,1,6,2022-05-03_11-02-08,fp7d
2020-12-13,LU,54,56,6,50,2022-05-03_11-02-08,fp7d
2020-12-13,NE,10,15,5,10,2022-05-03_11-02-08,fp7d
2020-12-13,NW,6,5,0,5,2022-05-03_11-02-08,fp7d
2020-12-13,OW,0,0,0,0,2022-05-03_11-02-08,fp7d
2020-12-13,SG,54,70,16,54,2022-05-03_11-02-08,fp7d
2020-12-13,SH,8,8,0,8,2022-05-03_11-02-08,fp7d
2020-12-13,SO,17,27,10,17,2022-05-03_11-02-08,fp7d
2020-12-13,SZ,12,9,0,9,2022-05-03_11-02-08,fp7d
2020-12-13,TG,21,36,15,21,2022-05-03_11-02-08,fp7d
2020-12-13,TI,53,81,34,47,2022-05-03_11-02-08,fp7d
2020-12-13,UR,6,6,0,6,2022-05-03_11-02-08,fp7d
2020-12-13,VD,79,145,66,79,2022-05-03_11-02-08,fp7d
2020-12-13,VS,20,28,8,20,2022-05-03_11-02-08,fp7d
2020-12-13,ZG,8,8,0,8,2022-05-03_11-02-08,fp7d
2020-12-13,ZH,190,219,31,188,2022-05-03_11-02-08,fp7d
2020-12-14,AG,52,52,4,48,2022-05-03_11-02-08,fp7d
2020-12-14,AI,0,0,0,0,2022-05-03_11-02-08,fp7d
2020-12-14,AR,6,6,0,6,2022-05-03_11-02-08,fp7d
2020-12-14,BE,104,119,16,103,2022-05-03_11-02-08,fp7d
2020-12-14,BL,20,18,0,18,2022-05-03_11-02-08,fp7d
2020-12-14,BS,54,51,1,50,2022-05-03_11-02-08,fp7d
2020-12-14,FR,24,26,2,24,2022-05-03_11-02-08,fp7d
2020-12-14,GE,38,59,21,38,2022-05-03_11-02-08,fp7d
2020-12-14,GL,6,6,0,6,2022-05-03_11-02-08,fp7d
2020-12-14,GR,16,22,6,16,2022-05-03_11-02-08,fp7d
2020-12-14,JU,6,7,1,6,2022-05-03_11-02-08,fp7d
2020-12-14,LU,54,56,6,50,2022-05-03_11-02-08,fp7d
2020-12-14,NE,10,13,3,10,2022-05-03_11-02-08,fp7d
2020-12-14,NW,6,5,0,5,2022-05-03_11-02-08,fp7d
2020-12-14,OW,0,0,0,0,2022-05-03_11-02-08,fp7d
2020-12-14,SG,54,70,16,54,2022-05-03_11-02-08,fp7d
2020-12-14,SH,8,8,0,8,2022-05-03_11-02-08,fp7d
2020-12-14,SO,17,27,10,17,2022-05-03_11-02-08,fp7d
2020-12-14,SZ,12,9,0,9,2022-05-03_11-02-08,fp7d
2020-12-14,TG,21,36,15,21,2022-05-03_11-02-08,fp7d
2020-12-14,TI,53,81,34,47,2022-05-03_11-02-08,fp7d
2020-12-14,UR,6,6,0,6,2022-05-03_11-02-08,fp7d
2020-12-14,VD,79,139,60,79,2022-05-03_11-02-08,fp7d
2020-12-14,VS,20,28,8,20,2022-05-03_11-02-08,fp7d
2020-12-14,ZG,8,7,0,7,2022-05-03_11-02-08,fp7d
2020-12-14,ZH,190,219,31,188,2022-05-03_11-02-08,fp7d
2020-12-15,AG,52,53,4,49,2022-05-03_11-02-08,fp7d
2020-12-15,AI,0,0,0,0,2022-05-03_11-02-08,fp7d
2020-12-15,AR,6,6,0,6,2022-05-03_11-02-08,fp7d
2020-12-15,BE,104,119,16,103,2022-05-03_11-02-08,fp7d
2020-12-15,BL,20,18,0,18,2022-05-03_11-02-08,fp7d
2020-12-15,BS,54,51,1,50,2022-05-03_11-02-08,fp7d
2020-12-15,FR,24,24,0,24,2022-05-03_11-02-08,fp7d
2020-12-15,GE,38,64,26,38,2022-05-03_11-02-08,fp7d
2020-12-15,GL,6,6,0,6,2022-05-03_11-02-08,fp7d
2020-12-15,GR,16,22,6,16,2022-05-03_11-02-08,fp7d
2020-12-15,JU,6,7,1,6,2022-05-03_11-02-08,fp7d
2020-12-15,LU,54,56,6,50,2022-05-03_11-02-08,fp7d
2020-12-15,NE,10,13,3,10,2022-05-03_11-02-08,fp7d
2020-12-15,NW,6,5,0,5,2022-05-03_11-02-08,fp7d
2020-12-15,OW,0,0,0,0,2022-05-03_11-02-08,fp7d
2020-12-15,SG,54,70,16,54,2022-05-03_11-02-08,fp7d
2020-12-15,SH,8,8,0,8,2022-05-03_11-02-08,fp7d
2020-12-15,SO,17,25,8,17,2022-05-03_11-02-08,fp7d
2020-12-15,SZ,12,9,0,9,2022-05-03_11-02-08,fp7d
2020-12-15,TG,21,40,19,21,2022-05-03_11-02-08,fp7d
2020-12-15,TI,53,82,35,47,2022-05-03_11-02-08,fp7d
2020-12-15,UR,6,6,0,6,2022-05-03_11-02-08,fp7d
2020-12-15,VD,85,145,60,85,2022-05-03_11-02-08,fp7d
2020-12-15,VS,20,28,8,20,2022-05-03_11-02-08,fp7d
2020-12-15,ZG,8,7,0,7,2022-05-03_11-02-08,fp7d
2020-12-15,ZH,190,218,31,187,2022-05-03_11-02-08,fp7d
2020-12-16,AG,52,53,4,49,2022-05-03_11-02-08,fp7d
2020-12-16,AI,0,0,0,0,2022-05-03_11-02-08,fp7d
2020-12-16,AR,6,6,0,6,2022-05-03_11-02-08,fp7d
2020-12-16,BE,104,119,16,103,2022-05-03_11-02-08,fp7d
2020-12-16,BL,20,18,0,18,2022-05-03_11-02-08,fp7d
2020-12-16,BS,54,51,1,50,2022-05-03_11-02-08,fp7d
2020-12-16,FR,24,24,0,24,2022-05-03_11-02-08,fp7d
2020-12-16,GE,38,64,26,38,2022-05-03_11-02-08,fp7d
2020-12-16,GL,6,6,0,6,2022-05-03_11-02-08,fp7d
2020-12-16,GR,16,22,6,16,2022-05-03_11-02-08,fp7d
2020-12-16,JU,6,7,1,6,2022-05-03_11-02-08,fp7d
2020-12-16,LU,54,56,6,50,2022-05-03_11-02-08,fp7d
2020-12-16,NE,10,13,3,10,2022-05-03_11-02-08,fp7d
2020-12-16,NW,6,5,0,5,2022-05-03_11-02-08,fp7d
2020-12-16,OW,0,0,0,0,2022-05-03_11-02-08,fp7d
2020-12-16,SG,54,70,16,54,2022-05-03_11-02-08,fp7d
2020-12-16,SH,8,8,0,8,2022-05-03_11-02-08,fp7d
2020-12-16,SO,17,25,8,17,2022-05-03_11-02-08,fp7d
2020-12-16,SZ,12,10,0,10,2022-05-03_11-02-08,fp7d
2020-12-16,TG,21,40,19,21,2022-05-03_11-02-08,fp7d
2020-12-16,TI,53,82,35,47,2022-05-03_11-02-08,fp7d
2020-12-16,UR,6,6,0,6,2022-05-03_11-02-08,fp7d
2020-12-16,VD,85,145,60,85,2022-05-03_11-02-08,fp7d
2020-12-16,VS,20,28,8,20,2022-05-03_11-02-08,fp7d
2020-12-16,ZG,8,7,0,7,2022-05-03_11-02-08,fp7d
2020-12-16,ZH,190,219,31,188,2022-05-03_11-02-08,fp7d
2020-12-17,AG,52,53,4,49,2022-05-03_11-02-08,fp7d
2020-12-17,AI,0,0,0,0,2022-05-03_11-02-08,fp7d
2020-12-17,AR,6,6,0,6,2022-05-03_11-02-08,fp7d
2020-12-17,BE,104,119,16,103,2022-05-03_11-02-08,fp7d
2020-12-17,BL,20,18,0,18,2022-05-03_11-02-08,fp7d
2020-12-17,BS,54,51,1,50,2022-05-03_11-02-08,fp7d
2020-12-17,FR,24,24,0,24,2022-05-03_11-02-08,fp7d
2020-12-17,GE,38,64,26,38,2022-05-03_11-02-08,fp7d
2020-12-17,GL,6,6,0,6,2022-05-03_11-02-08,fp7d
2020-12-17,GR,16,22,6,16,2022-05-03_11-02-08,fp7d
2020-12-17,JU,6,7,1,6,2022-05-03_11-02-08,fp7d
2020-12-17,LU,54,56,6,50,2022-05-03_11-02-08,fp7d
2020-12-17,NE,10,13,3,10,2022-05-03_11-02-08,fp7d
2020-12-17,NW,6,6,0,6,2022-05-03_11-02-08,fp7d
2020-12-17,OW,0,0,0,0,2022-05-03_11-02-08,fp7d
2020-12-17,SG,54,70,16,54,2022-05-03_11-02-08,fp7d
2020-12-17,SH,8,8,0,8,2022-05-03_11-02-08,fp7d
2020-12-17,SO,17,25,8,17,2022-05-03_11-02-08,fp7d
2020-12-17,SZ,12,9,0,9,2022-05-03_11-02-08,fp7d
2020-12-17,TG,21,40,19,21,2022-05-03_11-02-08,fp7d
2020-12-17,TI,53,80,33,47,2022-05-03_11-02-08,fp7d
2020-12-17,UR,6,6,0,6,2022-05-03_11-02-08,fp7d
2020-12-17,VD,85,142,57,85,2022-05-03_11-02-08,fp7d
2020-12-17,VS,20,29,9,20,2022-05-03_11-02-08,fp7d
2020-12-17,ZG,8,7,0,7,2022-05-03_11-02-08,fp7d
2020-12-17,ZH,190,218,30,188,2022-05-03_11-02-08,fp7d
2020-12-18,AG,52,55,5,50,2022-05-03_11-02-08,fp7d
2020-12-18,AI,0,0,0,0,2022-05-03_11-02-08,fp7d
2020-12-18,AR,6,6,0,6,2022-05-03_11-02-08,fp7d
2020-12-18,BE,104,119,16,103,2022-05-03_11-02-08,fp7d
2020-12-18,BL,20,18,0,18,2022-05-03_11-02-08,fp7d
2020-12-18,BS,54,50,0,50,2022-05-03_11-02-08,fp7d
2020-12-18,FR,24,24,0,24,2022-05-03_11-02-08,fp7d
2020-12-18,GE,38,64,26,38,2022-05-03_11-02-08,fp7d
2020-12-18,GL,6,6,0,6,2022-05-03_11-02-08,fp7d
2020-12-18,GR,16,22,6,16,2022-05-03_11-02-08,fp7d
2020-12-18,JU,6,7,1,6,2022-05-03_11-02-08,fp7d
2020-12-18,LU,54,56,6,50,2022-05-03_11-02-08,fp7d
2020-12-18,NE,10,13,3,10,2022-05-03_11-02-08,fp7d
2020-12-18,NW,6,6,0,6,2022-05-03_11-02-08,fp7d
2020-12-18,OW,0,0,0,0,2022-05-03_11-02-08,fp7d
2020-12-18,SG,54,70,16,54,2022-05-03_11-02-08,fp7d
2020-12-18,SH,8,8,0,8,2022-05-03_11-02-08,fp7d
2020-12-18,SO,17,25,8,17,2022-05-03_11-02-08,fp7d
2020-12-18,SZ,12,9,0,9,2022-05-03_11-02-08,fp7d
2020-12-18,TG,21,40,19,21,2022-05-03_11-02-08,fp7d
2020-12-18,TI,53,72,33,39,2022-05-03_11-02-08,fp7d
2020-12-18,UR,6,6,0,6,2022-05-03_11-02-08,fp7d
2020-12-18,VD,85,142,57,85,2022-05-03_11-02-08,fp7d
2020-12-18,VS,20,29,9,20,2022-05-03_11-02-08,fp7d
2020-12-18,ZG,8,7,0,7,2022-05-03_11-02-08,fp7d
2020-12-18,ZH,190,217,29,188,2022-05-03_11-02-08,fp7d
2020-12-19,AG,52,57,9,48,2022-05-03_11-02-08,fp7d
2020-12-19,AI,0,0,0,0,2022-05-03_11-02-08,fp7d
2020-12-19,AR,6,6,0,6,2022-05-03_11-02-08,fp7d
2020-12-19,BE,104,118,16,102,2022-05-03_11-02-08,fp7d
2020-12-19,BL,20,18,0,18,2022-05-03_11-02-08,fp7d
2020-12-19,BS,54,50,0,50,2022-05-03_11-02-08,fp7d
2020-12-19,FR,24,24,0,24,2022-05-03_11-02-08,fp7d
2020-12-19,GE,38,64,26,38,2022-05-03_11-02-08,fp7d
2020-12-19,GL,6,6,0,6,2022-05-03_11-02-08,fp7d
2020-12-19,GR,16,22,6,16,2022-05-03_11-02-08,fp7d
2020-12-19,JU,6,7,1,6,2022-05-03_11-02-08,fp7d
2020-12-19,LU,54,56,6,50,2022-05-03_11-02-08,fp7d
2020-12-19,NE,10,13,3,10,2022-05-03_11-02-08,fp7d
2020-12-19,NW,6,6,0,6,2022-05-03_11-02-08,fp7d
2020-12-19,OW,0,0,0,0,2022-05-03_11-02-08,fp7d
2020-12-19,SG,54,70,16,54,2022-05-03_11-02-08,fp7d
2020-12-19,SH,8,8,0,8,2022-05-03_11-02-08,fp7d
2020-12-19,SO,17,25,8,17,2022-05-03_11-02-08,fp7d
2020-12-19,SZ,12,9,0,9,2022-05-03_11-02-08,fp7d
2020-12-19,TG,21,40,19,21,2022-05-03_11-02-08,fp7d
2020-12-19,TI,53,72,33,39,2022-05-03_11-02-08,fp7d
2020-12-19,UR,6,6,0,6,2022-05-03_11-02-08,fp7d
2020-12-19,VD,85,140,55,85,2022-05-03_11-02-08,fp7d
2020-12-19,VS,20,29,9,20,2022-05-03_11-02-08,fp7d
2020-12-19,ZG,8,5,0,5,2022-05-03_11-02-08,fp7d
2020-12-19,ZH,190,217,29,188,2022-05-03_11-02-08,fp7d
2020-12-20,AG,52,57,9,48,2022-05-03_11-02-08,fp7d
2020-12-20,AI,0,0,0,0,2022-05-03_11-02-08,fp7d
2020-12-20,AR,6,6,0,6,2022-05-03_11-02-08,fp7d
2020-12-20,BE,104,118,16,102,2022-05-03_11-02-08,fp7d
2020-12-20,BL,20,18,0,18,2022-05-03_11-02-08,fp7d
2020-12-20,BS,54,50,0,50,2022-05-03_11-02-08,fp7d
2020-12-20,FR,24,24,0,24,2022-05-03_11-02-08,fp7d
2020-12-20,GE,38,64,26,38,2022-05-03_11-02-08,fp7d
2020-12-20,GL,6,6,0,6,2022-05-03_11-02-08,fp7d
2020-12-20,GR,16,22,6,16,2022-05-03_11-02-08,fp7d
2020-12-20,JU,6,7,1,6,2022-05-03_11-02-08,fp7d
2020-12-20,LU,54,56,6,50,2022-05-03_11-02-08,fp7d
2020-12-20,NE,10,13,3,10,2022-05-03_11-02-08,fp7d
2020-12-20,NW,6,6,0,6,2022-05-03_11-02-08,fp7d
2020-12-20,OW,0,0,0,0,2022-05-03_11-02-08,fp7d
2020-12-20,SG,54,70,16,54,2022-05-03_11-02-08,fp7d
2020-12-20,SH,8,8,0,8,2022-05-03_11-02-08,fp7d
2020-12-20,SO,17,25,8,17,2022-05-03_11-02-08,fp7d
2020-12-20,SZ,12,9,0,9,2022-05-03_11-02-08,fp7d
2020-12-20,TG,21,40,19,21,2022-05-03_11-02-08,fp7d
2020-12-20,TI,53,70,33,37,2022-05-03_11-02-08,fp7d
2020-12-20,UR,6,6,0,6,2022-05-03_11-02-08,fp7d
2020-12-20,VD,85,140,55,85,2022-05-03_11-02-08,fp7d
2020-12-20,VS,20,29,9,20,2022-05-03_11-02-08,fp7d
2020-12-20,ZG,8,5,0,5,2022-05-03_11-02-08,fp7d
2020-12-20,ZH,190,217,29,188,2022-05-03_11-02-08,fp7d
2020-12-21,AG,52,59,9,50,2022-05-03_11-02-08,fp7d
2020-12-21,AI,0,0,0,0,2022-05-03_11-02-08,fp7d
2020-12-21,AR,6,6,0,6,2022-05-03_11-02-08,fp7d
2020-12-21,BE,104,115,14,101,2022-05-03_11-02-08,fp7d
2020-12-21,BL,20,18,0,18,2022-05-03_11-02-08,fp7d
2020-12-21,BS,54,50,0,50,2022-05-03_11-02-08,fp7d
2020-12-21,FR,24,24,0,24,2022-05-03_11-02-08,fp7d
2020-12-21,GE,38,64,26,38,2022-05-03_11-02-08,fp7d
2020-12-21,GL,6,6,0,6,2022-05-03_11-02-08,fp7d
2020-12-21,GR,16,22,6,16,2022-05-03_11-02-08,fp7d
2020-12-21,JU,6,6,0,6,2022-05-03_11-02-08,fp7d
2020-12-21,LU,54,56,6,50,2022-05-03_11-02-08,fp7d
2020-12-21,NE,10,13,3,10,2022-05-03_11-02-08,fp7d
2020-12-21,NW,6,6,0,6,2022-05-03_11-02-08,fp7d
2020-12-21,OW,0,0,0,0,2022-05-03_11-02-08,fp7d
2020-12-21,SG,54,70,16,54,2022-05-03_11-02-08,fp7d
2020-12-21,SH,8,8,0,8,2022-05-03_11-02-08,fp7d
2020-12-21,SO,17,25,8,17,2022-05-03_11-02-08,fp7d
2020-12-21,SZ,12,9,0,9,2022-05-03_11-02-08,fp7d
2020-12-21,TG,21,40,19,21,2022-05-03_11-02-08,fp7d
2020-12-21,TI,53,70,33,37,2022-05-03_11-02-08,fp7d
2020-12-21,UR,6,6,0,6,2022-05-03_11-02-08,fp7d
2020-12-21,VD,85,140,55,85,2022-05-03_11-02-08,fp7d
2020-12-21,VS,20,27,7,20,2022-05-03_11-02-08,fp7d
2020-12-21,ZG,8,8,0,8,2022-05-03_11-02-08,fp7d
2020-12-21,ZH,190,217,29,188,2022-05-03_11-02-08,fp7d
2020-12-22,AG,52,57,9,48,2022-05-03_11-02-08,fp7d
2020-12-22,AI,0,0,0,0,2022-05-03_11-02-08,fp7d
2020-12-22,AR,6,6,0,6,2022-05-03_11-02-08,fp7d
2020-12-22,BE,104,111,12,99,2022-05-03_11-02-08,fp7d
2020-12-22,BL,20,18,0,18,2022-05-03_11-02-08,fp7d
2020-12-22,BS,54,50,0,50,2022-05-03_11-02-08,fp7d
2020-12-22,FR,24,24,0,24,2022-05-03_11-02-08,fp7d
2020-12-22,GE,38,64,26,38,2022-05-03_11-02-08,fp7d
2020-12-22,GL,6,6,0,6,2022-05-03_11-02-08,fp7d
2020-12-22,GR,16,18,2,16,2022-05-03_11-02-08,fp7d
2020-12-22,JU,6,6,0,6,2022-05-03_11-02-08,fp7d
2020-12-22,LU,54,56,6,50,2022-05-03_11-02-08,fp7d
2020-12-22,NE,10,13,3,10,2022-05-03_11-02-08,fp7d
2020-12-22,NW,6,6,0,6,2022-05-03_11-02-08,fp7d
2020-12-22,OW,0,0,0,0,2022-05-03_11-02-08,fp7d
2020-12-22,SG,54,70,16,54,2022-05-03_11-02-08,fp7d
2020-12-22,SH,8,8,0,8,2022-05-03_11-02-08,fp7d
2020-12-22,SO,17,25,8,17,2022-05-03_11-02-08,fp7d
2020-12-22,SZ,12,9,0,9,2022-05-03_11-02-08,fp7d
2020-12-22,TG,21,40,19,21,2022-05-03_11-02-08,fp7d
2020-12-22,TI,53,72,33,39,2022-05-03_11-02-08,fp7d
2020-12-22,UR,6,6,0,6,2022-05-03_11-02-08,fp7d
2020-12-22,VD,85,132,47,85,2022-05-03_11-02-08,fp7d
2020-12-22,VS,20,27,7,20,2022-05-03_11-02-08,fp7d
2020-12-22,ZG,8,8,0,8,2022-05-03_11-02-08,fp7d
2020-12-22,ZH,190,216,29,187,2022-05-03_11-02-08,fp7d
2020-12-23,AG,52,60,10,50,2022-05-03_11-02-08,fp7d
2020-12-23,AI,0,0,0,0,2022-05-03_11-02-08,fp7d
2020-12-23,AR,6,6,0,6,2022-05-03_11-02-08,fp7d
2020-12-23,BE,104,109,12,97,2022-05-03_11-02-08,fp7d
2020-12-23,BL,20,18,0,18,2022-05-03_11-02-08,fp7d
2020-12-23,BS,54,50,0,50,2022-05-03_11-02-08,fp7d
2020-12-23,FR,24,24,0,24,2022-05-03_11-02-08,fp7d
2020-12-23,GE,38,64,26,38,2022-05-03_11-02-08,fp7d
2020-12-23,GL,6,6,0,6,2022-05-03_11-02-08,fp7d
2020-12-23,GR,16,18,2,16,2022-05-03_11-02-08,fp7d
2020-12-23,JU,6,6,0,6,2022-05-03_11-02-08,fp7d
2020-12-23,LU,54,56,6,50,2022-05-03_11-02-08,fp7d
2020-12-23,NE,10,12,2,10,2022-05-03_11-02-08,fp7d
2020-12-23,NW,6,6,0,6,2022-05-03_11-02-08,fp7d
2020-12-23,OW,0,0,0,0,2022-05-03_11-02-08,fp7d
2020-12-23,SG,54,64,10,54,2022-05-03_11-02-08,fp7d
2020-12-23,SH,8,8,0,8,2022-05-03_11-02-08,fp7d
2020-12-23,SO,17,25,8,17,2022-05-03_11-02-08,fp7d
2020-12-23,SZ,12,9,0,9,2022-05-03_11-02-08,fp7d
2020-12-23,TG,21,40,19,21,2022-05-03_11-02-08,fp7d
2020-12-23,TI,53,72,33,39,2022-05-03_11-02-08,fp7d
2020-12-23,UR,6,6,0,6,2022-05-03_11-02-08,fp7d
2020-12-23,VD,85,132,47,85,2022-05-03_11-02-08,fp7d
2020-12-23,VS,20,27,7,20,2022-05-03_11-02-08,fp7d
2020-12-23,ZG,8,8,0,8,2022-05-03_11-02-08,fp7d
2020-12-23,ZH,190,217,29,188,2022-05-03_11-02-08,fp7d
2020-12-24,AG,52,60,10,50,2022-05-03_11-02-08,fp7d
2020-12-24,AI,0,0,0,0,2022-05-03_11-02-08,fp7d
2020-12-24,AR,6,6,0,6,2022-05-03_11-02-08,fp7d
2020-12-24,BE,104,109,12,97,2022-05-03_11-02-08,fp7d
2020-12-24,BL,20,18,0,18,2022-05-03_11-02-08,fp7d
2020-12-24,BS,54,50,0,50,2022-05-03_11-02-08,fp7d
2020-12-24,FR,24,24,0,24,2022-05-03_11-02-08,fp7d
2020-12-24,GE,38,64,26,38,2022-05-03_11-02-08,fp7d
2020-12-24,GL,6,5,0,5,2022-05-03_11-02-08,fp7d
2020-12-24,GR,16,18,2,16,2022-05-03_11-02-08,fp7d
2020-12-24,JU,6,6,0,6,2022-05-03_11-02-08,fp7d
2020-12-24,LU,54,56,6,50,2022-05-03_11-02-08,fp7d
2020-12-24,NE,10,12,2,10,2022-05-03_11-02-08,fp7d
2020-12-24,NW,6,6,0,6,2022-05-03_11-02-08,fp7d
2020-12-24,OW,0,0,0,0,2022-05-03_11-02-08,fp7d
2020-12-24,SG,54,64,10,54,2022-05-03_11-02-08,fp7d
2020-12-24,SH,8,8,0,8,2022-05-03_11-02-08,fp7d
2020-12-24,SO,17,25,8,17,2022-05-03_11-02-08,fp7d
2020-12-24,SZ,12,9,0,9,2022-05-03_11-02-08,fp7d
2020-12-24,TG,21,40,19,21,2022-05-03_11-02-08,fp7d
2020-12-24,TI,53,71,33,38,2022-05-03_11-02-08,fp7d
2020-12-24,UR,6,6,0,6,2022-05-03_11-02-08,fp7d
2020-12-24,VD,85,132,47,85,2022-05-03_11-02-08,fp7d
2020-12-24,VS,20,27,7,20,2022-05-03_11-02-08,fp7d
2020-12-24,ZG,8,8,0,8,2022-05-03_11-02-08,fp7d
2020-12-24,ZH,190,217,29,188,2022-05-03_11-02-08,fp7d
2020-12-25,AG,52,60,10,50,2022-05-03_11-02-08,fp7d
2020-12-25,AI,0,0,0,0,2022-05-03_11-02-08,fp7d
2020-12-25,AR,6,6,0,6,2022-05-03_11-02-08,fp7d
2020-12-25,BE,104,109,12,97,2022-05-03_11-02-08,fp7d
2020-12-25,BL,20,18,0,18,2022-05-03_11-02-08,fp7d
2020-12-25,BS,54,50,0,50,2022-05-03_11-02-08,fp7d
2020-12-25,FR,24,24,0,24,2022-05-03_11-02-08,fp7d
2020-12-25,GE,38,64,26,38,2022-05-03_11-02-08,fp7d
2020-12-25,GL,6,5,0,5,2022-05-03_11-02-08,fp7d
2020-12-25,GR,16,18,2,16,2022-05-03_11-02-08,fp7d
2020-12-25,JU,6,6,0,6,2022-05-03_11-02-08,fp7d
2020-12-25,LU,40,46,6,40,2022-05-03_11-02-08,fp7d
2020-12-25,NE,10,12,2,10,2022-05-03_11-02-08,fp7d
2020-12-25,NW,6,6,0,6,2022-05-03_11-02-08,fp7d
2020-12-25,OW,0,0,0,0,2022-05-03_11-02-08,fp7d
2020-12-25,SG,54,61,7,54,2022-05-03_11-02-08,fp7d
2020-12-25,SH,8,8,0,8,2022-05-03_11-02-08,fp7d
2020-12-25,SO,17,25,8,17,2022-05-03_11-02-08,fp7d
2020-12-25,SZ,12,9,0,9,2022-05-03_11-02-08,fp7d
2020-12-25,TG,21,40,19,21,2022-05-03_11-02-08,fp7d
2020-12-25,TI,53,70,33,37,2022-05-03_11-02-08,fp7d
2020-12-25,UR,6,6,0,6,2022-05-03_11-02-08,fp7d
2020-12-25,VD,85,132,47,85,2022-05-03_11-02-08,fp7d
2020-12-25,VS,20,27,7,20,2022-05-03_11-02-08,fp7d
2020-12-25,ZG,8,8,0,8,2022-05-03_11-02-08,fp7d
2020-12-25,ZH,190,217,29,188,2022-05-03_11-02-08,fp7d
2020-12-26,AG,52,60,10,50,2022-05-03_11-02-08,fp7d
2020-12-26,AI,0,0,0,0,2022-05-03_11-02-08,fp7d
2020-12-26,AR,6,6,0,6,2022-05-03_11-02-08,fp7d
2020-12-26,BE,104,107,12,95,2022-05-03_11-02-08,fp7d
2020-12-26,BL,20,18,0,18,2022-05-03_11-02-08,fp7d
2020-12-26,BS,54,50,0,50,2022-05-03_11-02-08,fp7d
2020-12-26,FR,24,24,0,24,2022-05-03_11-02-08,fp7d
2020-12-26,GE,38,64,26,38,2022-05-03_11-02-08,fp7d
2020-12-26,GL,6,5,0,5,2022-05-03_11-02-08,fp7d
2020-12-26,GR,16,18,2,16,2022-05-03_11-02-08,fp7d
2020-12-26,JU,6,6,0,6,2022-05-03_11-02-08,fp7d
2020-12-26,LU,40,46,6,40,2022-05-03_11-02-08,fp7d
2020-12-26,NE,10,12,2,10,2022-05-03_11-02-08,fp7d
2020-12-26,NW,6,6,0,6,2022-05-03_11-02-08,fp7d
2020-12-26,OW,0,0,0,0,2022-05-03_11-02-08,fp7d
2020-12-26,SG,54,61,7,54,2022-05-03_11-02-08,fp7d
2020-12-26,SH,8,8,0,8,2022-05-03_11-02-08,fp7d
2020-12-26,SO,17,25,8,17,2022-05-03_11-02-08,fp7d
2020-12-26,SZ,12,9,0,9,2022-05-03_11-02-08,fp7d
2020-12-26,TG,21,40,19,21,2022-05-03_11-02-08,fp7d
2020-12-26,TI,53,70,33,37,2022-05-03_11-02-08,fp7d
2020-12-26,UR,6,6,0,6,2022-05-03_11-02-08,fp7d
2020-12-26,VD,85,132,47,85,2022-05-03_11-02-08,fp7d
2020-12-26,VS,20,27,7,20,2022-05-03_11-02-08,fp7d
2020-12-26,ZG,8,8,0,8,2022-05-03_11-02-08,fp7d
2020-12-26,ZH,190,217,29,188,2022-05-03_11-02-08,fp7d
2020-12-27,AG,52,60,10,50,2022-05-03_11-02-08,fp7d
2020-12-27,AI,0,0,0,0,2022-05-03_11-02-08,fp7d
2020-12-27,AR,6,6,0,6,2022-05-03_11-02-08,fp7d
2020-12-27,BE,104,107,12,95,2022-05-03_11-02-08,fp7d
2020-12-27,BL,20,18,0,18,2022-05-03_11-02-08,fp7d
2020-12-27,BS,54,50,0,50,2022-05-03_11-02-08,fp7d
2020-12-27,FR,24,24,0,24,2022-05-03_11-02-08,fp7d
2020-12-27,GE,38,64,26,38,2022-05-03_11-02-08,fp7d
2020-12-27,GL,6,4,0,4,2022-05-03_11-02-08,fp7d
2020-12-27,GR,16,18,2,16,2022-05-03_11-02-08,fp7d
2020-12-27,JU,6,6,0,6,2022-05-03_11-02-08,fp7d
2020-12-27,LU,40,46,6,40,2022-05-03_11-02-08,fp7d
2020-12-27,NE,10,12,2,10,2022-05-03_11-02-08,fp7d
2020-12-27,NW,6,6,0,6,2022-05-03_11-02-08,fp7d
2020-12-27,OW,0,0,0,0,2022-05-03_11-02-08,fp7d
2020-12-27,SG,54,61,7,54,2022-05-03_11-02-08,fp7d
2020-12-27,SH,8,8,0,8,2022-05-03_11-02-08,fp7d
2020-12-27,SO,17,25,8,17,2022-05-03_11-02-08,fp7d
2020-12-27,SZ,12,9,0,9,2022-05-03_11-02-08,fp7d
2020-12-27,TG,21,40,19,21,2022-05-03_11-02-08,fp7d
2020-12-27,TI,53,76,37,39,2022-05-03_11-02-08,fp7d
2020-12-27,UR,6,6,0,6,2022-05-03_11-02-08,fp7d
2020-12-27,VD,85,132,47,85,2022-05-03_11-02-08,fp7d
2020-12-27,VS,20,27,7,20,2022-05-03_11-02-08,fp7d
2020-12-27,ZG,8,8,0,8,2022-05-03_11-02-08,fp7d
2020-12-27,ZH,190,217,29,188,2022-05-03_11-02-08,fp7d
2020-12-28,AG,52,60,10,50,2022-05-03_11-02-08,fp7d
2020-12-28,AI,0,0,0,0,2022-05-03_11-02-08,fp7d
2020-12-28,AR,6,6,0,6,2022-05-03_11-02-08,fp7d
2020-12-28,BE,104,107,12,95,2022-05-03_11-02-08,fp7d
2020-12-28,BL,20,18,0,18,2022-05-03_11-02-08,fp7d
2020-12-28,BS,54,50,0,50,2022-05-03_11-02-08,fp7d
2020-12-28,FR,24,24,0,24,2022-05-03_11-02-08,fp7d
2020-12-28,GE,38,64,26,38,2022-05-03_11-02-08,fp7d
2020-12-28,GL,6,6,0,6,2022-05-03_11-02-08,fp7d
2020-12-28,GR,16,18,2,16,2022-05-03_11-02-08,fp7d
2020-12-28,JU,6,6,0,6,2022-05-03_11-02-08,fp7d
2020-12-28,LU,54,56,6,50,2022-05-03_11-02-08,fp7d
2020-12-28,NE,10,12,2,10,2022-05-03_11-02-08,fp7d
2020-12-28,NW,6,6,0,6,2022-05-03_11-02-08,fp7d
2020-12-28,OW,0,0,0,0,2022-05-03_11-02-08,fp7d
2020-12-28,SG,54,61,7,54,2022-05-03_11-02-08,fp7d
2020-12-28,SH,8,8,0,8,2022-05-03_11-02-08,fp7d
2020-12-28,SO,17,25,8,17,2022-05-03_11-02-08,fp7d
2020-12-28,SZ,12,9,0,9,2022-05-03_11-02-08,fp7d
2020-12-28,TG,21,40,19,21,2022-05-03_11-02-08,fp7d
2020-12-28,TI,53,82,35,47,2022-05-03_11-02-08,fp7d
2020-12-28,UR,6,6,0,6,2022-05-03_11-02-08,fp7d
2020-12-28,VD,85,126,41,85,2022-05-03_11-02-08,fp7d
2020-12-28,VS,20,27,7,20,2022-05-03_11-02-08,fp7d
2020-12-28,ZG,8,8,0,8,2022-05-03_11-02-08,fp7d
2020-12-28,ZH,190,216,29,187,2022-05-03_11-02-08,fp7d
2020-12-29,AG,52,60,10,50,2022-05-03_11-02-08,fp7d
2020-12-29,AI,0,0,0,0,2022-05-03_11-02-08,fp7d
2020-12-29,AR,6,6,0,6,2022-05-03_11-02-08,fp7d
2020-12-29,BE,104,109,12,97,2022-05-03_11-02-08,fp7d
2020-12-29,BL,20,18,0,18,2022-05-03_11-02-08,fp7d
2020-12-29,BS,54,50,0,50,2022-05-03_11-02-08,fp7d
2020-12-29,FR,24,24,0,24,2022-05-03_11-02-08,fp7d
2020-12-29,GE,38,64,26,38,2022-05-03_11-02-08,fp7d
2020-12-29,GL,6,5,0,5,2022-05-03_11-02-08,fp7d
2020-12-29,GR,16,18,2,16,2022-05-03_11-02-08,fp7d
2020-12-29,JU,6,6,0,6,2022-05-03_11-02-08,fp7d
2020-12-29,LU,54,56,6,50,2022-05-03_11-02-08,fp7d
2020-12-29,NE,10,12,2,10,2022-05-03_11-02-08,fp7d
2020-12-29,NW,6,6,0,6,2022-05-03_11-02-08,fp7d
2020-12-29,OW,0,0,0,0,2022-05-03_11-02-08,fp7d
2020-12-29,SG,54,61,7,54,2022-05-03_11-02-08,fp7d
2020-12-29,SH,8,8,0,8,2022-05-03_11-02-08,fp7d
2020-12-29,SO,17,25,8,17,2022-05-03_11-02-08,fp7d
2020-12-29,SZ,12,9,0,9,2022-05-03_11-02-08,fp7d
2020-12-29,TG,21,40,19,21,2022-05-03_11-02-08,fp7d
2020-12-29,TI,53,82,35,47,2022-05-03_11-02-08,fp7d
2020-12-29,UR,6,6,0,6,2022-05-03_11-02-08,fp7d
2020-12-29,VD,85,126,41,85,2022-05-03_11-02-08,fp7d
2020-12-29,VS,20,27,7,20,2022-05-03_11-02-08,fp7d
2020-12-29,ZG,8,8,0,8,2022-05-03_11-02-08,fp7d
2020-12-29,ZH,190,216,29,187,2022-05-03_11-02-08,fp7d
2020-12-30,AG,52,59,10,49,2022-05-03_11-02-08,fp7d
2020-12-30,AI,0,0,0,0,2022-05-03_11-02-08,fp7d
2020-12-30,AR,6,6,0,6,2022-05-03_11-02-08,fp7d
2020-12-30,BE,104,109,12,97,2022-05-03_11-02-08,fp7d
2020-12-30,BL,20,18,0,18,2022-05-03_11-02-08,fp7d
2020-12-30,BS,54,50,0,50,2022-05-03_11-02-08,fp7d
2020-12-30,FR,24,24,0,24,2022-05-03_11-02-08,fp7d
2020-12-30,GE,38,58,20,38,2022-05-03_11-02-08,fp7d
2020-12-30,GL,6,5,0,5,2022-05-03_11-02-08,fp7d
2020-12-30,GR,16,18,2,16,2022-05-03_11-02-08,fp7d
2020-12-30,JU,6,6,0,6,2022-05-03_11-02-08,fp7d
2020-12-30,LU,54,56,6,50,2022-05-03_11-02-08,fp7d
2020-12-30,NE,10,12,2,10,2022-05-03_11-02-08,fp7d
2020-12-30,NW,6,6,0,6,2022-05-03_11-02-08,fp7d
2020-12-30,OW,0,0,0,0,2022-05-03_11-02-08,fp7d
2020-12-30,SG,54,61,7,54,2022-05-03_11-02-08,fp7d
2020-12-30,SH,8,8,0,8,2022-05-03_11-02-08,fp7d
2020-12-30,SO,17,25,8,17,2022-05-03_11-02-08,fp7d
2020-12-30,SZ,12,9,0,9,2022-05-03_11-02-08,fp7d
2020-12-30,TG,21,40,19,21,2022-05-03_11-02-08,fp7d
2020-12-30,TI,53,82,35,47,2022-05-03_11-02-08,fp7d
2020-12-30,UR,6,6,0,6,2022-05-03_11-02-08,fp7d
2020-12-30,VD,85,126,41,85,2022-05-03_11-02-08,fp7d
2020-12-30,VS,20,27,7,20,2022-05-03_11-02-08,fp7d
2020-12-30,ZG,8,8,0,8,2022-05-03_11-02-08,fp7d
2020-12-30,ZH,190,216,29,187,2022-05-03_11-02-08,fp7d
2020-12-31,AG,52,59,10,49,2022-05-03_11-02-08,fp7d
2020-12-31,AI,0,0,0,0,2022-05-03_11-02-08,fp7d
2020-12-31,AR,6,6,0,6,2022-05-03_11-02-08,fp7d
2020-12-31,BE,104,109,12,97,2022-05-03_11-02-08,fp7d
2020-12-31,BL,20,18,0,18,2022-05-03_11-02-08,fp7d
2020-12-31,BS,54,50,0,50,2022-05-03_11-02-08,fp7d
2020-12-31,FR,24,24,0,24,2022-05-03_11-02-08,fp7d
2020-12-31,GE,38,58,20,38,2022-05-03_11-02-08,fp7d
2020-12-31,GL,6,4,0,4,2022-05-03_11-02-08,fp7d
2020-12-31,GR,16,18,2,16,2022-05-03_11-02-08,fp7d
2020-12-31,JU,6,6,0,6,2022-05-03_11-02-08,fp7d
2020-12-31,LU,54,56,6,50,2022-05-03_11-02-08,fp7d
2020-12-31,NE,10,12,2,10,2022-05-03_11-02-08,fp7d
2020-12-31,NW,6,6,0,6,2022-05-03_11-02-08,fp7d
2020-12-31,OW,0,0,0,0,2022-05-03_11-02-08,fp7d
2020-12-31,SG,54,61,7,54,2022-05-03_11-02-08,fp7d
2020-12-31,SH,8,8,0,8,2022-05-03_11-02-08,fp7d
2020-12-31,SO,17,25,8,17,2022-05-03_11-02-08,fp7d
2020-12-31,SZ,12,9,0,9,2022-05-03_11-02-08,fp7d
2020-12-31,TG,21,40,19,21,2022-05-03_11-02-08,fp7d
2020-12-31,TI,53,82,35,47,2022-05-03_11-02-08,fp7d
2020-12-31,UR,6,6,0,6,2022-05-03_11-02-08,fp7d
2020-12-31,VD,85,126,41,85,2022-05-03_11-02-08,fp7d
2020-12-31,VS,20,27,7,20,2022-05-03_11-02-08,fp7d
2020-12-31,ZG,8,8,0,8,2022-05-03_11-02-08,fp7d
2020-12-31,ZH,190,217,30,187,2022-05-03_11-02-08,fp7d
2021-01-01,AG,52,58,10,48,2022-05-03_11-02-08,fp7d
2021-01-01,AI,0,0,0,0,2022-05-03_11-02-08,fp7d
2021-01-01,AR,6,6,0,6,2022-05-03_11-02-08,fp7d
2021-01-01,BE,104,108,12,96,2022-05-03_11-02-08,fp7d
2021-01-01,BL,20,18,0,18,2022-05-03_11-02-08,fp7d
2021-01-01,BS,54,50,0,50,2022-05-03_11-02-08,fp7d
2021-01-01,FR,24,24,0,24,2022-05-03_11-02-08,fp7d
2021-01-01,GE,38,58,20,38,2022-05-03_11-02-08,fp7d
2021-01-01,GL,6,4,0,4,2022-05-03_11-02-08,fp7d
2021-01-01,GR,16,18,2,16,2022-05-03_11-02-08,fp7d
2021-01-01,JU,6,6,0,6,2022-05-03_11-02-08,fp7d
2021-01-01,LU,54,56,6,50,2022-05-03_11-02-08,fp7d
2021-01-01,NE,10,12,2,10,2022-05-03_11-02-08,fp7d
2021-01-01,NW,6,6,0,6,2022-05-03_11-02-08,fp7d
2021-01-01,OW,0,0,0,0,2022-05-03_11-02-08,fp7d
2021-01-01,SG,54,61,7,54,2022-05-03_11-02-08,fp7d
2021-01-01,SH,8,8,0,8,2022-05-03_11-02-08,fp7d
2021-01-01,SO,17,25,8,17,2022-05-03_11-02-08,fp7d
2021-01-01,SZ,12,9,0,9,2022-05-03_11-02-08,fp7d
2021-01-01,TG,21,40,19,21,2022-05-03_11-02-08,fp7d
2021-01-01,TI,53,82,35,47,2022-05-03_11-02-08,fp7d
2021-01-01,UR,6,6,0,6,2022-05-03_11-02-08,fp7d
2021-01-01,VD,85,126,41,85,2022-05-03_11-02-08,fp7d
2021-01-01,VS,20,27,7,20,2022-05-03_11-02-08,fp7d
2021-01-01,ZG,8,8,0,8,2022-05-03_11-02-08,fp7d
2021-01-01,ZH,190,216,29,187,2022-05-03_11-02-08,fp7d
2021-01-02,AG,52,55,10,45,2022-05-03_11-02-08,fp7d
2021-01-02,AI,0,0,0,0,2022-05-03_11-02-08,fp7d
2021-01-02,AR,6,6,0,6,2022-05-03_11-02-08,fp7d
2021-01-02,BE,104,108,12,96,2022-05-03_11-02-08,fp7d
2021-01-02,BL,20,18,0,18,2022-05-03_11-02-08,fp7d
2021-01-02,BS,54,50,0,50,2022-05-03_11-02-08,fp7d
2021-01-02,FR,24,24,0,24,2022-05-03_11-02-08,fp7d
2021-01-02,GE,38,58,20,38,2022-05-03_11-02-08,fp7d
2021-01-02,GL,6,4,0,4,2022-05-03_11-02-08,fp7d
2021-01-02,GR,16,18,2,16,2022-05-03_11-02-08,fp7d
2021-01-02,JU,6,6,0,6,2022-05-03_11-02-08,fp7d
2021-01-02,LU,54,56,6,50,2022-05-03_11-02-08,fp7d
2021-01-02,NE,10,12,2,10,2022-05-03_11-02-08,fp7d
2021-01-02,NW,6,6,0,6,2022-05-03_11-02-08,fp7d
2021-01-02,OW,0,0,0,0,2022-05-03_11-02-08,fp7d
2021-01-02,SG,54,61,7,54,2022-05-03_11-02-08,fp7d
2021-01-02,SH,8,8,0,8,2022-05-03_11-02-08,fp7d
2021-01-02,SO,17,25,8,17,2022-05-03_11-02-08,fp7d
2021-01-02,SZ,12,9,0,9,2022-05-03_11-02-08,fp7d
2021-01-02,TG,21,40,19,21,2022-05-03_11-02-08,fp7d
2021-01-02,TI,53,82,35,47,2022-05-03_11-02-08,fp7d
2021-01-02,UR,6,6,0,6,2022-05-03_11-02-08,fp7d
2021-01-02,VD,85,126,41,85,2022-05-03_11-02-08,fp7d
2021-01-02,VS,20,27,7,20,2022-05-03_11-02-08,fp7d
2021-01-02,ZG,8,8,0,8,2022-05-03_11-02-08,fp7d
2021-01-02,ZH,190,217,30,187,2022-05-03_11-02-08,fp7d
2021-01-03,AG,52,56,10,46,2022-05-03_11-02-08,fp7d
2021-01-03,AI,0,0,0,0,2022-05-03_11-02-08,fp7d
2021-01-03,AR,6,6,0,6,2022-05-03_11-02-08,fp7d
2021-01-03,BE,104,108,12,96,2022-05-03_11-02-08,fp7d
2021-01-03,BL,20,18,0,18,2022-05-03_11-02-08,fp7d
2021-01-03,BS,54,50,0,50,2022-05-03_11-02-08,fp7d
2021-01-03,FR,24,24,0,24,2022-05-03_11-02-08,fp7d
2021-01-03,GE,38,58,20,38,2022-05-03_11-02-08,fp7d
2021-01-03,GL,6,4,0,4,2022-05-03_11-02-08,fp7d
2021-01-03,GR,16,18,2,16,2022-05-03_11-02-08,fp7d
2021-01-03,JU,6,6,0,6,2022-05-03_11-02-08,fp7d
2021-01-03,LU,54,56,6,50,2022-05-03_11-02-08,fp7d
2021-01-03,NE,10,12,2,10,2022-05-03_11-02-08,fp7d
2021-01-03,NW,6,6,0,6,2022-05-03_11-02-08,fp7d
2021-01-03,OW,0,0,0,0,2022-05-03_11-02-08,fp7d
2021-01-03,SG,54,61,7,54,2022-05-03_11-02-08,fp7d
2021-01-03,SH,8,8,0,8,2022-05-03_11-02-08,fp7d
2021-01-03,SO,17,25,8,17,2022-05-03_11-02-08,fp7d
2021-01-03,SZ,12,9,0,9,2022-05-03_11-02-08,fp7d
2021-01-03,TG,21,40,19,21,2022-05-03_11-02-08,fp7d
2021-01-03,TI,53,82,35,47,2022-05-03_11-02-08,fp7d
2021-01-03,UR,6,6,0,6,2022-05-03_11-02-08,fp7d
2021-01-03,VD,85,126,41,85,2022-05-03_11-02-08,fp7d
2021-01-03,VS,20,27,7,20,2022-05-03_11-02-08,fp7d
2021-01-03,ZG,8,8,0,8,2022-05-03_11-02-08,fp7d
2021-01-03,ZH,190,218,30,188,2022-05-03_11-02-08,fp7d
2021-01-04,AG,52,60,10,50,2022-05-03_11-02-08,fp7d
2021-01-04,AI,0,0,0,0,2022-05-03_11-02-08,fp7d
2021-01-04,AR,6,6,0,6,2022-05-03_11-02-08,fp7d
2021-01-04,BE,104,108,12,96,2022-05-03_11-02-08,fp7d
2021-01-04,BL,20,18,0,18,2022-05-03_11-02-08,fp7d
2021-01-04,BS,54,50,0,50,2022-05-03_11-02-08,fp7d
2021-01-04,FR,24,24,0,24,2022-05-03_11-02-08,fp7d
2021-01-04,GE,38,64,26,38,2022-05-03_11-02-08,fp7d
2021-01-04,GL,6,4,0,4,2022-05-03_11-02-08,fp7d
2021-01-04,GR,16,18,2,16,2022-05-03_11-02-08,fp7d
2021-01-04,JU,6,6,0,6,2022-05-03_11-02-08,fp7d
2021-01-04,LU,54,56,6,50,2022-05-03_11-02-08,fp7d
2021-01-04,NE,10,12,2,10,2022-05-03_11-02-08,fp7d
2021-01-04,NW,6,6,0,6,2022-05-03_11-02-08,fp7d
2021-01-04,OW,0,0,0,0,2022-05-03_11-02-08,fp7d
2021-01-04,SG,54,61,7,54,2022-05-03_11-02-08,fp7d
2021-01-04,SH,8,8,0,8,2022-05-03_11-02-08,fp7d
2021-01-04,SO,17,25,8,17,2022-05-03_11-02-08,fp7d
2021-01-04,SZ,12,9,0,9,2022-05-03_11-02-08,fp7d
2021-01-04,TG,21,38,17,21,2022-05-03_11-02-08,fp7d
2021-01-04,TI,53,82,35,47,2022-05-03_11-02-08,fp7d
2021-01-04,UR,6,6,0,6,2022-05-03_11-02-08,fp7d
2021-01-04,VD,85,126,41,85,2022-05-03_11-02-08,fp7d
2021-01-04,VS,20,27,7,20,2022-05-03_11-02-08,fp7d
2021-01-04,ZG,8,8,0,8,2022-05-03_11-02-08,fp7d
2021-01-04,ZH,190,217,29,188,2022-05-03_11-02-08,fp7d
2021-01-05,AG,52,60,10,50,2022-05-03_11-02-08,fp7d
2021-01-05,AI,0,0,0,0,2022-05-03_11-02-08,fp7d
2021-01-05,AR,6,6,0,6,2022-05-03_11-02-08,fp7d
2021-01-05,BE,104,108,12,96,2022-05-03_11-02-08,fp7d
2021-01-05,BL,20,18,0,18,2022-05-03_11-02-08,fp7d
2021-01-05,BS,54,50,0,50,2022-05-03_11-02-08,fp7d
2021-01-05,FR,24,24,0,24,2022-05-03_11-02-08,fp7d
2021-01-05,GE,38,64,26,38,2022-05-03_11-02-08,fp7d
2021-01-05,GL,6,5,0,5,2022-05-03_11-02-08,fp7d
2021-01-05,GR,16,18,2,16,2022-05-03_11-02-08,fp7d
2021-01-05,JU,6,6,0,6,2022-05-03_11-02-08,fp7d
2021-01-05,LU,54,54,4,50,2022-05-03_11-02-08,fp7d
2021-01-05,NE,10,12,2,10,2022-05-03_11-02-08,fp7d
2021-01-05,NW,6,5,0,5,2022-05-03_11-02-08,fp7d
2021-01-05,OW,0,0,0,0,2022-05-03_11-02-08,fp7d
2021-01-05,SG,54,61,7,54,2022-05-03_11-02-08,fp7d
2021-01-05,SH,8,8,0,8,2022-05-03_11-02-08,fp7d
2021-01-05,SO,17,25,8,17,2022-05-03_11-02-08,fp7d
2021-01-05,SZ,12,9,0,9,2022-05-03_11-02-08,fp7d
2021-01-05,TG,21,38,17,21,2022-05-03_11-02-08,fp7d
2021-01-05,TI,53,86,39,47,2022-05-03_11-02-08,fp7d
2021-01-05,UR,6,6,0,6,2022-05-03_11-02-08,fp7d
2021-01-05,VD,85,126,41,85,2022-05-03_11-02-08,fp7d
2021-01-05,VS,20,27,7,20,2022-05-03_11-02-08,fp7d
2021-01-05,ZG,8,8,0,8,2022-05-03_11-02-08,fp7d
2021-01-05,ZH,190,218,30,188,2022-05-03_11-02-08,fp7d
2021-01-06,AG,52,60,10,50,2022-05-03_11-02-08,fp7d
2021-01-06,AI,0,0,0,0,2022-05-03_11-02-08,fp7d
2021-01-06,AR,6,6,0,6,2022-05-03_11-02-08,fp7d
2021-01-06,BE,104,108,12,96,2022-05-03_11-02-08,fp7d
2021-01-06,BL,20,19,1,18,2022-05-03_11-02-08,fp7d
2021-01-06,BS,54,50,0,50,2022-05-03_11-02-08,fp7d
2021-01-06,FR,24,24,0,24,2022-05-03_11-02-08,fp7d
2021-01-06,GE,38,64,26,38,2022-05-03_11-02-08,fp7d
2021-01-06,GL,6,5,0,5,2022-05-03_11-02-08,fp7d
2021-01-06,GR,16,18,2,16,2022-05-03_11-02-08,fp7d
2021-01-06,JU,6,6,0,6,2022-05-03_11-02-08,fp7d
2021-01-06,LU,54,54,4,50,2022-05-03_11-02-08,fp7d
2021-01-06,NE,10,12,2,10,2022-05-03_11-02-08,fp7d
2021-01-06,NW,6,5,0,5,2022-05-03_11-02-08,fp7d
2021-01-06,OW,0,0,0,0,2022-05-03_11-02-08,fp7d
2021-01-06,SG,54,65,11,54,2022-05-03_11-02-08,fp7d
2021-01-06,SH,8,8,0,8,2022-05-03_11-02-08,fp7d
2021-01-06,SO,17,25,8,17,2022-05-03_11-02-08,fp7d
2021-01-06,SZ,12,9,0,9,2022-05-03_11-02-08,fp7d
2021-01-06,TG,21,38,17,21,2022-05-03_11-02-08,fp7d
2021-01-06,TI,53,86,39,47,2022-05-03_11-02-08,fp7d
2021-01-06,UR,6,6,0,6,2022-05-03_11-02-08,fp7d
2021-01-06,VD,85,126,41,85,2022-05-03_11-02-08,fp7d
2021-01-06,VS,20,25,5,20,2022-05-03_11-02-08,fp7d
2021-01-06,ZG,8,8,0,8,2022-05-03_11-02-08,fp7d
2021-01-06,ZH,190,218,30,188,2022-05-03_11-02-08,fp7d
2021-01-07,AG,52,58,8,50,2022-05-03_11-02-08,fp7d
2021-01-07,AI,0,0,0,0,2022-05-03_11-02-08,fp7d
2021-01-07,AR,6,6,0,6,2022-05-03_11-02-08,fp7d
2021-01-07,BE,104,109,12,97,2022-05-03_11-02-08,fp7d
2021-01-07,BL,20,18,0,18,2022-05-03_11-02-08,fp7d
2021-01-07,BS,54,50,0,50,2022-05-03_11-02-08,fp7d
2021-01-07,FR,24,21,0,21,2022-05-03_11-02-08,fp7d
2021-01-07,GE,38,64,26,38,2022-05-03_11-02-08,fp7d
2021-01-07,GL,6,5,0,5,2022-05-03_11-02-08,fp7d
2021-01-07,GR,16,17,1,16,2022-05-03_11-02-08,fp7d
2021-01-07,JU,6,6,0,6,2022-05-03_11-02-08,fp7d
2021-01-07,LU,54,54,4,50,2022-05-03_11-02-08,fp7d
2021-01-07,NE,10,12,2,10,2022-05-03_11-02-08,fp7d
2021-01-07,NW,6,5,0,5,2022-05-03_11-02-08,fp7d
2021-01-07,OW,0,0,0,0,2022-05-03_11-02-08,fp7d
2021-01-07,SG,54,65,11,54,2022-05-03_11-02-08,fp7d
2021-01-07,SH,8,8,0,8,2022-05-03_11-02-08,fp7d
2021-01-07,SO,17,25,8,17,2022-05-03_11-02-08,fp7d
2021-01-07,SZ,12,9,0,9,2022-05-03_11-02-08,fp7d
2021-01-07,TG,21,38,17,21,2022-05-03_11-02-08,fp7d
2021-01-07,TI,53,86,39,47,2022-05-03_11-02-08,fp7d
2021-01-07,UR,6,6,0,6,2022-05-03_11-02-08,fp7d
2021-01-07,VD,85,126,41,85,2022-05-03_11-02-08,fp7d
2021-01-07,VS,20,25,5,20,2022-05-03_11-02-08,fp7d
2021-01-07,ZG,8,5,0,5,2022-05-03_11-02-08,fp7d
2021-01-07,ZH,190,217,29,188,2022-05-03_11-02-08,fp7d
2021-01-08,AG,52,57,7,50,2022-05-03_11-02-08,fp7d
2021-01-08,AI,0,0,0,0,2022-05-03_11-02-08,fp7d
2021-01-08,AR,6,6,0,6,2022-05-03_11-02-08,fp7d
2021-01-08,BE,104,109,12,97,2022-05-03_11-02-08,fp7d
2021-01-08,BL,20,18,0,18,2022-05-03_11-02-08,fp7d
2021-01-08,BS,54,50,0,50,2022-05-03_11-02-08,fp7d
2021-01-08,FR,24,24,0,24,2022-05-03_11-02-08,fp7d
2021-01-08,GE,38,64,26,38,2022-05-03_11-02-08,fp7d
2021-01-08,GL,6,5,0,5,2022-05-03_11-02-08,fp7d
2021-01-08,GR,16,17,1,16,2022-05-03_11-02-08,fp7d
2021-01-08,JU,6,6,0,6,2022-05-03_11-02-08,fp7d
2021-01-08,LU,54,54,4,50,2022-05-03_11-02-08,fp7d
2021-01-08,NE,10,12,2,10,2022-05-03_11-02-08,fp7d
2021-01-08,NW,6,5,0,5,2022-05-03_11-02-08,fp7d
2021-01-08,OW,0,0,0,0,2022-05-03_11-02-08,fp7d
2021-01-08,SG,54,65,11,54,2022-05-03_11-02-08,fp7d
2021-01-08,SH,8,8,0,8,2022-05-03_11-02-08,fp7d
2021-01-08,SO,17,25,8,17,2022-05-03_11-02-08,fp7d
2021-01-08,SZ,12,10,0,10,2022-05-03_11-02-08,fp7d
2021-01-08,TG,21,38,17,21,2022-05-03_11-02-08,fp7d
2021-01-08,TI,53,91,44,47,2022-05-03_11-02-08,fp7d
2021-01-08,UR,6,6,0,6,2022-05-03_11-02-08,fp7d
2021-01-08,VD,85,120,35,85,2022-05-03_11-02-08,fp7d
2021-01-08,VS,20,25,5,20,2022-05-03_11-02-08,fp7d
2021-01-08,ZG,8,8,0,8,2022-05-03_11-02-08,fp7d
2021-01-08,ZH,190,217,29,188,2022-05-03_11-02-08,fp7d
2021-01-09,AG,52,56,6,50,2022-05-03_11-02-08,fp7d
2021-01-09,AI,0,0,0,0,2022-05-03_11-02-08,fp7d
2021-01-09,AR,6,6,0,6,2022-05-03_11-02-08,fp7d
2021-01-09,BE,104,107,10,97,2022-05-03_11-02-08,fp7d
2021-01-09,BL,20,18,0,18,2022-05-03_11-02-08,fp7d
2021-01-09,BS,54,50,0,50,2022-05-03_11-02-08,fp7d
2021-01-09,FR,24,24,0,24,2022-05-03_11-02-08,fp7d
2021-01-09,GE,38,64,26,38,2022-05-03_11-02-08,fp7d
2021-01-09,GL,6,5,0,5,2022-05-03_11-02-08,fp7d
2021-01-09,GR,16,17,1,16,2022-05-03_11-02-08,fp7d
2021-01-09,JU,6,6,0,6,2022-05-03_11-02-08,fp7d
2021-01-09,LU,54,54,4,50,2022-05-03_11-02-08,fp7d
2021-01-09,NE,10,12,2,10,2022-05-03_11-02-08,fp7d
2021-01-09,NW,6,5,0,5,2022-05-03_11-02-08,fp7d
2021-01-09,OW,0,0,0,0,2022-05-03_11-02-08,fp7d
2021-01-09,SG,54,65,11,54,2022-05-03_11-02-08,fp7d
2021-01-09,SH,8,8,0,8,2022-05-03_11-02-08,fp7d
2021-01-09,SO,17,25,8,17,2022-05-03_11-02-08,fp7d
2021-01-09,SZ,12,10,0,10,2022-05-03_11-02-08,fp7d
2021-01-09,TG,21,38,17,21,2022-05-03_11-02-08,fp7d
2021-01-09,TI,53,92,45,47,2022-05-03_11-02-08,fp7d
2021-01-09,UR,6,6,0,6,2022-05-03_11-02-08,fp7d
2021-01-09,VD,85,120,35,85,2022-05-03_11-02-08,fp7d
2021-01-09,VS,20,25,5,20,2022-05-03_11-02-08,fp7d
2021-01-09,ZG,8,8,0,8,2022-05-03_11-02-08,fp7d
2021-01-09,ZH,190,217,29,188,2022-05-03_11-02-08,fp7d
2021-01-10,AG,52,54,4,50,2022-05-03_11-02-08,fp7d
2021-01-10,AI,0,0,0,0,2022-05-03_11-02-08,fp7d
2021-01-10,AR,6,6,0,6,2022-05-03_11-02-08,fp7d
2021-01-10,BE,104,109,10,99,2022-05-03_11-02-08,fp7d
2021-01-10,BL,20,18,0,18,2022-05-03_11-02-08,fp7d
2021-01-10,BS,54,50,0,50,2022-05-03_11-02-08,fp7d
2021-01-10,FR,24,24,0,24,2022-05-03_11-02-08,fp7d
2021-01-10,GE,38,64,26,38,2022-05-03_11-02-08,fp7d
2021-01-10,GL,6,5,0,5,2022-05-03_11-02-08,fp7d
2021-01-10,GR,16,17,1,16,2022-05-03_11-02-08,fp7d
2021-01-10,JU,6,6,0,6,2022-05-03_11-02-08,fp7d
2021-01-10,LU,54,54,4,50,2022-05-03_11-02-08,fp7d
2021-01-10,NE,10,12,2,10,2022-05-03_11-02-08,fp7d
2021-01-10,NW,6,5,0,5,2022-05-03_11-02-08,fp7d
2021-01-10,OW,0,0,0,0,2022-05-03_11-02-08,fp7d
2021-01-10,SG,54,65,11,54,2022-05-03_11-02-08,fp7d
2021-01-10,SH,8,8,0,8,2022-05-03_11-02-08,fp7d
2021-01-10,SO,17,25,8,17,2022-05-03_11-02-08,fp7d
2021-01-10,SZ,12,9,0,9,2022-05-03_11-02-08,fp7d
2021-01-10,TG,21,38,17,21,2022-05-03_11-02-08,fp7d
2021-01-10,TI,53,93,46,47,2022-05-03_11-02-08,fp7d
2021-01-10,UR,6,6,0,6,2022-05-03_11-02-08,fp7d
2021-01-10,VD,85,120,35,85,2022-05-03_11-02-08,fp7d
2021-01-10,VS,20,25,5,20,2022-05-03_11-02-08,fp7d
2021-01-10,ZG,8,8,0,8,2022-05-03_11-02-08,fp7d
2021-01-10,ZH,190,217,29,188,2022-05-03_11-02-08,fp7d
2021-01-11,AG,52,54,4,50,2022-05-03_11-02-08,fp7d
2021-01-11,AI,0,0,0,0,2022-05-03_11-02-08,fp7d
2021-01-11,AR,6,6,0,6,2022-05-03_11-02-08,fp7d
2021-01-11,BE,104,108,10,98,2022-05-03_11-02-08,fp7d
2021-01-11,BL,20,18,0,18,2022-05-03_11-02-08,fp7d
2021-01-11,BS,54,50,0,50,2022-05-03_11-02-08,fp7d
2021-01-11,FR,24,24,0,24,2022-05-03_11-02-08,fp7d
2021-01-11,GE,38,64,26,38,2022-05-03_11-02-08,fp7d
2021-01-11,GL,6,6,0,6,2022-05-03_11-02-08,fp7d
2021-01-11,GR,16,17,1,16,2022-05-03_11-02-08,fp7d
2021-01-11,JU,6,6,0,6,2022-05-03_11-02-08,fp7d
2021-01-11,LU,54,54,4,50,2022-05-03_11-02-08,fp7d
2021-01-11,NE,10,12,2,10,2022-05-03_11-02-08,fp7d
2021-01-11,NW,6,5,0,5,2022-05-03_11-02-08,fp7d
2021-01-11,OW,0,0,0,0,2022-05-03_11-02-08,fp7d
2021-01-11,SG,54,65,11,54,2022-05-03_11-02-08,fp7d
2021-01-11,SH,8,8,0,8,2022-05-03_11-02-08,fp7d
2021-01-11,SO,17,25,8,17,2022-05-03_11-02-08,fp7d
2021-01-11,SZ,12,10,0,10,2022-05-03_11-02-08,fp7d
2021-01-11,TG,21,38,17,21,2022-05-03_11-02-08,fp7d
2021-01-11,TI,53,91,46,45,2022-05-03_11-02-08,fp7d
2021-01-11,UR,6,6,0,6,2022-05-03_11-02-08,fp7d
2021-01-11,VD,85,120,35,85,2022-05-03_11-02-08,fp7d
2021-01-11,VS,20,25,5,20,2022-05-03_11-02-08,fp7d
2021-01-11,ZG,8,8,0,8,2022-05-03_11-02-08,fp7d
2021-01-11,ZH,190,217,29,188,2022-05-03_11-02-08,fp7d
2021-01-12,AG,52,56,6,50,2022-05-03_11-02-08,fp7d
2021-01-12,AI,0,0,0,0,2022-05-03_11-02-08,fp7d
2021-01-12,AR,6,6,0,6,2022-05-03_11-02-08,fp7d
2021-01-12,BE,104,109,10,99,2022-05-03_11-02-08,fp7d
2021-01-12,BL,20,18,0,18,2022-05-03_11-02-08,fp7d
2021-01-12,BS,54,50,0,50,2022-05-03_11-02-08,fp7d
2021-01-12,FR,24,24,0,24,2022-05-03_11-02-08,fp7d
2021-01-12,GE,38,64,26,38,2022-05-03_11-02-08,fp7d
2021-01-12,GL,6,6,0,6,2022-05-03_11-02-08,fp7d
2021-01-12,GR,16,17,1,16,2022-05-03_11-02-08,fp7d
2021-01-12,JU,6,6,0,6,2022-05-03_11-02-08,fp7d
2021-01-12,LU,54,54,4,50,2022-05-03_11-02-08,fp7d
2021-01-12,NE,10,12,2,10,2022-05-03_11-02-08,fp7d
2021-01-12,NW,6,5,0,5,2022-05-03_11-02-08,fp7d
2021-01-12,OW,0,0,0,0,2022-05-03_11-02-08,fp7d
2021-01-12,SG,54,65,11,54,2022-05-03_11-02-08,fp7d
2021-01-12,SH,8,8,0,8,2022-05-03_11-02-08,fp7d
2021-01-12,SO,17,25,8,17,2022-05-03_11-02-08,fp7d
2021-01-12,SZ,12,10,0,10,2022-05-03_11-02-08,fp7d
2021-01-12,TG,21,38,17,21,2022-05-03_11-02-08,fp7d
2021-01-12,TI,53,87,42,45,2022-05-03_11-02-08,fp7d
2021-01-12,UR,6,6,0,6,2022-05-03_11-02-08,fp7d
2021-01-12,VD,85,128,43,85,2022-05-03_11-02-08,fp7d
2021-01-12,VS,20,25,5,20,2022-05-03_11-02-08,fp7d
2021-01-12,ZG,8,8,0,8,2022-05-03_11-02-08,fp7d
2021-01-12,ZH,190,221,32,189,2022-05-03_11-02-08,fp7d
2021-01-13,AG,52,56,6,50,2022-05-03_11-02-08,fp7d
2021-01-13,AI,0,0,0,0,2022-05-03_11-02-08,fp7d
2021-01-13,AR,6,6,0,6,2022-05-03_11-02-08,fp7d
2021-01-13,BE,104,109,10,99,2022-05-03_11-02-08,fp7d
2021-01-13,BL,20,18,0,18,2022-05-03_11-02-08,fp7d
2021-01-13,BS,54,50,0,50,2022-05-03_11-02-08,fp7d
2021-01-13,FR,24,24,0,24,2022-05-03_11-02-08,fp7d
2021-01-13,GE,38,64,26,38,2022-05-03_11-02-08,fp7d
2021-01-13,GL,6,6,0,6,2022-05-03_11-02-08,fp7d
2021-01-13,GR,16,17,1,16,2022-05-03_11-02-08,fp7d
2021-01-13,JU,6,6,0,6,2022-05-03_11-02-08,fp7d
2021-01-13,LU,54,54,4,50,2022-05-03_11-02-08,fp7d
2021-01-13,NE,10,12,2,10,2022-05-03_11-02-08,fp7d
2021-01-13,NW,6,5,0,5,2022-05-03_11-02-08,fp7d
2021-01-13,OW,0,0,0,0,2022-05-03_11-02-08,fp7d
2021-01-13,SG,54,65,11,54,2022-05-03_11-02-08,fp7d
2021-01-13,SH,8,8,0,8,2022-05-03_11-02-08,fp7d
2021-01-13,SO,17,25,8,17,2022-05-03_11-02-08,fp7d
2021-01-13,SZ,12,10,0,10,2022-05-03_11-02-08,fp7d
2021-01-13,TG,21,38,17,21,2022-05-03_11-02-08,fp7d
2021-01-13,TI,53,86,41,45,2022-05-03_11-02-08,fp7d
2021-01-13,UR,6,6,0,6,2022-05-03_11-02-08,fp7d
2021-01-13,VD,85,128,43,85,2022-05-03_11-02-08,fp7d
2021-01-13,VS,20,25,5,20,2022-05-03_11-02-08,fp7d
2021-01-13,ZG,8,8,0,8,2022-05-03_11-02-08,fp7d
2021-01-13,ZH,190,219,32,187,2022-05-03_11-02-08,fp7d
2021-01-14,AG,52,52,2,50,2022-05-03_11-02-08,fp7d
2021-01-14,AI,0,0,0,0,2022-05-03_11-02-08,fp7d
2021-01-14,AR,6,6,0,6,2022-05-03_11-02-08,fp7d
2021-01-14,BE,104,109,10,99,2022-05-03_11-02-08,fp7d
2021-01-14,BL,20,18,0,18,2022-05-03_11-02-08,fp7d
2021-01-14,BS,54,50,0,50,2022-05-03_11-02-08,fp7d
2021-01-14,FR,24,24,0,24,2022-05-03_11-02-08,fp7d
2021-01-14,GE,38,59,21,38,2022-05-03_11-02-08,fp7d
2021-01-14,GL,6,6,0,6,2022-05-03_11-02-08,fp7d
2021-01-14,GR,16,17,1,16,2022-05-03_11-02-08,fp7d
2021-01-14,JU,6,6,0,6,2022-05-03_11-02-08,fp7d
2021-01-14,LU,54,54,4,50,2022-05-03_11-02-08,fp7d
2021-01-14,NE,10,12,2,10,2022-05-03_11-02-08,fp7d
2021-01-14,NW,6,5,0,5,2022-05-03_11-02-08,fp7d
2021-01-14,OW,0,0,0,0,2022-05-03_11-02-08,fp7d
2021-01-14,SG,54,65,11,54,2022-05-03_11-02-08,fp7d
2021-01-14,SH,8,8,0,8,2022-05-03_11-02-08,fp7d
2021-01-14,SO,17,25,8,17,2022-05-03_11-02-08,fp7d
2021-01-14,SZ,12,10,0,10,2022-05-03_11-02-08,fp7d
2021-01-14,TG,21,38,17,21,2022-05-03_11-02-08,fp7d
2021-01-14,TI,53,84,39,45,2022-05-03_11-02-08,fp7d
2021-01-14,UR,6,6,0,6,2022-05-03_11-02-08,fp7d
2021-01-14,VD,85,128,43,85,2022-05-03_11-02-08,fp7d
2021-01-14,VS,20,25,5,20,2022-05-03_11-02-08,fp7d
2021-01-14,ZG,8,8,0,8,2022-05-03_11-02-08,fp7d
2021-01-14,ZH,190,218,32,186,2022-05-03_11-02-08,fp7d
2021-01-15,AG,52,52,2,50,2022-05-03_11-02-08,fp7d
2021-01-15,AI,0,0,0,0,2022-05-03_11-02-08,fp7d
2021-01-15,AR,6,6,0,6,2022-05-03_11-02-08,fp7d
2021-01-15,BE,104,109,10,99,2022-05-03_11-02-08,fp7d
2021-01-15,BL,20,18,0,18,2022-05-03_11-02-08,fp7d
2021-01-15,BS,54,50,0,50,2022-05-03_11-02-08,fp7d
2021-01-15,FR,24,24,0,24,2022-05-03_11-02-08,fp7d
2021-01-15,GE,38,59,21,38,2022-05-03_11-02-08,fp7d
2021-01-15,GL,6,6,0,6,2022-05-03_11-02-08,fp7d
2021-01-15,GR,16,17,1,16,2022-05-03_11-02-08,fp7d
2021-01-15,JU,6,6,0,6,2022-05-03_11-02-08,fp7d
2021-01-15,LU,54,54,4,50,2022-05-03_11-02-08,fp7d
2021-01-15,NE,10,12,2,10,2022-05-03_11-02-08,fp7d
2021-01-15,NW,6,5,0,5,2022-05-03_11-02-08,fp7d
2021-01-15,OW,0,0,0,0,2022-05-03_11-02-08,fp7d
2021-01-15,SG,54,65,11,54,2022-05-03_11-02-08,fp7d
2021-01-15,SH,8,8,0,8,2022-05-03_11-02-08,fp7d
2021-01-15,SO,17,25,8,17,2022-05-03_11-02-08,fp7d
2021-01-15,SZ,12,10,0,10,2022-05-03_11-02-08,fp7d
2021-01-15,TG,21,38,17,21,2022-05-03_11-02-08,fp7d
2021-01-15,TI,53,80,35,45,2022-05-03_11-02-08,fp7d
2021-01-15,UR,6,6,0,6,2022-05-03_11-02-08,fp7d
2021-01-15,VD,85,128,43,85,2022-05-03_11-02-08,fp7d
2021-01-15,VS,20,25,5,20,2022-05-03_11-02-08,fp7d
2021-01-15,ZG,8,8,0,8,2022-05-03_11-02-08,fp7d
2021-01-15,ZH,190,215,29,186,2022-05-03_11-02-08,fp7d
2021-01-16,AG,52,52,2,50,2022-05-03_11-02-08,fp7d
2021-01-16,AI,0,0,0,0,2022-05-03_11-02-08,fp7d
2021-01-16,AR,6,6,0,6,2022-05-03_11-02-08,fp7d
2021-01-16,BE,104,109,10,99,2022-05-03_11-02-08,fp7d
2021-01-16,BL,20,18,0,18,2022-05-03_11-02-08,fp7d
2021-01-16,BS,54,50,0,50,2022-05-03_11-02-08,fp7d
2021-01-16,FR,24,24,0,24,2022-05-03_11-02-08,fp7d
2021-01-16,GE,38,59,21,38,2022-05-03_11-02-08,fp7d
2021-01-16,GL,6,6,0,6,2022-05-03_11-02-08,fp7d
2021-01-16,GR,16,17,1,16,2022-05-03_11-02-08,fp7d
2021-01-16,JU,6,6,0,6,2022-05-03_11-02-08,fp7d
2021-01-16,LU,54,54,4,50,2022-05-03_11-02-08,fp7d
2021-01-16,NE,10,12,2,10,2022-05-03_11-02-08,fp7d
2021-01-16,NW,6,5,0,5,2022-05-03_11-02-08,fp7d
2021-01-16,OW,0,0,0,0,2022-05-03_11-02-08,fp7d
2021-01-16,SG,54,65,11,54,2022-05-03_11-02-08,fp7d
2021-01-16,SH,8,8,0,8,2022-05-03_11-02-08,fp7d
2021-01-16,SO,17,25,8,17,2022-05-03_11-02-08,fp7d
2021-01-16,SZ,12,10,0,10,2022-05-03_11-02-08,fp7d
2021-01-16,TG,21,38,17,21,2022-05-03_11-02-08,fp7d
2021-01-16,TI,53,80,35,45,2022-05-03_11-02-08,fp7d
2021-01-16,UR,6,6,0,6,2022-05-03_11-02-08,fp7d
2021-01-16,VD,85,128,43,85,2022-05-03_11-02-08,fp7d
2021-01-16,VS,20,25,5,20,2022-05-03_11-02-08,fp7d
2021-01-16,ZG,8,8,0,8,2022-05-03_11-02-08,fp7d
2021-01-16,ZH,190,215,29,186,2022-05-03_11-02-08,fp7d
2021-01-17,AG,52,52,2,50,2022-05-03_11-02-08,fp7d
2021-01-17,AI,0,0,0,0,2022-05-03_11-02-08,fp7d
2021-01-17,AR,6,6,0,6,2022-05-03_11-02-08,fp7d
2021-01-17,BE,104,109,10,99,2022-05-03_11-02-08,fp7d
2021-01-17,BL,20,18,0,18,2022-05-03_11-02-08,fp7d
2021-01-17,BS,54,50,0,50,2022-05-03_11-02-08,fp7d
2021-01-17,FR,24,24,0,24,2022-05-03_11-02-08,fp7d
2021-01-17,GE,38,59,21,38,2022-05-03_11-02-08,fp7d
2021-01-17,GL,6,6,0,6,2022-05-03_11-02-08,fp7d
2021-01-17,GR,16,17,1,16,2022-05-03_11-02-08,fp7d
2021-01-17,JU,6,6,0,6,2022-05-03_11-02-08,fp7d
2021-01-17,LU,54,54,4,50,2022-05-03_11-02-08,fp7d
2021-01-17,NE,10,12,2,10,2022-05-03_11-02-08,fp7d
2021-01-17,NW,6,5,0,5,2022-05-03_11-02-08,fp7d
2021-01-17,OW,0,0,0,0,2022-05-03_11-02-08,fp7d
2021-01-17,SG,54,65,11,54,2022-05-03_11-02-08,fp7d
2021-01-17,SH,8,8,0,8,2022-05-03_11-02-08,fp7d
2021-01-17,SO,17,25,8,17,2022-05-03_11-02-08,fp7d
2021-01-17,SZ,12,10,0,10,2022-05-03_11-02-08,fp7d
2021-01-17,TG,21,38,17,21,2022-05-03_11-02-08,fp7d
2021-01-17,TI,53,80,35,45,2022-05-03_11-02-08,fp7d
2021-01-17,UR,6,6,0,6,2022-05-03_11-02-08,fp7d
2021-01-17,VD,85,128,43,85,2022-05-03_11-02-08,fp7d
2021-01-17,VS,20,25,5,20,2022-05-03_11-02-08,fp7d
2021-01-17,ZG,8,8,0,8,2022-05-03_11-02-08,fp7d
2021-01-17,ZH,190,215,29,186,2022-05-03_11-02-08,fp7d
2021-01-18,AG,52,52,2,50,2022-05-03_11-02-08,fp7d
2021-01-18,AI,0,0,0,0,2022-05-03_11-02-08,fp7d
2021-01-18,AR,6,6,0,6,2022-05-03_11-02-08,fp7d
2021-01-18,BE,104,107,8,99,2022-05-03_11-02-08,fp7d
2021-01-18,BL,20,18,0,18,2022-05-03_11-02-08,fp7d
2021-01-18,BS,54,50,0,50,2022-05-03_11-02-08,fp7d
2021-01-18,FR,24,24,0,24,2022-05-03_11-02-08,fp7d
2021-01-18,GE,38,59,21,38,2022-05-03_11-02-08,fp7d
2021-01-18,GL,6,4,0,4,2022-05-03_11-02-08,fp7d
2021-01-18,GR,16,17,1,16,2022-05-03_11-02-08,fp7d
2021-01-18,JU,6,6,0,6,2022-05-03_11-02-08,fp7d
2021-01-18,LU,54,54,4,50,2022-05-03_11-02-08,fp7d
2021-01-18,NE,10,12,2,10,2022-05-03_11-02-08,fp7d
2021-01-18,NW,6,5,0,5,2022-05-03_11-02-08,fp7d
2021-01-18,OW,0,0,0,0,2022-05-03_11-02-08,fp7d
2021-01-18,SG,54,65,11,54,2022-05-03_11-02-08,fp7d
2021-01-18,SH,8,8,0,8,2022-05-03_11-02-08,fp7d
2021-01-18,SO,17,25,8,17,2022-05-03_11-02-08,fp7d
2021-01-18,SZ,12,10,0,10,2022-05-03_11-02-08,fp7d
2021-01-18,TG,21,38,17,21,2022-05-03_11-02-08,fp7d
2021-01-18,TI,53,78,33,45,2022-05-03_11-02-08,fp7d
2021-01-18,UR,6,6,0,6,2022-05-03_11-02-08,fp7d
2021-01-18,VD,85,121,36,85,2022-05-03_11-02-08,fp7d
2021-01-18,VS,20,25,5,20,2022-05-03_11-02-08,fp7d
2021-01-18,ZG,8,8,0,8,2022-05-03_11-02-08,fp7d
2021-01-18,ZH,190,216,30,186,2022-05-03_11-02-08,fp7d
2021-01-19,AG,52,52,2,50,2022-05-03_11-02-08,fp7d
2021-01-19,AI,0,0,0,0,2022-05-03_11-02-08,fp7d
2021-01-19,AR,6,6,0,6,2022-05-03_11-02-08,fp7d
2021-01-19,BE,104,107,8,99,2022-05-03_11-02-08,fp7d
2021-01-19,BL,20,18,0,18,2022-05-03_11-02-08,fp7d
2021-01-19,BS,54,50,0,50,2022-05-03_11-02-08,fp7d
2021-01-19,FR,24,24,0,24,2022-05-03_11-02-08,fp7d
2021-01-19,GE,38,59,21,38,2022-05-03_11-02-08,fp7d
2021-01-19,GL,6,5,0,5,2022-05-03_11-02-08,fp7d
2021-01-19,GR,16,17,1,16,2022-05-03_11-02-08,fp7d
2021-01-19,JU,6,6,0,6,2022-05-03_11-02-08,fp7d
2021-01-19,LU,54,54,4,50,2022-05-03_11-02-08,fp7d
2021-01-19,NE,10,12,2,10,2022-05-03_11-02-08,fp7d
2021-01-19,NW,6,5,0,5,2022-05-03_11-02-08,fp7d
2021-01-19,OW,0,0,0,0,2022-05-03_11-02-08,fp7d
2021-01-19,SG,54,65,11,54,2022-05-03_11-02-08,fp7d
2021-01-19,SH,8,8,0,8,2022-05-03_11-02-08,fp7d
2021-01-19,SO,17,25,8,17,2022-05-03_11-02-08,fp7d
2021-01-19,SZ,12,10,0,10,2022-05-03_11-02-08,fp7d
2021-01-19,TG,21,38,17,21,2022-05-03_11-02-08,fp7d
2021-01-19,TI,53,78,33,45,2022-05-03_11-02-08,fp7d
2021-01-19,UR,6,6,0,6,2022-05-03_11-02-08,fp7d
2021-01-19,VD,85,121,36,85,2022-05-03_11-02-08,fp7d
2021-01-19,VS,20,25,5,20,2022-05-03_11-02-08,fp7d
2021-01-19,ZG,8,8,0,8,2022-05-03_11-02-08,fp7d
2021-01-19,ZH,190,216,30,186,2022-05-03_11-02-08,fp7d
2021-01-20,AG,52,50,0,50,2022-05-03_11-02-08,fp7d
2021-01-20,AI,0,0,0,0,2022-05-03_11-02-08,fp7d
2021-01-20,AR,6,6,0,6,2022-05-03_11-02-08,fp7d
2021-01-20,BE,104,107,8,99,2022-05-03_11-02-08,fp7d
2021-01-20,BL,20,18,0,18,2022-05-03_11-02-08,fp7d
2021-01-20,BS,54,50,0,50,2022-05-03_11-02-08,fp7d
2021-01-20,FR,24,24,0,24,2022-05-03_11-02-08,fp7d
2021-01-20,GE,38,59,21,38,2022-05-03_11-02-08,fp7d
2021-01-20,GL,6,6,0,6,2022-05-03_11-02-08,fp7d
2021-01-20,GR,16,17,1,16,2022-05-03_11-02-08,fp7d
2021-01-20,JU,6,6,0,6,2022-05-03_11-02-08,fp7d
2021-01-20,LU,54,51,4,47,2022-05-03_11-02-08,fp7d
2021-01-20,NE,10,12,2,10,2022-05-03_11-02-08,fp7d
2021-01-20,NW,6,5,0,5,2022-05-03_11-02-08,fp7d
2021-01-20,OW,0,0,0,0,2022-05-03_11-02-08,fp7d
2021-01-20,SG,54,65,11,54,2022-05-03_11-02-08,fp7d
2021-01-20,SH,8,8,0,8,2022-05-03_11-02-08,fp7d
2021-01-20,SO,17,25,8,17,2022-05-03_11-02-08,fp7d
2021-01-20,SZ,12,10,0,10,2022-05-03_11-02-08,fp7d
2021-01-20,TG,21,38,17,21,2022-05-03_11-02-08,fp7d
2021-01-20,TI,53,78,33,45,2022-05-03_11-02-08,fp7d
2021-01-20,UR,6,6,0,6,2022-05-03_11-02-08,fp7d
2021-01-20,VD,85,121,36,85,2022-05-03_11-02-08,fp7d
2021-01-20,VS,20,25,5,20,2022-05-03_11-02-08,fp7d
2021-01-20,ZG,8,8,0,8,2022-05-03_11-02-08,fp7d
2021-01-20,ZH,190,215,31,184,2022-05-03_11-02-08,fp7d
2021-01-21,AG,52,52,2,50,2022-05-03_11-02-08,fp7d
2021-01-21,AI,0,0,0,0,2022-05-03_11-02-08,fp7d
2021-01-21,AR,6,6,0,6,2022-05-03_11-02-08,fp7d
2021-01-21,BE,104,107,8,99,2022-05-03_11-02-08,fp7d
2021-01-21,BL,20,18,0,18,2022-05-03_11-02-08,fp7d
2021-01-21,BS,54,50,0,50,2022-05-03_11-02-08,fp7d
2021-01-21,FR,24,24,0,24,2022-05-03_11-02-08,fp7d
2021-01-21,GE,38,59,21,38,2022-05-03_11-02-08,fp7d
2021-01-21,GL,6,6,0,6,2022-05-03_11-02-08,fp7d
2021-01-21,GR,16,17,1,16,2022-05-03_11-02-08,fp7d
2021-01-21,JU,6,6,0,6,2022-05-03_11-02-08,fp7d
2021-01-21,LU,54,51,4,47,2022-05-03_11-02-08,fp7d
2021-01-21,NE,10,12,2,10,2022-05-03_11-02-08,fp7d
2021-01-21,NW,6,5,0,5,2022-05-03_11-02-08,fp7d
2021-01-21,OW,0,0,0,0,2022-05-03_11-02-08,fp7d
2021-01-21,SG,54,65,11,54,2022-05-03_11-02-08,fp7d
2021-01-21,SH,8,8,0,8,2022-05-03_11-02-08,fp7d
2021-01-21,SO,17,25,8,17,2022-05-03_11-02-08,fp7d
2021-01-21,SZ,12,10,0,10,2022-05-03_11-02-08,fp7d
2021-01-21,TG,21,38,17,21,2022-05-03_11-02-08,fp7d
2021-01-21,TI,53,76,31,45,2022-05-03_11-02-08,fp7d
2021-01-21,UR,6,6,0,6,2022-05-03_11-02-08,fp7d
2021-01-21,VD,85,121,36,85,2022-05-03_11-02-08,fp7d
2021-01-21,VS,20,25,5,20,2022-05-03_11-02-08,fp7d
2021-01-21,ZG,8,8,0,8,2022-05-03_11-02-08,fp7d
2021-01-21,ZH,190,213,29,184,2022-05-03_11-02-08,fp7d
2021-01-22,AG,52,52,2,50,2022-05-03_11-02-08,fp7d
2021-01-22,AI,0,0,0,0,2022-05-03_11-02-08,fp7d
2021-01-22,AR,6,6,0,6,2022-05-03_11-02-08,fp7d
2021-01-22,BE,104,108,9,99,2022-05-03_11-02-08,fp7d
2021-01-22,BL,20,18,0,18,2022-05-03_11-02-08,fp7d
2021-01-22,BS,54,50,0,50,2022-05-03_11-02-08,fp7d
2021-01-22,FR,24,24,0,24,2022-05-03_11-02-08,fp7d
2021-01-22,GE,38,59,21,38,2022-05-03_11-02-08,fp7d
2021-01-22,GL,6,6,0,6,2022-05-03_11-02-08,fp7d
2021-01-22,GR,16,17,1,16,2022-05-03_11-02-08,fp7d
2021-01-22,JU,6,6,0,6,2022-05-03_11-02-08,fp7d
2021-01-22,LU,54,51,4,47,2022-05-03_11-02-08,fp7d
2021-01-22,NE,10,12,2,10,2022-05-03_11-02-08,fp7d
2021-01-22,NW,6,4,0,4,2022-05-03_11-02-08,fp7d
2021-01-22,OW,0,0,0,0,2022-05-03_11-02-08,fp7d
2021-01-22,SG,54,63,9,54,2022-05-03_11-02-08,fp7d
2021-01-22,SH,8,8,0,8,2022-05-03_11-02-08,fp7d
2021-01-22,SO,17,25,8,17,2022-05-03_11-02-08,fp7d
2021-01-22,SZ,12,10,0,10,2022-05-03_11-02-08,fp7d
2021-01-22,TG,21,38,17,21,2022-05-03_11-02-08,fp7d
2021-01-22,TI,53,73,27,46,2022-05-03_11-02-08,fp7d
2021-01-22,UR,6,6,0,6,2022-05-03_11-02-08,fp7d
2021-01-22,VD,85,118,33,85,2022-05-03_11-02-08,fp7d
2021-01-22,VS,20,25,5,20,2022-05-03_11-02-08,fp7d
2021-01-22,ZG,8,8,0,8,2022-05-03_11-02-08,fp7d
2021-01-22,ZH,190,214,30,184,2022-05-03_11-02-08,fp7d
2021-01-23,AG,52,50,0,50,2022-05-03_11-02-08,fp7d
2021-01-23,AI,0,0,0,0,2022-05-03_11-02-08,fp7d
2021-01-23,AR,6,6,0,6,2022-05-03_11-02-08,fp7d
2021-01-23,BE,104,108,9,99,2022-05-03_11-02-08,fp7d
2021-01-23,BL,20,18,0,18,2022-05-03_11-02-08,fp7d
2021-01-23,BS,54,50,0,50,2022-05-03_11-02-08,fp7d
2021-01-23,FR,24,24,0,24,2022-05-03_11-02-08,fp7d
2021-01-23,GE,38,59,21,38,2022-05-03_11-02-08,fp7d
2021-01-23,GL,6,6,0,6,2022-05-03_11-02-08,fp7d
2021-01-23,GR,16,17,1,16,2022-05-03_11-02-08,fp7d
2021-01-23,JU,6,6,0,6,2022-05-03_11-02-08,fp7d
2021-01-23,LU,54,51,4,47,2022-05-03_11-02-08,fp7d
2021-01-23,NE,10,12,2,10,2022-05-03_11-02-08,fp7d
2021-01-23,NW,6,4,0,4,2022-05-03_11-02-08,fp7d
2021-01-23,OW,0,0,0,0,2022-05-03_11-02-08,fp7d
2021-01-23,SG,54,63,9,54,2022-05-03_11-02-08,fp7d
2021-01-23,SH,8,8,0,8,2022-05-03_11-02-08,fp7d
2021-01-23,SO,17,25,8,17,2022-05-03_11-02-08,fp7d
2021-01-23,SZ,12,10,0,10,2022-05-03_11-02-08,fp7d
2021-01-23,TG,21,38,17,21,2022-05-03_11-02-08,fp7d
2021-01-23,TI,53,73,27,46,2022-05-03_11-02-08,fp7d
2021-01-23,UR,6,6,0,6,2022-05-03_11-02-08,fp7d
2021-01-23,VD,85,118,33,85,2022-05-03_11-02-08,fp7d
2021-01-23,VS,20,25,5,20,2022-05-03_11-02-08,fp7d
2021-01-23,ZG,8,8,0,8,2022-05-03_11-02-08,fp7d
2021-01-23,ZH,190,214,30,184,2022-05-03_11-02-08,fp7d
2021-01-24,AG,52,50,0,50,2022-05-03_11-02-08,fp7d
2021-01-24,AI,0,0,0,0,2022-05-03_11-02-08,fp7d
2021-01-24,AR,6,6,0,6,2022-05-03_11-02-08,fp7d
2021-01-24,BE,104,107,8,99,2022-05-03_11-02-08,fp7d
2021-01-24,BL,20,18,0,18,2022-05-03_11-02-08,fp7d
2021-01-24,BS,54,50,0,50,2022-05-03_11-02-08,fp7d
2021-01-24,FR,24,24,0,24,2022-05-03_11-02-08,fp7d
2021-01-24,GE,38,59,21,38,2022-05-03_11-02-08,fp7d
2021-01-24,GL,6,6,0,6,2022-05-03_11-02-08,fp7d
2021-01-24,GR,16,17,1,16,2022-05-03_11-02-08,fp7d
2021-01-24,JU,6,6,0,6,2022-05-03_11-02-08,fp7d
2021-01-24,LU,54,51,4,47,2022-05-03_11-02-08,fp7d
2021-01-24,NE,10,12,2,10,2022-05-03_11-02-08,fp7d
2021-01-24,NW,6,4,0,4,2022-05-03_11-02-08,fp7d
2021-01-24,OW,0,0,0,0,2022-05-03_11-02-08,fp7d
2021-01-24,SG,54,63,9,54,2022-05-03_11-02-08,fp7d
2021-01-24,SH,8,8,0,8,2022-05-03_11-02-08,fp7d
2021-01-24,SO,17,25,8,17,2022-05-03_11-02-08,fp7d
2021-01-24,SZ,12,10,0,10,2022-05-03_11-02-08,fp7d
2021-01-24,TG,21,38,17,21,2022-05-03_11-02-08,fp7d
2021-01-24,TI,53,73,27,46,2022-05-03_11-02-08,fp7d
2021-01-24,UR,6,6,0,6,2022-05-03_11-02-08,fp7d
2021-01-24,VD,85,119,34,85,2022-05-03_11-02-08,fp7d
2021-01-24,VS,20,25,5,20,2022-05-03_11-02-08,fp7d
2021-01-24,ZG,8,8,0,8,2022-05-03_11-02-08,fp7d
2021-01-24,ZH,190,214,30,184,2022-05-03_11-02-08,fp7d
2021-01-25,AG,52,50,0,50,2022-05-03_11-02-08,fp7d
2021-01-25,AI,0,0,0,0,2022-05-03_11-02-08,fp7d
2021-01-25,AR,6,6,0,6,2022-05-03_11-02-08,fp7d
2021-01-25,BE,104,107,8,99,2022-05-03_11-02-08,fp7d
2021-01-25,BL,20,18,0,18,2022-05-03_11-02-08,fp7d
2021-01-25,BS,54,50,0,50,2022-05-03_11-02-08,fp7d
2021-01-25,FR,24,24,0,24,2022-05-03_11-02-08,fp7d
2021-01-25,GE,38,59,21,38,2022-05-03_11-02-08,fp7d
2021-01-25,GL,6,6,0,6,2022-05-03_11-02-08,fp7d
2021-01-25,GR,16,17,1,16,2022-05-03_11-02-08,fp7d
2021-01-25,JU,6,6,0,6,2022-05-03_11-02-08,fp7d
2021-01-25,LU,54,51,4,47,2022-05-03_11-02-08,fp7d
2021-01-25,NE,10,12,2,10,2022-05-03_11-02-08,fp7d
2021-01-25,NW,6,4,0,4,2022-05-03_11-02-08,fp7d
2021-01-25,OW,0,0,0,0,2022-05-03_11-02-08,fp7d
2021-01-25,SG,54,63,9,54,2022-05-03_11-02-08,fp7d
2021-01-25,SH,8,8,0,8,2022-05-03_11-02-08,fp7d
2021-01-25,SO,17,25,8,17,2022-05-03_11-02-08,fp7d
2021-01-25,SZ,12,10,0,10,2022-05-03_11-02-08,fp7d
2021-01-25,TG,21,38,17,21,2022-05-03_11-02-08,fp7d
2021-01-25,TI,53,73,27,46,2022-05-03_11-02-08,fp7d
2021-01-25,UR,6,6,0,6,2022-05-03_11-02-08,fp7d
2021-01-25,VD,85,118,33,85,2022-05-03_11-02-08,fp7d
2021-01-25,VS,20,25,5,20,2022-05-03_11-02-08,fp7d
2021-01-25,ZG,8,8,0,8,2022-05-03_11-02-08,fp7d
2021-01-25,ZH,190,214,30,184,2022-05-03_11-02-08,fp7d
2021-01-26,AG,52,50,0,50,2022-05-03_11-02-08,fp7d
2021-01-26,AI,0,0,0,0,2022-05-03_11-02-08,fp7d
2021-01-26,AR,6,6,0,6,2022-05-03_11-02-08,fp7d
2021-01-26,BE,104,106,8,98,2022-05-03_11-02-08,fp7d
2021-01-26,BL,20,18,0,18,2022-05-03_11-02-08,fp7d
2021-01-26,BS,54,50,0,50,2022-05-03_11-02-08,fp7d
2021-01-26,FR,24,24,0,24,2022-05-03_11-02-08,fp7d
2021-01-26,GE,38,59,21,38,2022-05-03_11-02-08,fp7d
2021-01-26,GL,6,6,0,6,2022-05-03_11-02-08,fp7d
2021-01-26,GR,16,17,1,16,2022-05-03_11-02-08,fp7d
2021-01-26,JU,6,6,0,6,2022-05-03_11-02-08,fp7d
2021-01-26,LU,54,51,4,47,2022-05-03_11-02-08,fp7d
2021-01-26,NE,10,12,2,10,2022-05-03_11-02-08,fp7d
2021-01-26,NW,6,4,0,4,2022-05-03_11-02-08,fp7d
2021-01-26,OW,0,0,0,0,2022-05-03_11-02-08,fp7d
2021-01-26,SG,54,63,9,54,2022-05-03_11-02-08,fp7d
2021-01-26,SH,8,8,0,8,2022-05-03_11-02-08,fp7d
2021-01-26,SO,17,25,8,17,2022-05-03_11-02-08,fp7d
2021-01-26,SZ,12,10,0,10,2022-05-03_11-02-08,fp7d
2021-01-26,TG,21,38,17,21,2022-05-03_11-02-08,fp7d
2021-01-26,TI,53,73,27,46,2022-05-03_11-02-08,fp7d
2021-01-26,UR,6,6,0,6,2022-05-03_11-02-08,fp7d
2021-01-26,VD,85,119,34,85,2022-05-03_11-02-08,fp7d
2021-01-26,VS,20,25,5,20,2022-05-03_11-02-08,fp7d
2021-01-26,ZG,8,8,0,8,2022-05-03_11-02-08,fp7d
2021-01-26,ZH,190,210,29,181,2022-05-03_11-02-08,fp7d
2021-01-27,AG,52,50,0,50,2022-05-03_11-02-08,fp7d
2021-01-27,AI,0,0,0,0,2022-05-03_11-02-08,fp7d
2021-01-27,AR,6,6,0,6,2022-05-03_11-02-08,fp7d
2021-01-27,BE,104,106,8,98,2022-05-03_11-02-08,fp7d
2021-01-27,BL,20,18,0,18,2022-05-03_11-02-08,fp7d
2021-01-27,BS,54,50,0,50,2022-05-03_11-02-08,fp7d
2021-01-27,FR,24,24,0,24,2022-05-03_11-02-08,fp7d
2021-01-27,GE,38,59,21,38,2022-05-03_11-02-08,fp7d
2021-01-27,GL,6,6,0,6,2022-05-03_11-02-08,fp7d
2021-01-27,GR,16,17,1,16,2022-05-03_11-02-08,fp7d
2021-01-27,JU,6,6,0,6,2022-05-03_11-02-08,fp7d
2021-01-27,LU,54,51,4,47,2022-05-03_11-02-08,fp7d
2021-01-27,NE,10,12,2,10,2022-05-03_11-02-08,fp7d
2021-01-27,NW,6,4,0,4,2022-05-03_11-02-08,fp7d
2021-01-27,OW,0,0,0,0,2022-05-03_11-02-08,fp7d
2021-01-27,SG,54,63,9,54,2022-05-03_11-02-08,fp7d
2021-01-27,SH,8,8,0,8,2022-05-03_11-02-08,fp7d
2021-01-27,SO,17,25,8,17,2022-05-03_11-02-08,fp7d
2021-01-27,SZ,12,10,0,10,2022-05-03_11-02-08,fp7d
2021-01-27,TG,21,38,17,21,2022-05-03_11-02-08,fp7d
2021-01-27,TI,53,73,27,46,2022-05-03_11-02-08,fp7d
2021-01-27,UR,6,6,0,6,2022-05-03_11-02-08,fp7d
2021-01-27,VD,85,119,34,85,2022-05-03_11-02-08,fp7d
2021-01-27,VS,20,25,5,20,2022-05-03_11-02-08,fp7d
2021-01-27,ZG,8,8,0,8,2022-05-03_11-02-08,fp7d
2021-01-27,ZH,190,212,30,182,2022-05-03_11-02-08,fp7d
2021-01-28,AG,52,52,0,52,2022-05-03_11-02-08,fp7d
2021-01-28,AI,0,0,0,0,2022-05-03_11-02-08,fp7d
2021-01-28,AR,6,6,0,6,2022-05-03_11-02-08,fp7d
2021-01-28,BE,104,106,8,98,2022-05-03_11-02-08,fp7d
2021-01-28,BL,20,18,0,18,2022-05-03_11-02-08,fp7d
2021-01-28,BS,54,50,0,50,2022-05-03_11-02-08,fp7d
2021-01-28,FR,24,24,0,24,2022-05-03_11-02-08,fp7d
2021-01-28,GE,38,59,21,38,2022-05-03_11-02-08,fp7d
2021-01-28,GL,6,6,0,6,2022-05-03_11-02-08,fp7d
2021-01-28,GR,16,17,1,16,2022-05-03_11-02-08,fp7d
2021-01-28,JU,6,6,0,6,2022-05-03_11-02-08,fp7d
2021-01-28,LU,40,41,4,37,2022-05-03_11-02-08,fp7d
2021-01-28,NE,10,12,2,10,2022-05-03_11-02-08,fp7d
2021-01-28,NW,6,4,0,4,2022-05-03_11-02-08,fp7d
2021-01-28,OW,0,0,0,0,2022-05-03_11-02-08,fp7d
2021-01-28,SG,54,63,9,54,2022-05-03_11-02-08,fp7d
2021-01-28,SH,8,8,0,8,2022-05-03_11-02-08,fp7d
2021-01-28,SO,17,25,8,17,2022-05-03_11-02-08,fp7d
2021-01-28,SZ,12,10,0,10,2022-05-03_11-02-08,fp7d
2021-01-28,TG,21,38,17,21,2022-05-03_11-02-08,fp7d
2021-01-28,TI,53,73,27,46,2022-05-03_11-02-08,fp7d
2021-01-28,UR,6,6,0,6,2022-05-03_11-02-08,fp7d
2021-01-28,VD,85,119,34,85,2022-05-03_11-02-08,fp7d
2021-01-28,VS,20,25,5,20,2022-05-03_11-02-08,fp7d
2021-01-28,ZG,8,8,0,8,2022-05-03_11-02-08,fp7d
2021-01-28,ZH,190,214,31,183,2022-05-03_11-02-08,fp7d
2021-01-29,AG,52,50,0,50,2022-05-03_11-02-08,fp7d
2021-01-29,AI,0,0,0,0,2022-05-03_11-02-08,fp7d
2021-01-29,AR,6,6,0,6,2022-05-03_11-02-08,fp7d
2021-01-29,BE,104,105,8,97,2022-05-03_11-02-08,fp7d
2021-01-29,BL,20,18,0,18,2022-05-03_11-02-08,fp7d
2021-01-29,BS,54,50,0,50,2022-05-03_11-02-08,fp7d
2021-01-29,FR,24,24,0,24,2022-05-03_11-02-08,fp7d
2021-01-29,GE,38,59,21,38,2022-05-03_11-02-08,fp7d
2021-01-29,GL,6,6,0,6,2022-05-03_11-02-08,fp7d
2021-01-29,GR,16,17,1,16,2022-05-03_11-02-08,fp7d
2021-01-29,JU,6,6,0,6,2022-05-03_11-02-08,fp7d
2021-01-29,LU,40,41,4,37,2022-05-03_11-02-08,fp7d
2021-01-29,NE,10,12,2,10,2022-05-03_11-02-08,fp7d
2021-01-29,NW,6,4,0,4,2022-05-03_11-02-08,fp7d
2021-01-29,OW,0,0,0,0,2022-05-03_11-02-08,fp7d
2021-01-29,SG,54,63,9,54,2022-05-03_11-02-08,fp7d
2021-01-29,SH,8,8,0,8,2022-05-03_11-02-08,fp7d
2021-01-29,SO,17,25,8,17,2022-05-03_11-02-08,fp7d
2021-01-29,SZ,12,11,0,11,2022-05-03_11-02-08,fp7d
2021-01-29,TG,21,38,17,21,2022-05-03_11-02-08,fp7d
2021-01-29,TI,53,71,25,46,2022-05-03_11-02-08,fp7d
2021-01-29,UR,6,6,0,6,2022-05-03_11-02-08,fp7d
2021-01-29,VD,85,116,31,85,2022-05-03_11-02-08,fp7d
2021-01-29,VS,20,25,5,20,2022-05-03_11-02-08,fp7d
2021-01-29,ZG,8,8,0,8,2022-05-03_11-02-08,fp7d
2021-01-29,ZH,190,219,32,187,2022-05-03_11-02-08,fp7d
2021-01-30,AG,52,50,0,50,2022-05-03_11-02-08,fp7d
2021-01-30,AI,0,0,0,0,2022-05-03_11-02-08,fp7d
2021-01-30,AR,6,6,0,6,2022-05-03_11-02-08,fp7d
2021-01-30,BE,104,105,8,97,2022-05-03_11-02-08,fp7d
2021-01-30,BL,20,18,0,18,2022-05-03_11-02-08,fp7d
2021-01-30,BS,54,50,0,50,2022-05-03_11-02-08,fp7d
2021-01-30,FR,24,24,0,24,2022-05-03_11-02-08,fp7d
2021-01-30,GE,38,59,21,38,2022-05-03_11-02-08,fp7d
2021-01-30,GL,6,6,0,6,2022-05-03_11-02-08,fp7d
2021-01-30,GR,16,17,1,16,2022-05-03_11-02-08,fp7d
2021-01-30,JU,6,6,0,6,2022-05-03_11-02-08,fp7d
2021-01-30,LU,40,41,4,37,2022-05-03_11-02-08,fp7d
2021-01-30,NE,10,12,2,10,2022-05-03_11-02-08,fp7d
2021-01-30,NW,6,4,0,4,2022-05-03_11-02-08,fp7d
2021-01-30,OW,0,0,0,0,2022-05-03_11-02-08,fp7d
2021-01-30,SG,54,63,9,54,2022-05-03_11-02-08,fp7d
2021-01-30,SH,8,8,0,8,2022-05-03_11-02-08,fp7d
2021-01-30,SO,17,25,8,17,2022-05-03_11-02-08,fp7d
2021-01-30,SZ,12,11,0,11,2022-05-03_11-02-08,fp7d
2021-01-30,TG,21,38,17,21,2022-05-03_11-02-08,fp7d
2021-01-30,TI,53,71,25,46,2022-05-03_11-02-08,fp7d
2021-01-30,UR,6,6,0,6,2022-05-03_11-02-08,fp7d
2021-01-30,VD,85,116,31,85,2022-05-03_11-02-08,fp7d
2021-01-30,VS,20,25,5,20,2022-05-03_11-02-08,fp7d
2021-01-30,ZG,8,7,0,7,2022-05-03_11-02-08,fp7d
2021-01-30,ZH,190,212,30,182,2022-05-03_11-02-08,fp7d
2021-01-31,AG,52,50,0,50,2022-05-03_11-02-08,fp7d
2021-01-31,AI,0,0,0,0,2022-05-03_11-02-08,fp7d
2021-01-31,AR,6,6,0,6,2022-05-03_11-02-08,fp7d
2021-01-31,BE,104,103,6,97,2022-05-03_11-02-08,fp7d
2021-01-31,BL,20,18,0,18,2022-05-03_11-02-08,fp7d
2021-01-31,BS,54,50,0,50,2022-05-03_11-02-08,fp7d
2021-01-31,FR,24,24,0,24,2022-05-03_11-02-08,fp7d
2021-01-31,GE,38,59,21,38,2022-05-03_11-02-08,fp7d
2021-01-31,GL,6,6,0,6,2022-05-03_11-02-08,fp7d
2021-01-31,GR,16,17,1,16,2022-05-03_11-02-08,fp7d
2021-01-31,JU,6,6,0,6,2022-05-03_11-02-08,fp7d
2021-01-31,LU,40,41,4,37,2022-05-03_11-02-08,fp7d
2021-01-31,NE,10,12,2,10,2022-05-03_11-02-08,fp7d
2021-01-31,NW,6,4,0,4,2022-05-03_11-02-08,fp7d
2021-01-31,OW,0,0,0,0,2022-05-03_11-02-08,fp7d
2021-01-31,SG,54,63,9,54,2022-05-03_11-02-08,fp7d
2021-01-31,SH,8,8,0,8,2022-05-03_11-02-08,fp7d
2021-01-31,SO,17,25,8,17,2022-05-03_11-02-08,fp7d
2021-01-31,SZ,12,11,0,11,2022-05-03_11-02-08,fp7d
2021-01-31,TG,21,38,17,21,2022-05-03_11-02-08,fp7d
2021-01-31,TI,53,71,25,46,2022-05-03_11-02-08,fp7d
2021-01-31,UR,6,6,0,6,2022-05-03_11-02-08,fp7d
2021-01-31,VD,85,116,31,85,2022-05-03_11-02-08,fp7d
2021-01-31,VS,20,25,5,20,2022-05-03_11-02-08,fp7d
2021-01-31,ZG,8,7,0,7,2022-05-03_11-02-08,fp7d
2021-01-31,ZH,190,210,29,181,2022-05-03_11-02-08,fp7d
2021-02-01,AG,52,51,0,51,2022-05-03_11-02-08,fp7d
2021-02-01,AI,0,0,0,0,2022-05-03_11-02-08,fp7d
2021-02-01,AR,6,6,0,6,2022-05-03_11-02-08,fp7d
2021-02-01,BE,104,103,6,97,2022-05-03_11-02-08,fp7d
2021-02-01,BL,20,18,0,18,2022-05-03_11-02-08,fp7d
2021-02-01,BS,54,50,0,50,2022-05-03_11-02-08,fp7d
2021-02-01,FR,24,24,0,24,2022-05-03_11-02-08,fp7d
2021-02-01,GE,38,59,21,38,2022-05-03_11-02-08,fp7d
2021-02-01,GL,6,6,0,6,2022-05-03_11-02-08,fp7d
2021-02-01,GR,16,17,1,16,2022-05-03_11-02-08,fp7d
2021-02-01,JU,6,6,0,6,2022-05-03_11-02-08,fp7d
2021-02-01,LU,54,49,2,47,2022-05-03_11-02-08,fp7d
2021-02-01,NE,10,12,2,10,2022-05-03_11-02-08,fp7d
2021-02-01,NW,6,5,0,5,2022-05-03_11-02-08,fp7d
2021-02-01,OW,0,0,0,0,2022-05-03_11-02-08,fp7d
2021-02-01,SG,54,63,9,54,2022-05-03_11-02-08,fp7d
2021-02-01,SH,8,8,0,8,2022-05-03_11-02-08,fp7d
2021-02-01,SO,17,25,8,17,2022-05-03_11-02-08,fp7d
2021-02-01,SZ,12,11,0,11,2022-05-03_11-02-08,fp7d
2021-02-01,TG,21,38,17,21,2022-05-03_11-02-08,fp7d
2021-02-01,TI,53,67,21,46,2022-05-03_11-02-08,fp7d
2021-02-01,UR,6,6,0,6,2022-05-03_11-02-08,fp7d
2021-02-01,VD,85,116,31,85,2022-05-03_11-02-08,fp7d
2021-02-01,VS,20,25,5,20,2022-05-03_11-02-08,fp7d
2021-02-01,ZG,8,5,0,5,2022-05-03_11-02-08,fp7d
2021-02-01,ZH,190,212,29,183,2022-05-03_11-02-08,fp7d
2021-02-02,AG,52,50,0,50,2022-05-03_11-02-08,fp7d
2021-02-02,AI,0,0,0,0,2022-05-03_11-02-08,fp7d
2021-02-02,AR,6,6,0,6,2022-05-03_11-02-08,fp7d
2021-02-02,BE,104,103,6,97,2022-05-03_11-02-08,fp7d
2021-02-02,BL,20,18,0,18,2022-05-03_11-02-08,fp7d
2021-02-02,BS,54,50,0,50,2022-05-03_11-02-08,fp7d
2021-02-02,FR,24,24,0,24,2022-05-03_11-02-08,fp7d
2021-02-02,GE,38,59,21,38,2022-05-03_11-02-08,fp7d
2021-02-02,GL,6,6,0,6,2022-05-03_11-02-08,fp7d
2021-02-02,GR,16,17,1,16,2022-05-03_11-02-08,fp7d
2021-02-02,JU,6,6,0,6,2022-05-03_11-02-08,fp7d
2021-02-02,LU,54,49,2,47,2022-05-03_11-02-08,fp7d
2021-02-02,NE,10,12,2,10,2022-05-03_11-02-08,fp7d
2021-02-02,NW,6,5,0,5,2022-05-03_11-02-08,fp7d
2021-02-02,OW,0,0,0,0,2022-05-03_11-02-08,fp7d
2021-02-02,SG,54,65,11,54,2022-05-03_11-02-08,fp7d
2021-02-02,SH,8,8,0,8,2022-05-03_11-02-08,fp7d
2021-02-02,SO,17,25,8,17,2022-05-03_11-02-08,fp7d
2021-02-02,SZ,12,11,0,11,2022-05-03_11-02-08,fp7d
2021-02-02,TG,21,38,17,21,2022-05-03_11-02-08,fp7d
2021-02-02,TI,53,67,21,46,2022-05-03_11-02-08,fp7d
2021-02-02,UR,6,6,0,6,2022-05-03_11-02-08,fp7d
2021-02-02,VD,85,116,31,85,2022-05-03_11-02-08,fp7d
2021-02-02,VS,20,25,5,20,2022-05-03_11-02-08,fp7d
2021-02-02,ZG,8,6,0,6,2022-05-03_11-02-08,fp7d
2021-02-02,ZH,190,213,30,183,2022-05-03_11-02-08,fp7d
2021-02-03,AG,52,50,0,50,2022-05-03_11-02-08,fp7d
2021-02-03,AI,0,0,0,0,2022-05-03_11-02-08,fp7d
2021-02-03,AR,6,6,0,6,2022-05-03_11-02-08,fp7d
2021-02-03,BE,104,103,6,97,2022-05-03_11-02-08,fp7d
2021-02-03,BL,20,18,0,18,2022-05-03_11-02-08,fp7d
2021-02-03,BS,54,50,0,50,2022-05-03_11-02-08,fp7d
2021-02-03,FR,24,24,0,24,2022-05-03_11-02-08,fp7d
2021-02-03,GE,38,59,21,38,2022-05-03_11-02-08,fp7d
2021-02-03,GL,6,6,0,6,2022-05-03_11-02-08,fp7d
2021-02-03,GR,16,17,1,16,2022-05-03_11-02-08,fp7d
2021-02-03,JU,6,6,0,6,2022-05-03_11-02-08,fp7d
2021-02-03,LU,54,49,2,47,2022-05-03_11-02-08,fp7d
2021-02-03,NE,10,12,2,10,2022-05-03_11-02-08,fp7d
2021-02-03,NW,6,5,0,5,2022-05-03_11-02-08,fp7d
2021-02-03,OW,0,0,0,0,2022-05-03_11-02-08,fp7d
2021-02-03,SG,54,61,7,54,2022-05-03_11-02-08,fp7d
2021-02-03,SH,8,8,0,8,2022-05-03_11-02-08,fp7d
2021-02-03,SO,17,25,8,17,2022-05-03_11-02-08,fp7d
2021-02-03,SZ,12,12,0,12,2022-05-03_11-02-08,fp7d
2021-02-03,TG,21,38,17,21,2022-05-03_11-02-08,fp7d
2021-02-03,TI,53,67,21,46,2022-05-03_11-02-08,fp7d
2021-02-03,UR,6,6,0,6,2022-05-03_11-02-08,fp7d
2021-02-03,VD,85,116,31,85,2022-05-03_11-02-08,fp7d
2021-02-03,VS,20,25,5,20,2022-05-03_11-02-08,fp7d
2021-02-03,ZG,8,6,0,6,2022-05-03_11-02-08,fp7d
2021-02-03,ZH,190,212,29,183,2022-05-03_11-02-08,fp7d
2021-02-04,AG,52,50,0,50,2022-05-03_11-02-08,fp7d
2021-02-04,AI,0,0,0,0,2022-05-03_11-02-08,fp7d
2021-02-04,AR,6,6,0,6,2022-05-03_11-02-08,fp7d
2021-02-04,BE,104,105,6,99,2022-05-03_11-02-08,fp7d
2021-02-04,BL,20,18,0,18,2022-05-03_11-02-08,fp7d
2021-02-04,BS,54,50,0,50,2022-05-03_11-02-08,fp7d
2021-02-04,FR,24,24,0,24,2022-05-03_11-02-08,fp7d
2021-02-04,GE,38,59,21,38,2022-05-03_11-02-08,fp7d
2021-02-04,GL,6,6,0,6,2022-05-03_11-02-08,fp7d
2021-02-04,GR,16,17,1,16,2022-05-03_11-02-08,fp7d
2021-02-04,JU,6,6,0,6,2022-05-03_11-02-08,fp7d
2021-02-04,LU,54,49,2,47,2022-05-03_11-02-08,fp7d
2021-02-04,NE,10,12,2,10,2022-05-03_11-02-08,fp7d
2021-02-04,NW,6,5,0,5,2022-05-03_11-02-08,fp7d
2021-02-04,OW,0,0,0,0,2022-05-03_11-02-08,fp7d
2021-02-04,SG,54,61,7,54,2022-05-03_11-02-08,fp7d
2021-02-04,SH,8,8,0,8,2022-05-03_11-02-08,fp7d
2021-02-04,SO,17,25,8,17,2022-05-03_11-02-08,fp7d
2021-02-04,SZ,12,12,0,12,2022-05-03_11-02-08,fp7d
2021-02-04,TG,21,38,17,21,2022-05-03_11-02-08,fp7d
2021-02-04,TI,53,68,21,47,2022-05-03_11-02-08,fp7d
2021-02-04,UR,6,6,0,6,2022-05-03_11-02-08,fp7d
2021-02-04,VD,85,115,30,85,2022-05-03_11-02-08,fp7d
2021-02-04,VS,20,25,5,20,2022-05-03_11-02-08,fp7d
2021-02-04,ZG,8,7,0,7,2022-05-03_11-02-08,fp7d
2021-02-04,ZH,190,210,27,183,2022-05-03_11-02-08,fp7d
2021-02-05,AG,52,50,0,50,2022-05-03_11-02-08,fp7d
2021-02-05,AI,0,0,0,0,2022-05-03_11-02-08,fp7d
2021-02-05,AR,6,6,0,6,2022-05-03_11-02-08,fp7d
2021-02-05,BE,104,103,6,97,2022-05-03_11-02-08,fp7d
2021-02-05,BL,20,18,0,18,2022-05-03_11-02-08,fp7d
2021-02-05,BS,54,50,0,50,2022-05-03_11-02-08,fp7d
2021-02-05,FR,24,24,0,24,2022-05-03_11-02-08,fp7d
2021-02-05,GE,38,59,21,38,2022-05-03_11-02-08,fp7d
2021-02-05,GL,6,6,0,6,2022-05-03_11-02-08,fp7d
2021-02-05,GR,16,17,1,16,2022-05-03_11-02-08,fp7d
2021-02-05,JU,6,6,0,6,2022-05-03_11-02-08,fp7d
2021-02-05,LU,54,52,2,50,2022-05-03_11-02-08,fp7d
2021-02-05,NE,10,12,2,10,2022-05-03_11-02-08,fp7d
2021-02-05,NW,6,5,0,5,2022-05-03_11-02-08,fp7d
2021-02-05,OW,0,0,0,0,2022-05-03_11-02-08,fp7d
2021-02-05,SG,54,61,7,54,2022-05-03_11-02-08,fp7d
2021-02-05,SH,8,8,0,8,2022-05-03_11-02-08,fp7d
2021-02-05,SO,17,25,8,17,2022-05-03_11-02-08,fp7d
2021-02-05,SZ,12,12,0,12,2022-05-03_11-02-08,fp7d
2021-02-05,TG,21,38,17,21,2022-05-03_11-02-08,fp7d
2021-02-05,TI,55,70,21,49,2022-05-03_11-02-08,fp7d
2021-02-05,UR,6,6,0,6,2022-05-03_11-02-08,fp7d
2021-02-05,VD,85,115,30,85,2022-05-03_11-02-08,fp7d
2021-02-05,VS,20,25,5,20,2022-05-03_11-02-08,fp7d
2021-02-05,ZG,8,7,0,7,2022-05-03_11-02-08,fp7d
2021-02-05,ZH,190,206,27,179,2022-05-03_11-02-08,fp7d
2021-02-06,AG,52,50,0,50,2022-05-03_11-02-08,fp7d
2021-02-06,AI,0,0,0,0,2022-05-03_11-02-08,fp7d
2021-02-06,AR,6,6,0,6,2022-05-03_11-02-08,fp7d
2021-02-06,BE,104,103,6,97,2022-05-03_11-02-08,fp7d
2021-02-06,BL,20,18,0,18,2022-05-03_11-02-08,fp7d
2021-02-06,BS,54,50,0,50,2022-05-03_11-02-08,fp7d
2021-02-06,FR,24,24,0,24,2022-05-03_11-02-08,fp7d
2021-02-06,GE,38,59,21,38,2022-05-03_11-02-08,fp7d
2021-02-06,GL,6,6,0,6,2022-05-03_11-02-08,fp7d
2021-02-06,GR,16,17,1,16,2022-05-03_11-02-08,fp7d
2021-02-06,JU,6,6,0,6,2022-05-03_11-02-08,fp7d
2021-02-06,LU,54,52,2,50,2022-05-03_11-02-08,fp7d
2021-02-06,NE,10,12,2,10,2022-05-03_11-02-08,fp7d
2021-02-06,NW,6,5,0,5,2022-05-03_11-02-08,fp7d
2021-02-06,OW,0,0,0,0,2022-05-03_11-02-08,fp7d
2021-02-06,SG,54,61,7,54,2022-05-03_11-02-08,fp7d
2021-02-06,SH,8,8,0,8,2022-05-03_11-02-08,fp7d
2021-02-06,SO,17,25,8,17,2022-05-03_11-02-08,fp7d
2021-02-06,SZ,12,12,0,12,2022-05-03_11-02-08,fp7d
2021-02-06,TG,21,38,17,21,2022-05-03_11-02-08,fp7d
2021-02-06,TI,55,70,21,49,2022-05-03_11-02-08,fp7d
2021-02-06,UR,6,6,0,6,2022-05-03_11-02-08,fp7d
2021-02-06,VD,85,115,30,85,2022-05-03_11-02-08,fp7d
2021-02-06,VS,20,25,5,20,2022-05-03_11-02-08,fp7d
2021-02-06,ZG,8,7,0,7,2022-05-03_11-02-08,fp7d
2021-02-06,ZH,190,208,27,181,2022-05-03_11-02-08,fp7d
2021-02-07,AG,52,50,0,50,2022-05-03_11-02-08,fp7d
2021-02-07,AI,0,0,0,0,2022-05-03_11-02-08,fp7d
2021-02-07,AR,6,6,0,6,2022-05-03_11-02-08,fp7d
2021-02-07,BE,104,99,6,93,2022-05-03_11-02-08,fp7d
2021-02-07,BL,20,18,0,18,2022-05-03_11-02-08,fp7d
2021-02-07,BS,54,50,0,50,2022-05-03_11-02-08,fp7d
2021-02-07,FR,24,24,0,24,2022-05-03_11-02-08,fp7d
2021-02-07,GE,38,59,21,38,2022-05-03_11-02-08,fp7d
2021-02-07,GL,6,6,0,6,2022-05-03_11-02-08,fp7d
2021-02-07,GR,16,17,1,16,2022-05-03_11-02-08,fp7d
2021-02-07,JU,6,6,0,6,2022-05-03_11-02-08,fp7d
2021-02-07,LU,54,52,2,50,2022-05-03_11-02-08,fp7d
2021-02-07,NE,10,12,2,10,2022-05-03_11-02-08,fp7d
2021-02-07,NW,6,5,0,5,2022-05-03_11-02-08,fp7d
2021-02-07,OW,0,0,0,0,2022-05-03_11-02-08,fp7d
2021-02-07,SG,54,61,7,54,2022-05-03_11-02-08,fp7d
2021-02-07,SH,8,8,0,8,2022-05-03_11-02-08,fp7d
2021-02-07,SO,17,25,8,17,2022-05-03_11-02-08,fp7d
2021-02-07,SZ,12,12,0,12,2022-05-03_11-02-08,fp7d
2021-02-07,TG,21,38,17,21,2022-05-03_11-02-08,fp7d
2021-02-07,TI,55,70,21,49,2022-05-03_11-02-08,fp7d
2021-02-07,UR,6,6,0,6,2022-05-03_11-02-08,fp7d
2021-02-07,VD,85,115,30,85,2022-05-03_11-02-08,fp7d
2021-02-07,VS,20,25,5,20,2022-05-03_11-02-08,fp7d
2021-02-07,ZG,8,7,0,7,2022-05-03_11-02-08,fp7d
2021-02-07,ZH,190,208,27,181,2022-05-03_11-02-08,fp7d
2021-02-08,AG,52,48,0,48,2022-05-03_11-02-08,fp7d
2021-02-08,AI,0,0,0,0,2022-05-03_11-02-08,fp7d
2021-02-08,AR,6,6,0,6,2022-05-03_11-02-08,fp7d
2021-02-08,BE,104,104,6,98,2022-05-03_11-02-08,fp7d
2021-02-08,BL,20,18,0,18,2022-05-03_11-02-08,fp7d
2021-02-08,BS,54,50,0,50,2022-05-03_11-02-08,fp7d
2021-02-08,FR,24,24,0,24,2022-05-03_11-02-08,fp7d
2021-02-08,GE,38,59,21,38,2022-05-03_11-02-08,fp7d
2021-02-08,GL,6,6,0,6,2022-05-03_11-02-08,fp7d
2021-02-08,GR,16,17,1,16,2022-05-03_11-02-08,fp7d
2021-02-08,JU,6,6,0,6,2022-05-03_11-02-08,fp7d
2021-02-08,LU,54,52,2,50,2022-05-03_11-02-08,fp7d
2021-02-08,NE,10,12,2,10,2022-05-03_11-02-08,fp7d
2021-02-08,NW,6,5,0,5,2022-05-03_11-02-08,fp7d
2021-02-08,OW,0,0,0,0,2022-05-03_11-02-08,fp7d
2021-02-08,SG,54,61,7,54,2022-05-03_11-02-08,fp7d
2021-02-08,SH,8,8,0,8,2022-05-03_11-02-08,fp7d
2021-02-08,SO,17,25,8,17,2022-05-03_11-02-08,fp7d
2021-02-08,SZ,12,12,0,12,2022-05-03_11-02-08,fp7d
2021-02-08,TG,21,38,17,21,2022-05-03_11-02-08,fp7d
2021-02-08,TI,55,70,21,49,2022-05-03_11-02-08,fp7d
2021-02-08,UR,6,6,0,6,2022-05-03_11-02-08,fp7d
2021-02-08,VD,85,115,30,85,2022-05-03_11-02-08,fp7d
2021-02-08,VS,20,25,5,20,2022-05-03_11-02-08,fp7d
2021-02-08,ZG,8,7,0,7,2022-05-03_11-02-08,fp7d
2021-02-08,ZH,190,206,27,179,2022-05-03_11-02-08,fp7d
2021-02-09,AG,52,48,0,48,2022-05-03_11-02-08,fp7d
2021-02-09,AI,0,0,0,0,2022-05-03_11-02-08,fp7d
2021-02-09,AR,6,6,0,6,2022-05-03_11-02-08,fp7d
2021-02-09,BE,104,104,6,98,2022-05-03_11-02-08,fp7d
2021-02-09,BL,20,18,0,18,2022-05-03_11-02-08,fp7d
2021-02-09,BS,54,50,0,50,2022-05-03_11-02-08,fp7d
2021-02-09,FR,24,24,0,24,2022-05-03_11-02-08,fp7d
2021-02-09,GE,38,59,21,38,2022-05-03_11-02-08,fp7d
2021-02-09,GL,6,6,0,6,2022-05-03_11-02-08,fp7d
2021-02-09,GR,16,17,1,16,2022-05-03_11-02-08,fp7d
2021-02-09,JU,6,6,0,6,2022-05-03_11-02-08,fp7d
2021-02-09,LU,54,52,2,50,2022-05-03_11-02-08,fp7d
2021-02-09,NE,10,12,2,10,2022-05-03_11-02-08,fp7d
2021-02-09,NW,6,5,0,5,2022-05-03_11-02-08,fp7d
2021-02-09,OW,0,0,0,0,2022-05-03_11-02-08,fp7d
2021-02-09,SG,54,61,7,54,2022-05-03_11-02-08,fp7d
2021-02-09,SH,8,8,0,8,2022-05-03_11-02-08,fp7d
2021-02-09,SO,17,25,8,17,2022-05-03_11-02-08,fp7d
2021-02-09,SZ,12,12,0,12,2022-05-03_11-02-08,fp7d
2021-02-09,TG,21,38,17,21,2022-05-03_11-02-08,fp7d
2021-02-09,TI,55,70,21,49,2022-05-03_11-02-08,fp7d
2021-02-09,UR,6,6,0,6,2022-05-03_11-02-08,fp7d
2021-02-09,VD,85,115,30,85,2022-05-03_11-02-08,fp7d
2021-02-09,VS,20,25,5,20,2022-05-03_11-02-08,fp7d
2021-02-09,ZG,8,7,0,7,2022-05-03_11-02-08,fp7d
2021-02-09,ZH,190,203,27,176,2022-05-03_11-02-08,fp7d
2021-02-10,AG,52,49,0,49,2022-05-03_11-02-08,fp7d
2021-02-10,AI,0,0,0,0,2022-05-03_11-02-08,fp7d
2021-02-10,AR,6,6,0,6,2022-05-03_11-02-08,fp7d
2021-02-10,BE,104,104,6,98,2022-05-03_11-02-08,fp7d
2021-02-10,BL,20,18,0,18,2022-05-03_11-02-08,fp7d
2021-02-10,BS,54,50,0,50,2022-05-03_11-02-08,fp7d
2021-02-10,FR,24,24,0,24,2022-05-03_11-02-08,fp7d
2021-02-10,GE,38,59,21,38,2022-05-03_11-02-08,fp7d
2021-02-10,GL,6,6,0,6,2022-05-03_11-02-08,fp7d
2021-02-10,GR,16,17,1,16,2022-05-03_11-02-08,fp7d
2021-02-10,JU,6,6,0,6,2022-05-03_11-02-08,fp7d
2021-02-10,LU,54,52,2,50,2022-05-03_11-02-08,fp7d
2021-02-10,NE,10,12,2,10,2022-05-03_11-02-08,fp7d
2021-02-10,NW,6,5,0,5,2022-05-03_11-02-08,fp7d
2021-02-10,OW,0,0,0,0,2022-05-03_11-02-08,fp7d
2021-02-10,SG,54,61,7,54,2022-05-03_11-02-08,fp7d
2021-02-10,SH,8,8,0,8,2022-05-03_11-02-08,fp7d
2021-02-10,SO,17,25,8,17,2022-05-03_11-02-08,fp7d
2021-02-10,SZ,12,12,0,12,2022-05-03_11-02-08,fp7d
2021-02-10,TG,21,38,17,21,2022-05-03_11-02-08,fp7d
2021-02-10,TI,55,70,21,49,2022-05-03_11-02-08,fp7d
2021-02-10,UR,6,6,0,6,2022-05-03_11-02-08,fp7d
2021-02-10,VD,85,113,28,85,2022-05-03_11-02-08,fp7d
2021-02-10,VS,20,25,5,20,2022-05-03_11-02-08,fp7d
2021-02-10,ZG,8,7,0,7,2022-05-03_11-02-08,fp7d
2021-02-10,ZH,190,204,27,177,2022-05-03_11-02-08,fp7d
2021-02-11,AG,52,49,0,49,2022-05-03_11-02-08,fp7d
2021-02-11,AI,0,0,0,0,2022-05-03_11-02-08,fp7d
2021-02-11,AR,6,6,0,6,2022-05-03_11-02-08,fp7d
2021-02-11,BE,104,104,6,98,2022-05-03_11-02-08,fp7d
2021-02-11,BL,20,18,0,18,2022-05-03_11-02-08,fp7d
2021-02-11,BS,54,50,0,50,2022-05-03_11-02-08,fp7d
2021-02-11,FR,24,24,0,24,2022-05-03_11-02-08,fp7d
2021-02-11,GE,38,59,21,38,2022-05-03_11-02-08,fp7d
2021-02-11,GL,6,6,0,6,2022-05-03_11-02-08,fp7d
2021-02-11,GR,16,17,1,16,2022-05-03_11-02-08,fp7d
2021-02-11,JU,6,6,0,6,2022-05-03_11-02-08,fp7d
2021-02-11,LU,54,52,2,50,2022-05-03_11-02-08,fp7d
2021-02-11,NE,10,12,2,10,2022-05-03_11-02-08,fp7d
2021-02-11,NW,6,5,0,5,2022-05-03_11-02-08,fp7d
2021-02-11,OW,0,0,0,0,2022-05-03_11-02-08,fp7d
2021-02-11,SG,54,61,7,54,2022-05-03_11-02-08,fp7d
2021-02-11,SH,8,8,0,8,2022-05-03_11-02-08,fp7d
2021-02-11,SO,17,25,8,17,2022-05-03_11-02-08,fp7d
2021-02-11,SZ,12,12,0,12,2022-05-03_11-02-08,fp7d
2021-02-11,TG,21,38,17,21,2022-05-03_11-02-08,fp7d
2021-02-11,TI,55,70,21,49,2022-05-03_11-02-08,fp7d
2021-02-11,UR,6,6,0,6,2022-05-03_11-02-08,fp7d
2021-02-11,VD,85,113,28,85,2022-05-03_11-02-08,fp7d
2021-02-11,VS,20,25,5,20,2022-05-03_11-02-08,fp7d
2021-02-11,ZG,8,7,0,7,2022-05-03_11-02-08,fp7d
2021-02-11,ZH,190,205,27,178,2022-05-03_11-02-08,fp7d
2021-02-12,AG,52,48,0,48,2022-05-03_11-02-08,fp7d
2021-02-12,AI,0,0,0,0,2022-05-03_11-02-08,fp7d
2021-02-12,AR,6,6,0,6,2022-05-03_11-02-08,fp7d
2021-02-12,BE,104,104,6,98,2022-05-03_11-02-08,fp7d
2021-02-12,BL,20,18,0,18,2022-05-03_11-02-08,fp7d
2021-02-12,BS,54,50,0,50,2022-05-03_11-02-08,fp7d
2021-02-12,FR,24,24,0,24,2022-05-03_11-02-08,fp7d
2021-02-12,GE,38,59,21,38,2022-05-03_11-02-08,fp7d
2021-02-12,GL,6,6,0,6,2022-05-03_11-02-08,fp7d
2021-02-12,GR,16,17,1,16,2022-05-03_11-02-08,fp7d
2021-02-12,JU,6,6,0,6,2022-05-03_11-02-08,fp7d
2021-02-12,LU,54,52,2,50,2022-05-03_11-02-08,fp7d
2021-02-12,NE,10,12,2,10,2022-05-03_11-02-08,fp7d
2021-02-12,NW,6,5,0,5,2022-05-03_11-02-08,fp7d
2021-02-12,OW,0,0,0,0,2022-05-03_11-02-08,fp7d
2021-02-12,SG,54,61,7,54,2022-05-03_11-02-08,fp7d
2021-02-12,SH,8,8,0,8,2022-05-03_11-02-08,fp7d
2021-02-12,SO,17,25,8,17,2022-05-03_11-02-08,fp7d
2021-02-12,SZ,12,12,0,12,2022-05-03_11-02-08,fp7d
2021-02-12,TG,21,38,17,21,2022-05-03_11-02-08,fp7d
2021-02-12,TI,53,72,25,47,2022-05-03_11-02-08,fp7d
2021-02-12,UR,6,6,0,6,2022-05-03_11-02-08,fp7d
2021-02-12,VD,85,113,28,85,2022-05-03_11-02-08,fp7d
2021-02-12,VS,20,25,5,20,2022-05-03_11-02-08,fp7d
2021-02-12,ZG,8,7,0,7,2022-05-03_11-02-08,fp7d
2021-02-12,ZH,190,207,27,180,2022-05-03_11-02-08,fp7d
2021-02-13,AG,52,49,0,49,2022-05-03_11-02-08,fp7d
2021-02-13,AI,0,0,0,0,2022-05-03_11-02-08,fp7d
2021-02-13,AR,6,6,0,6,2022-05-03_11-02-08,fp7d
2021-02-13,BE,104,104,6,98,2022-05-03_11-02-08,fp7d
2021-02-13,BL,20,18,0,18,2022-05-03_11-02-08,fp7d
2021-02-13,BS,54,50,0,50,2022-05-03_11-02-08,fp7d
2021-02-13,FR,24,24,0,24,2022-05-03_11-02-08,fp7d
2021-02-13,GE,38,59,21,38,2022-05-03_11-02-08,fp7d
2021-02-13,GL,6,6,0,6,2022-05-03_11-02-08,fp7d
2021-02-13,GR,16,17,1,16,2022-05-03_11-02-08,fp7d
2021-02-13,JU,6,6,0,6,2022-05-03_11-02-08,fp7d
2021-02-13,LU,54,52,2,50,2022-05-03_11-02-08,fp7d
2021-02-13,NE,10,12,2,10,2022-05-03_11-02-08,fp7d
2021-02-13,NW,6,5,0,5,2022-05-03_11-02-08,fp7d
2021-02-13,OW,0,0,0,0,2022-05-03_11-02-08,fp7d
2021-02-13,SG,54,61,7,54,2022-05-03_11-02-08,fp7d
2021-02-13,SH,8,8,0,8,2022-05-03_11-02-08,fp7d
2021-02-13,SO,17,25,8,17,2022-05-03_11-02-08,fp7d
2021-02-13,SZ,12,12,0,12,2022-05-03_11-02-08,fp7d
2021-02-13,TG,21,38,17,21,2022-05-03_11-02-08,fp7d
2021-02-13,TI,53,72,25,47,2022-05-03_11-02-08,fp7d
2021-02-13,UR,6,6,0,6,2022-05-03_11-02-08,fp7d
2021-02-13,VD,85,113,28,85,2022-05-03_11-02-08,fp7d
2021-02-13,VS,20,25,5,20,2022-05-03_11-02-08,fp7d
2021-02-13,ZG,8,7,0,7,2022-05-03_11-02-08,fp7d
2021-02-13,ZH,190,209,27,182,2022-05-03_11-02-08,fp7d
2021-02-14,AG,52,49,0,49,2022-05-03_11-02-08,fp7d
2021-02-14,AI,0,0,0,0,2022-05-03_11-02-08,fp7d
2021-02-14,AR,6,6,0,6,2022-05-03_11-02-08,fp7d
2021-02-14,BE,104,104,6,98,2022-05-03_11-02-08,fp7d
2021-02-14,BL,20,18,0,18,2022-05-03_11-02-08,fp7d
2021-02-14,BS,54,50,0,50,2022-05-03_11-02-08,fp7d
2021-02-14,FR,24,24,0,24,2022-05-03_11-02-08,fp7d
2021-02-14,GE,38,59,21,38,2022-05-03_11-02-08,fp7d
2021-02-14,GL,6,6,0,6,2022-05-03_11-02-08,fp7d
2021-02-14,GR,16,17,1,16,2022-05-03_11-02-08,fp7d
2021-02-14,JU,6,6,0,6,2022-05-03_11-02-08,fp7d
2021-02-14,LU,54,52,2,50,2022-05-03_11-02-08,fp7d
2021-02-14,NE,10,12,2,10,2022-05-03_11-02-08,fp7d
2021-02-14,NW,6,5,0,5,2022-05-03_11-02-08,fp7d
2021-02-14,OW,0,0,0,0,2022-05-03_11-02-08,fp7d
2021-02-14,SG,54,61,7,54,2022-05-03_11-02-08,fp7d
2021-02-14,SH,8,8,0,8,2022-05-03_11-02-08,fp7d
2021-02-14,SO,17,25,8,17,2022-05-03_11-02-08,fp7d
2021-02-14,SZ,12,12,0,12,2022-05-03_11-02-08,fp7d
2021-02-14,TG,21,38,17,21,2022-05-03_11-02-08,fp7d
2021-02-14,TI,53,72,25,47,2022-05-03_11-02-08,fp7d
2021-02-14,UR,6,6,0,6,2022-05-03_11-02-08,fp7d
2021-02-14,VD,85,113,28,85,2022-05-03_11-02-08,fp7d
2021-02-14,VS,20,25,5,20,2022-05-03_11-02-08,fp7d
2021-02-14,ZG,8,8,0,8,2022-05-03_11-02-08,fp7d
2021-02-14,ZH,190,209,27,182,2022-05-03_11-02-08,fp7d
2021-02-15,AG,52,49,0,49,2022-05-03_11-02-08,fp7d
2021-02-15,AI,0,0,0,0,2022-05-03_11-02-08,fp7d
2021-02-15,AR,6,6,0,6,2022-05-03_11-02-08,fp7d
2021-02-15,BE,104,105,6,99,2022-05-03_11-02-08,fp7d
2021-02-15,BL,20,18,0,18,2022-05-03_11-02-08,fp7d
2021-02-15,BS,54,50,0,50,2022-05-03_11-02-08,fp7d
2021-02-15,FR,24,24,0,24,2022-05-03_11-02-08,fp7d
2021-02-15,GE,38,59,21,38,2022-05-03_11-02-08,fp7d
2021-02-15,GL,6,6,0,6,2022-05-03_11-02-08,fp7d
2021-02-15,GR,16,17,1,16,2022-05-03_11-02-08,fp7d
2021-02-15,JU,6,6,0,6,2022-05-03_11-02-08,fp7d
2021-02-15,LU,40,42,2,40,2022-05-03_11-02-08,fp7d
2021-02-15,NE,10,12,2,10,2022-05-03_11-02-08,fp7d
2021-02-15,NW,6,5,0,5,2022-05-03_11-02-08,fp7d
2021-02-15,OW,0,0,0,0,2022-05-03_11-02-08,fp7d
2021-02-15,SG,54,61,7,54,2022-05-03_11-02-08,fp7d
2021-02-15,SH,8,8,0,8,2022-05-03_11-02-08,fp7d
2021-02-15,SO,17,25,8,17,2022-05-03_11-02-08,fp7d
2021-02-15,SZ,12,12,0,12,2022-05-03_11-02-08,fp7d
2021-02-15,TG,21,38,17,21,2022-05-03_11-02-08,fp7d
2021-02-15,TI,53,72,25,47,2022-05-03_11-02-08,fp7d
2021-02-15,UR,6,6,0,6,2022-05-03_11-02-08,fp7d
2021-02-15,VD,85,113,28,85,2022-05-03_11-02-08,fp7d
2021-02-15,VS,20,25,5,20,2022-05-03_11-02-08,fp7d
2021-02-15,ZG,8,8,0,8,2022-05-03_11-02-08,fp7d
2021-02-15,ZH,190,209,27,182,2022-05-03_11-02-08,fp7d
2021-02-16,AG,52,48,0,48,2022-05-03_11-02-08,fp7d
2021-02-16,AI,0,0,0,0,2022-05-03_11-02-08,fp7d
2021-02-16,AR,6,6,0,6,2022-05-03_11-02-08,fp7d
2021-02-16,BE,104,105,6,99,2022-05-03_11-02-08,fp7d
2021-02-16,BL,20,18,0,18,2022-05-03_11-02-08,fp7d
2021-02-16,BS,54,50,0,50,2022-05-03_11-02-08,fp7d
2021-02-16,FR,24,24,0,24,2022-05-03_11-02-08,fp7d
2021-02-16,GE,38,59,21,38,2022-05-03_11-02-08,fp7d
2021-02-16,GL,6,6,0,6,2022-05-03_11-02-08,fp7d
2021-02-16,GR,16,17,1,16,2022-05-03_11-02-08,fp7d
2021-02-16,JU,6,6,0,6,2022-05-03_11-02-08,fp7d
2021-02-16,LU,40,42,2,40,2022-05-03_11-02-08,fp7d
2021-02-16,NE,10,12,2,10,2022-05-03_11-02-08,fp7d
2021-02-16,NW,6,5,0,5,2022-05-03_11-02-08,fp7d
2021-02-16,OW,0,0,0,0,2022-05-03_11-02-08,fp7d
2021-02-16,SG,54,61,7,54,2022-05-03_11-02-08,fp7d
2021-02-16,SH,8,8,0,8,2022-05-03_11-02-08,fp7d
2021-02-16,SO,17,25,8,17,2022-05-03_11-02-08,fp7d
2021-02-16,SZ,12,12,0,12,2022-05-03_11-02-08,fp7d
2021-02-16,TG,21,38,17,21,2022-05-03_11-02-08,fp7d
2021-02-16,TI,53,70,23,47,2022-05-03_11-02-08,fp7d
2021-02-16,UR,6,6,0,6,2022-05-03_11-02-08,fp7d
2021-02-16,VD,85,113,28,85,2022-05-03_11-02-08,fp7d
2021-02-16,VS,20,25,5,20,2022-05-03_11-02-08,fp7d
2021-02-16,ZG,8,8,0,8,2022-05-03_11-02-08,fp7d
2021-02-16,ZH,190,209,27,182,2022-05-03_11-02-08,fp7d
2021-02-17,AG,52,49,0,49,2022-05-03_11-02-08,fp7d
2021-02-17,AI,0,0,0,0,2022-05-03_11-02-08,fp7d
2021-02-17,AR,6,6,0,6,2022-05-03_11-02-08,fp7d
2021-02-17,BE,104,105,6,99,2022-05-03_11-02-08,fp7d
2021-02-17,BL,20,18,0,18,2022-05-03_11-02-08,fp7d
2021-02-17,BS,54,50,0,50,2022-05-03_11-02-08,fp7d
2021-02-17,FR,24,24,0,24,2022-05-03_11-02-08,fp7d
2021-02-17,GE,38,59,21,38,2022-05-03_11-02-08,fp7d
2021-02-17,GL,6,6,0,6,2022-05-03_11-02-08,fp7d
2021-02-17,GR,16,17,1,16,2022-05-03_11-02-08,fp7d
2021-02-17,JU,6,6,0,6,2022-05-03_11-02-08,fp7d
2021-02-17,LU,40,42,2,40,2022-05-03_11-02-08,fp7d
2021-02-17,NE,10,12,2,10,2022-05-03_11-02-08,fp7d
2021-02-17,NW,6,5,0,5,2022-05-03_11-02-08,fp7d
2021-02-17,OW,0,0,0,0,2022-05-03_11-02-08,fp7d
2021-02-17,SG,54,61,7,54,2022-05-03_11-02-08,fp7d
2021-02-17,SH,8,8,0,8,2022-05-03_11-02-08,fp7d
2021-02-17,SO,17,25,8,17,2022-05-03_11-02-08,fp7d
2021-02-17,SZ,12,12,0,12,2022-05-03_11-02-08,fp7d
2021-02-17,TG,21,38,17,21,2022-05-03_11-02-08,fp7d
2021-02-17,TI,53,70,23,47,2022-05-03_11-02-08,fp7d
2021-02-17,UR,6,6,0,6,2022-05-03_11-02-08,fp7d
2021-02-17,VD,85,113,28,85,2022-05-03_11-02-08,fp7d
2021-02-17,VS,20,25,5,20,2022-05-03_11-02-08,fp7d
2021-02-17,ZG,8,8,0,8,2022-05-03_11-02-08,fp7d
2021-02-17,ZH,190,213,28,185,2022-05-03_11-02-08,fp7d
2021-02-18,AG,52,49,0,49,2022-05-03_11-02-08,fp7d
2021-02-18,AI,0,0,0,0,2022-05-03_11-02-08,fp7d
2021-02-18,AR,6,6,0,6,2022-05-03_11-02-08,fp7d
2021-02-18,BE,104,104,6,98,2022-05-03_11-02-08,fp7d
2021-02-18,BL,20,18,0,18,2022-05-03_11-02-08,fp7d
2021-02-18,BS,54,50,0,50,2022-05-03_11-02-08,fp7d
2021-02-18,FR,24,24,0,24,2022-05-03_11-02-08,fp7d
2021-02-18,GE,38,59,21,38,2022-05-03_11-02-08,fp7d
2021-02-18,GL,6,6,0,6,2022-05-03_11-02-08,fp7d
2021-02-18,GR,16,17,1,16,2022-05-03_11-02-08,fp7d
2021-02-18,JU,6,6,0,6,2022-05-03_11-02-08,fp7d
2021-02-18,LU,54,52,2,50,2022-05-03_11-02-08,fp7d
2021-02-18,NE,10,12,2,10,2022-05-03_11-02-08,fp7d
2021-02-18,NW,6,5,0,5,2022-05-03_11-02-08,fp7d
2021-02-18,OW,0,0,0,0,2022-05-03_11-02-08,fp7d
2021-02-18,SG,54,61,7,54,2022-05-03_11-02-08,fp7d
2021-02-18,SH,8,8,0,8,2022-05-03_11-02-08,fp7d
2021-02-18,SO,17,25,8,17,2022-05-03_11-02-08,fp7d
2021-02-18,SZ,12,12,0,12,2022-05-03_11-02-08,fp7d
2021-02-18,TG,21,36,15,21,2022-05-03_11-02-08,fp7d
2021-02-18,TI,53,70,23,47,2022-05-03_11-02-08,fp7d
2021-02-18,UR,6,6,0,6,2022-05-03_11-02-08,fp7d
2021-02-18,VD,85,110,25,85,2022-05-03_11-02-08,fp7d
2021-02-18,VS,14,17,3,14,2022-05-03_11-02-08,fp7d
2021-02-18,ZG,8,8,0,8,2022-05-03_11-02-08,fp7d
2021-02-18,ZH,190,213,28,185,2022-05-03_11-02-08,fp7d
2021-02-19,AG,52,49,0,49,2022-05-03_11-02-08,fp7d
2021-02-19,AI,0,0,0,0,2022-05-03_11-02-08,fp7d
2021-02-19,AR,6,6,0,6,2022-05-03_11-02-08,fp7d
2021-02-19,BE,104,104,6,98,2022-05-03_11-02-08,fp7d
2021-02-19,BL,20,18,0,18,2022-05-03_11-02-08,fp7d
2021-02-19,BS,54,50,0,50,2022-05-03_11-02-08,fp7d
2021-02-19,FR,24,24,0,24,2022-05-03_11-02-08,fp7d
2021-02-19,GE,38,59,21,38,2022-05-03_11-02-08,fp7d
2021-02-19,GL,6,6,0,6,2022-05-03_11-02-08,fp7d
2021-02-19,GR,16,17,1,16,2022-05-03_11-02-08,fp7d
2021-02-19,JU,6,6,0,6,2022-05-03_11-02-08,fp7d
2021-02-19,LU,54,52,2,50,2022-05-03_11-02-08,fp7d
2021-02-19,NE,10,12,2,10,2022-05-03_11-02-08,fp7d
2021-02-19,NW,6,5,0,5,2022-05-03_11-02-08,fp7d
2021-02-19,OW,0,0,0,0,2022-05-03_11-02-08,fp7d
2021-02-19,SG,54,61,7,54,2022-05-03_11-02-08,fp7d
2021-02-19,SH,8,8,0,8,2022-05-03_11-02-08,fp7d
2021-02-19,SO,17,25,8,17,2022-05-03_11-02-08,fp7d
2021-02-19,SZ,12,12,0,12,2022-05-03_11-02-08,fp7d
2021-02-19,TG,21,36,15,21,2022-05-03_11-02-08,fp7d
2021-02-19,TI,53,70,23,47,2022-05-03_11-02-08,fp7d
2021-02-19,UR,6,6,0,6,2022-05-03_11-02-08,fp7d
2021-02-19,VD,85,110,25,85,2022-05-03_11-02-08,fp7d
2021-02-19,VS,14,17,3,14,2022-05-03_11-02-08,fp7d
2021-02-19,ZG,8,8,0,8,2022-05-03_11-02-08,fp7d
2021-02-19,ZH,190,214,29,185,2022-05-03_11-02-08,fp7d
2021-02-20,AG,52,49,0,49,2022-05-03_11-02-08,fp7d
2021-02-20,AI,0,0,0,0,2022-05-03_11-02-08,fp7d
2021-02-20,AR,6,6,0,6,2022-05-03_11-02-08,fp7d
2021-02-20,BE,104,103,6,97,2022-05-03_11-02-08,fp7d
2021-02-20,BL,20,18,0,18,2022-05-03_11-02-08,fp7d
2021-02-20,BS,54,46,0,46,2022-05-03_11-02-08,fp7d
2021-02-20,FR,24,24,0,24,2022-05-03_11-02-08,fp7d
2021-02-20,GE,38,56,18,38,2022-05-03_11-02-08,fp7d
2021-02-20,GL,6,6,0,6,2022-05-03_11-02-08,fp7d
2021-02-20,GR,16,17,1,16,2022-05-03_11-02-08,fp7d
2021-02-20,JU,6,6,0,6,2022-05-03_11-02-08,fp7d
2021-02-20,LU,54,52,2,50,2022-05-03_11-02-08,fp7d
2021-02-20,NE,10,12,2,10,2022-05-03_11-02-08,fp7d
2021-02-20,NW,6,5,0,5,2022-05-03_11-02-08,fp7d
2021-02-20,OW,0,0,0,0,2022-05-03_11-02-08,fp7d
2021-02-20,SG,54,61,7,54,2022-05-03_11-02-08,fp7d
2021-02-20,SH,8,8,0,8,2022-05-03_11-02-08,fp7d
2021-02-20,SO,17,25,8,17,2022-05-03_11-02-08,fp7d
2021-02-20,SZ,12,12,0,12,2022-05-03_11-02-08,fp7d
2021-02-20,TG,21,40,19,21,2022-05-03_11-02-08,fp7d
2021-02-20,TI,53,70,23,47,2022-05-03_11-02-08,fp7d
2021-02-20,UR,6,6,0,6,2022-05-03_11-02-08,fp7d
2021-02-20,VD,85,110,25,85,2022-05-03_11-02-08,fp7d
2021-02-20,VS,14,17,3,14,2022-05-03_11-02-08,fp7d
2021-02-20,ZG,8,8,0,8,2022-05-03_11-02-08,fp7d
2021-02-20,ZH,190,214,29,185,2022-05-03_11-02-08,fp7d
2021-02-21,AG,52,49,0,49,2022-05-03_11-02-08,fp7d
2021-02-21,AI,0,0,0,0,2022-05-03_11-02-08,fp7d
2021-02-21,AR,6,6,0,6,2022-05-03_11-02-08,fp7d
2021-02-21,BE,104,103,6,97,2022-05-03_11-02-08,fp7d
2021-02-21,BL,20,18,0,18,2022-05-03_11-02-08,fp7d
2021-02-21,BS,54,46,0,46,2022-05-03_11-02-08,fp7d
2021-02-21,FR,24,24,0,24,2022-05-03_11-02-08,fp7d
2021-02-21,GE,38,56,18,38,2022-05-03_11-02-08,fp7d
2021-02-21,GL,6,6,0,6,2022-05-03_11-02-08,fp7d
2021-02-21,GR,16,17,1,16,2022-05-03_11-02-08,fp7d
2021-02-21,JU,6,6,0,6,2022-05-03_11-02-08,fp7d
2021-02-21,LU,54,52,2,50,2022-05-03_11-02-08,fp7d
2021-02-21,NE,10,12,2,10,2022-05-03_11-02-08,fp7d
2021-02-21,NW,6,5,0,5,2022-05-03_11-02-08,fp7d
2021-02-21,OW,0,0,0,0,2022-05-03_11-02-08,fp7d
2021-02-21,SG,54,61,7,54,2022-05-03_11-02-08,fp7d
2021-02-21,SH,8,8,0,8,2022-05-03_11-02-08,fp7d
2021-02-21,SO,17,25,8,17,2022-05-03_11-02-08,fp7d
2021-02-21,SZ,12,12,0,12,2022-05-03_11-02-08,fp7d
2021-02-21,TG,21,40,19,21,2022-05-03_11-02-08,fp7d
2021-02-21,TI,53,70,23,47,2022-05-03_11-02-08,fp7d
2021-02-21,UR,6,6,0,6,2022-05-03_11-02-08,fp7d
2021-02-21,VD,85,110,25,85,2022-05-03_11-02-08,fp7d
2021-02-21,VS,14,17,3,14,2022-05-03_11-02-08,fp7d
2021-02-21,ZG,8,8,0,8,2022-05-03_11-02-08,fp7d
2021-02-21,ZH,190,214,29,185,2022-05-03_11-02-08,fp7d
2021-02-22,AG,52,49,0,49,2022-05-03_11-02-08,fp7d
2021-02-22,AI,0,0,0,0,2022-05-03_11-02-08,fp7d
2021-02-22,AR,6,6,0,6,2022-05-03_11-02-08,fp7d
2021-02-22,BE,104,103,6,97,2022-05-03_11-02-08,fp7d
2021-02-22,BL,20,16,0,16,2022-05-03_11-02-08,fp7d
2021-02-22,BS,54,50,0,50,2022-05-03_11-02-08,fp7d
2021-02-22,FR,24,24,0,24,2022-05-03_11-02-08,fp7d
2021-02-22,GE,38,56,18,38,2022-05-03_11-02-08,fp7d
2021-02-22,GL,6,6,0,6,2022-05-03_11-02-08,fp7d
2021-02-22,GR,16,17,1,16,2022-05-03_11-02-08,fp7d
2021-02-22,JU,6,6,0,6,2022-05-03_11-02-08,fp7d
2021-02-22,LU,54,52,2,50,2022-05-03_11-02-08,fp7d
2021-02-22,NE,10,12,2,10,2022-05-03_11-02-08,fp7d
2021-02-22,NW,6,5,0,5,2022-05-03_11-02-08,fp7d
2021-02-22,OW,0,0,0,0,2022-05-03_11-02-08,fp7d
2021-02-22,SG,54,63,9,54,2022-05-03_11-02-08,fp7d
2021-02-22,SH,8,8,0,8,2022-05-03_11-02-08,fp7d
2021-02-22,SO,17,25,8,17,2022-05-03_11-02-08,fp7d
2021-02-22,SZ,12,12,0,12,2022-05-03_11-02-08,fp7d
2021-02-22,TG,21,40,19,21,2022-05-03_11-02-08,fp7d
2021-02-22,TI,44,63,25,38,2022-05-03_11-02-08,fp7d
2021-02-22,UR,6,6,0,6,2022-05-03_11-02-08,fp7d
2021-02-22,VD,85,110,25,85,2022-05-03_11-02-08,fp7d
2021-02-22,VS,14,17,3,14,2022-05-03_11-02-08,fp7d
2021-02-22,ZG,8,8,0,8,2022-05-03_11-02-08,fp7d
2021-02-22,ZH,190,213,28,185,2022-05-03_11-02-08,fp7d
2021-02-23,AG,52,49,0,49,2022-05-03_11-02-08,fp7d
2021-02-23,AI,0,0,0,0,2022-05-03_11-02-08,fp7d
2021-02-23,AR,6,6,0,6,2022-05-03_11-02-08,fp7d
2021-02-23,BE,104,103,6,97,2022-05-03_11-02-08,fp7d
2021-02-23,BL,20,16,0,16,2022-05-03_11-02-08,fp7d
2021-02-23,BS,54,50,0,50,2022-05-03_11-02-08,fp7d
2021-02-23,FR,24,24,0,24,2022-05-03_11-02-08,fp7d
2021-02-23,GE,38,56,18,38,2022-05-03_11-02-08,fp7d
2021-02-23,GL,6,6,0,6,2022-05-03_11-02-08,fp7d
2021-02-23,GR,16,17,1,16,2022-05-03_11-02-08,fp7d
2021-02-23,JU,6,6,0,6,2022-05-03_11-02-08,fp7d
2021-02-23,LU,54,52,2,50,2022-05-03_11-02-08,fp7d
2021-02-23,NE,10,12,2,10,2022-05-03_11-02-08,fp7d
2021-02-23,NW,6,5,0,5,2022-05-03_11-02-08,fp7d
2021-02-23,OW,0,0,0,0,2022-05-03_11-02-08,fp7d
2021-02-23,SG,54,63,9,54,2022-05-03_11-02-08,fp7d
2021-02-23,SH,8,8,0,8,2022-05-03_11-02-08,fp7d
2021-02-23,SO,17,25,8,17,2022-05-03_11-02-08,fp7d
2021-02-23,SZ,12,12,0,12,2022-05-03_11-02-08,fp7d
2021-02-23,TG,21,40,19,21,2022-05-03_11-02-08,fp7d
2021-02-23,TI,53,72,25,47,2022-05-03_11-02-08,fp7d
2021-02-23,UR,6,6,0,6,2022-05-03_11-02-08,fp7d
2021-02-23,VD,85,110,25,85,2022-05-03_11-02-08,fp7d
2021-02-23,VS,20,25,5,20,2022-05-03_11-02-08,fp7d
2021-02-23,ZG,8,8,0,8,2022-05-03_11-02-08,fp7d
2021-02-23,ZH,190,215,30,185,2022-05-03_11-02-08,fp7d
2021-02-24,AG,52,48,0,48,2022-05-03_11-02-08,fp7d
2021-02-24,AI,0,0,0,0,2022-05-03_11-02-08,fp7d
2021-02-24,AR,6,6,0,6,2022-05-03_11-02-08,fp7d
2021-02-24,BE,104,103,6,97,2022-05-03_11-02-08,fp7d
2021-02-24,BL,20,16,0,16,2022-05-03_11-02-08,fp7d
2021-02-24,BS,54,50,0,50,2022-05-03_11-02-08,fp7d
2021-02-24,FR,24,24,0,24,2022-05-03_11-02-08,fp7d
2021-02-24,GE,38,56,18,38,2022-05-03_11-02-08,fp7d
2021-02-24,GL,6,6,0,6,2022-05-03_11-02-08,fp7d
2021-02-24,GR,16,17,1,16,2022-05-03_11-02-08,fp7d
2021-02-24,JU,6,6,0,6,2022-05-03_11-02-08,fp7d
2021-02-24,LU,54,52,2,50,2022-05-03_11-02-08,fp7d
2021-02-24,NE,10,12,2,10,2022-05-03_11-02-08,fp7d
2021-02-24,NW,6,5,0,5,2022-05-03_11-02-08,fp7d
2021-02-24,OW,0,0,0,0,2022-05-03_11-02-08,fp7d
2021-02-24,SG,54,63,9,54,2022-05-03_11-02-08,fp7d
2021-02-24,SH,8,8,0,8,2022-05-03_11-02-08,fp7d
2021-02-24,SO,17,25,8,17,2022-05-03_11-02-08,fp7d
2021-02-24,SZ,12,12,0,12,2022-05-03_11-02-08,fp7d
2021-02-24,TG,21,40,19,21,2022-05-03_11-02-08,fp7d
2021-02-24,TI,53,72,25,47,2022-05-03_11-02-08,fp7d
2021-02-24,UR,6,6,0,6,2022-05-03_11-02-08,fp7d
2021-02-24,VD,85,110,25,85,2022-05-03_11-02-08,fp7d
2021-02-24,VS,20,25,5,20,2022-05-03_11-02-08,fp7d
2021-02-24,ZG,8,8,0,8,2022-05-03_11-02-08,fp7d
2021-02-24,ZH,190,215,30,185,2022-05-03_11-02-08,fp7d
2021-02-25,AG,52,49,0,49,2022-05-03_11-02-08,fp7d
2021-02-25,AI,0,0,0,0,2022-05-03_11-02-08,fp7d
2021-02-25,AR,6,6,0,6,2022-05-03_11-02-08,fp7d
2021-02-25,BE,104,103,6,97,2022-05-03_11-02-08,fp7d
2021-02-25,BL,20,16,0,16,2022-05-03_11-02-08,fp7d
2021-02-25,BS,54,50,0,50,2022-05-03_11-02-08,fp7d
2021-02-25,FR,24,24,0,24,2022-05-03_11-02-08,fp7d
2021-02-25,GE,38,56,18,38,2022-05-03_11-02-08,fp7d
2021-02-25,GL,6,6,0,6,2022-05-03_11-02-08,fp7d
2021-02-25,GR,16,17,1,16,2022-05-03_11-02-08,fp7d
2021-02-25,JU,6,6,0,6,2022-05-03_11-02-08,fp7d
2021-02-25,LU,54,52,2,50,2022-05-03_11-02-08,fp7d
2021-02-25,NE,10,12,2,10,2022-05-03_11-02-08,fp7d
2021-02-25,NW,6,5,0,5,2022-05-03_11-02-08,fp7d
2021-02-25,OW,0,0,0,0,2022-05-03_11-02-08,fp7d
2021-02-25,SG,54,63,9,54,2022-05-03_11-02-08,fp7d
2021-02-25,SH,8,8,0,8,2022-05-03_11-02-08,fp7d
2021-02-25,SO,17,25,8,17,2022-05-03_11-02-08,fp7d
2021-02-25,SZ,12,12,0,12,2022-05-03_11-02-08,fp7d
2021-02-25,TG,21,40,19,21,2022-05-03_11-02-08,fp7d
2021-02-25,TI,53,72,25,47,2022-05-03_11-02-08,fp7d
2021-02-25,UR,6,6,0,6,2022-05-03_11-02-08,fp7d
2021-02-25,VD,85,110,25,85,2022-05-03_11-02-08,fp7d
2021-02-25,VS,20,25,5,20,2022-05-03_11-02-08,fp7d
2021-02-25,ZG,8,8,0,8,2022-05-03_11-02-08,fp7d
2021-02-25,ZH,190,214,29,185,2022-05-03_11-02-08,fp7d
2021-02-26,AG,52,49,0,49,2022-05-03_11-02-08,fp7d
2021-02-26,AI,0,0,0,0,2022-05-03_11-02-08,fp7d
2021-02-26,AR,6,6,0,6,2022-05-03_11-02-08,fp7d
2021-02-26,BE,104,103,6,97,2022-05-03_11-02-08,fp7d
2021-02-26,BL,20,16,0,16,2022-05-03_11-02-08,fp7d
2021-02-26,BS,54,50,0,50,2022-05-03_11-02-08,fp7d
2021-02-26,FR,24,24,0,24,2022-05-03_11-02-08,fp7d
2021-02-26,GE,38,50,12,38,2022-05-03_11-02-08,fp7d
2021-02-26,GL,6,6,0,6,2022-05-03_11-02-08,fp7d
2021-02-26,GR,16,17,1,16,2022-05-03_11-02-08,fp7d
2021-02-26,JU,6,6,0,6,2022-05-03_11-02-08,fp7d
2021-02-26,LU,54,52,2,50,2022-05-03_11-02-08,fp7d
2021-02-26,NE,10,12,2,10,2022-05-03_11-02-08,fp7d
2021-02-26,NW,6,5,0,5,2022-05-03_11-02-08,fp7d
2021-02-26,OW,0,0,0,0,2022-05-03_11-02-08,fp7d
2021-02-26,SG,54,63,9,54,2022-05-03_11-02-08,fp7d
2021-02-26,SH,8,8,0,8,2022-05-03_11-02-08,fp7d
2021-02-26,SO,17,25,8,17,2022-05-03_11-02-08,fp7d
2021-02-26,SZ,12,12,0,12,2022-05-03_11-02-08,fp7d
2021-02-26,TG,21,40,19,21,2022-05-03_11-02-08,fp7d
2021-02-26,TI,53,72,25,47,2022-05-03_11-02-08,fp7d
2021-02-26,UR,6,6,0,6,2022-05-03_11-02-08,fp7d
2021-02-26,VD,85,110,25,85,2022-05-03_11-02-08,fp7d
2021-02-26,VS,20,25,5,20,2022-05-03_11-02-08,fp7d
2021-02-26,ZG,8,8,0,8,2022-05-03_11-02-08,fp7d
2021-02-26,ZH,190,214,29,185,2022-05-03_11-02-08,fp7d
2021-02-27,AG,52,49,0,49,2022-05-03_11-02-08,fp7d
2021-02-27,AI,0,0,0,0,2022-05-03_11-02-08,fp7d
2021-02-27,AR,6,6,0,6,2022-05-03_11-02-08,fp7d
2021-02-27,BE,104,103,6,97,2022-05-03_11-02-08,fp7d
2021-02-27,BL,20,16,0,16,2022-05-03_11-02-08,fp7d
2021-02-27,BS,54,46,0,46,2022-05-03_11-02-08,fp7d
2021-02-27,FR,24,24,0,24,2022-05-03_11-02-08,fp7d
2021-02-27,GE,38,50,12,38,2022-05-03_11-02-08,fp7d
2021-02-27,GL,6,6,0,6,2022-05-03_11-02-08,fp7d
2021-02-27,GR,16,17,1,16,2022-05-03_11-02-08,fp7d
2021-02-27,JU,6,6,0,6,2022-05-03_11-02-08,fp7d
2021-02-27,LU,54,52,2,50,2022-05-03_11-02-08,fp7d
2021-02-27,NE,10,12,2,10,2022-05-03_11-02-08,fp7d
2021-02-27,NW,6,5,0,5,2022-05-03_11-02-08,fp7d
2021-02-27,OW,0,0,0,0,2022-05-03_11-02-08,fp7d
2021-02-27,SG,54,63,9,54,2022-05-03_11-02-08,fp7d
2021-02-27,SH,8,8,0,8,2022-05-03_11-02-08,fp7d
2021-02-27,SO,17,25,8,17,2022-05-03_11-02-08,fp7d
2021-02-27,SZ,12,12,0,12,2022-05-03_11-02-08,fp7d
2021-02-27,TG,21,40,19,21,2022-05-03_11-02-08,fp7d
2021-02-27,TI,53,72,25,47,2022-05-03_11-02-08,fp7d
2021-02-27,UR,6,6,0,6,2022-05-03_11-02-08,fp7d
2021-02-27,VD,85,110,25,85,2022-05-03_11-02-08,fp7d
2021-02-27,VS,20,25,5,20,2022-05-03_11-02-08,fp7d
2021-02-27,ZG,8,8,0,8,2022-05-03_11-02-08,fp7d
2021-02-27,ZH,190,213,29,184,2022-05-03_11-02-08,fp7d
2021-02-28,AG,52,48,0,48,2022-05-03_11-02-08,fp7d
2021-02-28,AI,0,0,0,0,2022-05-03_11-02-08,fp7d
2021-02-28,AR,6,6,0,6,2022-05-03_11-02-08,fp7d
2021-02-28,BE,104,103,6,97,2022-05-03_11-02-08,fp7d
2021-02-28,BL,20,16,0,16,2022-05-03_11-02-08,fp7d
2021-02-28,BS,54,46,0,46,2022-05-03_11-02-08,fp7d
2021-02-28,FR,24,24,0,24,2022-05-03_11-02-08,fp7d
2021-02-28,GE,38,50,12,38,2022-05-03_11-02-08,fp7d
2021-02-28,GL,6,6,0,6,2022-05-03_11-02-08,fp7d
2021-02-28,GR,16,17,1,16,2022-05-03_11-02-08,fp7d
2021-02-28,JU,6,6,0,6,2022-05-03_11-02-08,fp7d
2021-02-28,LU,54,52,2,50,2022-05-03_11-02-08,fp7d
2021-02-28,NE,10,12,2,10,2022-05-03_11-02-08,fp7d
2021-02-28,NW,6,5,0,5,2022-05-03_11-02-08,fp7d
2021-02-28,OW,0,0,0,0,2022-05-03_11-02-08,fp7d
2021-02-28,SG,54,63,9,54,2022-05-03_11-02-08,fp7d
2021-02-28,SH,8,8,0,8,2022-05-03_11-02-08,fp7d
2021-02-28,SO,17,25,8,17,2022-05-03_11-02-08,fp7d
2021-02-28,SZ,12,12,0,12,2022-05-03_11-02-08,fp7d
2021-02-28,TG,21,40,19,21,2022-05-03_11-02-08,fp7d
2021-02-28,TI,53,72,25,47,2022-05-03_11-02-08,fp7d
2021-02-28,UR,6,6,0,6,2022-05-03_11-02-08,fp7d
2021-02-28,VD,85,110,25,85,2022-05-03_11-02-08,fp7d
2021-02-28,VS,20,25,5,20,2022-05-03_11-02-08,fp7d
2021-02-28,ZG,8,8,0,8,2022-05-03_11-02-08,fp7d
2021-02-28,ZH,190,212,28,184,2022-05-03_11-02-08,fp7d
2021-03-01,AG,52,49,0,49,2022-05-03_11-02-08,fp7d
2021-03-01,AI,0,0,0,0,2022-05-03_11-02-08,fp7d
2021-03-01,AR,6,6,0,6,2022-05-03_11-02-08,fp7d
2021-03-01,BE,104,103,6,97,2022-05-03_11-02-08,fp7d
2021-03-01,BL,20,16,0,16,2022-05-03_11-02-08,fp7d
2021-03-01,BS,54,50,0,50,2022-05-03_11-02-08,fp7d
2021-03-01,FR,24,24,0,24,2022-05-03_11-02-08,fp7d
2021-03-01,GE,38,50,12,38,2022-05-03_11-02-08,fp7d
2021-03-01,GL,6,6,0,6,2022-05-03_11-02-08,fp7d
2021-03-01,GR,16,17,1,16,2022-05-03_11-02-08,fp7d
2021-03-01,JU,6,6,0,6,2022-05-03_11-02-08,fp7d
2021-03-01,LU,54,52,2,50,2022-05-03_11-02-08,fp7d
2021-03-01,NE,10,10,0,10,2022-05-03_11-02-08,fp7d
2021-03-01,NW,6,5,0,5,2022-05-03_11-02-08,fp7d
2021-03-01,OW,0,0,0,0,2022-05-03_11-02-08,fp7d
2021-03-01,SG,54,55,1,54,2022-05-03_11-02-08,fp7d
2021-03-01,SH,8,8,0,8,2022-05-03_11-02-08,fp7d
2021-03-01,SO,17,25,8,17,2022-05-03_11-02-08,fp7d
2021-03-01,SZ,12,12,0,12,2022-05-03_11-02-08,fp7d
2021-03-01,TG,21,40,19,21,2022-05-03_11-02-08,fp7d
2021-03-01,TI,53,78,25,53,2022-05-03_11-02-08,fp7d
2021-03-01,UR,6,6,0,6,2022-05-03_11-02-08,fp7d
2021-03-01,VD,85,111,26,85,2022-05-03_11-02-08,fp7d
2021-03-01,VS,20,22,2,20,2022-05-03_11-02-08,fp7d
2021-03-01,ZG,8,8,0,8,2022-05-03_11-02-08,fp7d
2021-03-01,ZH,190,212,28,184,2022-05-03_11-02-08,fp7d
2021-03-02,AG,52,49,0,49,2022-05-03_11-02-08,fp7d
2021-03-02,AI,0,0,0,0,2022-05-03_11-02-08,fp7d
2021-03-02,AR,6,6,0,6,2022-05-03_11-02-08,fp7d
2021-03-02,BE,104,103,6,97,2022-05-03_11-02-08,fp7d
2021-03-02,BL,20,16,0,16,2022-05-03_11-02-08,fp7d
2021-03-02,BS,54,50,0,50,2022-05-03_11-02-08,fp7d
2021-03-02,FR,24,24,0,24,2022-05-03_11-02-08,fp7d
2021-03-02,GE,38,50,12,38,2022-05-03_11-02-08,fp7d
2021-03-02,GL,6,6,0,6,2022-05-03_11-02-08,fp7d
2021-03-02,GR,16,16,0,16,2022-05-03_11-02-08,fp7d
2021-03-02,JU,6,6,0,6,2022-05-03_11-02-08,fp7d
2021-03-02,LU,54,52,2,50,2022-05-03_11-02-08,fp7d
2021-03-02,NE,10,10,0,10,2022-05-03_11-02-08,fp7d
2021-03-02,NW,6,5,0,5,2022-05-03_11-02-08,fp7d
2021-03-02,OW,0,0,0,0,2022-05-03_11-02-08,fp7d
2021-03-02,SG,54,55,1,54,2022-05-03_11-02-08,fp7d
2021-03-02,SH,8,8,0,8,2022-05-03_11-02-08,fp7d
2021-03-02,SO,17,25,8,17,2022-05-03_11-02-08,fp7d
2021-03-02,SZ,12,11,0,11,2022-05-03_11-02-08,fp7d
2021-03-02,TG,21,40,19,21,2022-05-03_11-02-08,fp7d
2021-03-02,TI,53,78,25,53,2022-05-03_11-02-08,fp7d
2021-03-02,UR,6,6,0,6,2022-05-03_11-02-08,fp7d
2021-03-02,VD,85,111,26,85,2022-05-03_11-02-08,fp7d
2021-03-02,VS,14,14,0,14,2022-05-03_11-02-08,fp7d
2021-03-02,ZG,8,8,0,8,2022-05-03_11-02-08,fp7d
2021-03-02,ZH,190,214,29,185,2022-05-03_11-02-08,fp7d
2021-03-03,AG,52,49,0,49,2022-05-03_11-02-08,fp7d
2021-03-03,AI,0,0,0,0,2022-05-03_11-02-08,fp7d
2021-03-03,AR,6,6,0,6,2022-05-03_11-02-08,fp7d
2021-03-03,BE,104,102,6,96,2022-05-03_11-02-08,fp7d
2021-03-03,BL,20,16,0,16,2022-05-03_11-02-08,fp7d
2021-03-03,BS,54,50,0,50,2022-05-03_11-02-08,fp7d
2021-03-03,FR,24,24,0,24,2022-05-03_11-02-08,fp7d
2021-03-03,GE,38,50,12,38,2022-05-03_11-02-08,fp7d
2021-03-03,GL,6,6,0,6,2022-05-03_11-02-08,fp7d
2021-03-03,GR,16,16,0,16,2022-05-03_11-02-08,fp7d
2021-03-03,JU,6,6,0,6,2022-05-03_11-02-08,fp7d
2021-03-03,LU,54,52,2,50,2022-05-03_11-02-08,fp7d
2021-03-03,NE,10,10,0,10,2022-05-03_11-02-08,fp7d
2021-03-03,NW,6,5,0,5,2022-05-03_11-02-08,fp7d
2021-03-03,OW,0,0,0,0,2022-05-03_11-02-08,fp7d
2021-03-03,SG,54,55,1,54,2022-05-03_11-02-08,fp7d
2021-03-03,SH,8,8,0,8,2022-05-03_11-02-08,fp7d
2021-03-03,SO,17,25,8,17,2022-05-03_11-02-08,fp7d
2021-03-03,SZ,12,11,0,11,2022-05-03_11-02-08,fp7d
2021-03-03,TG,21,40,19,21,2022-05-03_11-02-08,fp7d
2021-03-03,TI,53,78,25,53,2022-05-03_11-02-08,fp7d
2021-03-03,UR,6,6,0,6,2022-05-03_11-02-08,fp7d
2021-03-03,VD,85,111,26,85,2022-05-03_11-02-08,fp7d
2021-03-03,VS,14,15,1,14,2022-05-03_11-02-08,fp7d
2021-03-03,ZG,8,8,0,8,2022-05-03_11-02-08,fp7d
2021-03-03,ZH,190,214,29,185,2022-05-03_11-02-08,fp7d
2021-03-04,AG,52,49,0,49,2022-05-03_11-02-08,fp7d
2021-03-04,AI,0,0,0,0,2022-05-03_11-02-08,fp7d
2021-03-04,AR,6,6,0,6,2022-05-03_11-02-08,fp7d
2021-03-04,BE,104,102,6,96,2022-05-03_11-02-08,fp7d
2021-03-04,BL,20,16,0,16,2022-05-03_11-02-08,fp7d
2021-03-04,BS,54,50,0,50,2022-05-03_11-02-08,fp7d
2021-03-04,FR,24,24,0,24,2022-05-03_11-02-08,fp7d
2021-03-04,GE,38,50,12,38,2022-05-03_11-02-08,fp7d
2021-03-04,GL,6,6,0,6,2022-05-03_11-02-08,fp7d
2021-03-04,GR,16,16,0,16,2022-05-03_11-02-08,fp7d
2021-03-04,JU,6,6,0,6,2022-05-03_11-02-08,fp7d
2021-03-04,LU,54,52,2,50,2022-05-03_11-02-08,fp7d
2021-03-04,NE,10,10,0,10,2022-05-03_11-02-08,fp7d
2021-03-04,NW,6,5,0,5,2022-05-03_11-02-08,fp7d
2021-03-04,OW,0,0,0,0,2022-05-03_11-02-08,fp7d
2021-03-04,SG,54,55,1,54,2022-05-03_11-02-08,fp7d
2021-03-04,SH,8,8,0,8,2022-05-03_11-02-08,fp7d
2021-03-04,SO,17,25,8,17,2022-05-03_11-02-08,fp7d
2021-03-04,SZ,12,11,0,11,2022-05-03_11-02-08,fp7d
2021-03-04,TG,21,36,15,21,2022-05-03_11-02-08,fp7d
2021-03-04,TI,53,74,21,53,2022-05-03_11-02-08,fp7d
2021-03-04,UR,6,6,0,6,2022-05-03_11-02-08,fp7d
2021-03-04,VD,85,111,26,85,2022-05-03_11-02-08,fp7d
2021-03-04,VS,14,15,1,14,2022-05-03_11-02-08,fp7d
2021-03-04,ZG,8,8,0,8,2022-05-03_11-02-08,fp7d
2021-03-04,ZH,190,213,28,185,2022-05-03_11-02-08,fp7d
2021-03-05,AG,52,50,0,50,2022-05-03_11-02-08,fp7d
2021-03-05,AI,0,0,0,0,2022-05-03_11-02-08,fp7d
2021-03-05,AR,6,6,0,6,2022-05-03_11-02-08,fp7d
2021-03-05,BE,104,102,6,96,2022-05-03_11-02-08,fp7d
2021-03-05,BL,20,16,0,16,2022-05-03_11-02-08,fp7d
2021-03-05,BS,54,50,0,50,2022-05-03_11-02-08,fp7d
2021-03-05,FR,24,24,0,24,2022-05-03_11-02-08,fp7d
2021-03-05,GE,38,50,12,38,2022-05-03_11-02-08,fp7d
2021-03-05,GL,6,6,0,6,2022-05-03_11-02-08,fp7d
2021-03-05,GR,16,16,0,16,2022-05-03_11-02-08,fp7d
2021-03-05,JU,6,6,0,6,2022-05-03_11-02-08,fp7d
2021-03-05,LU,54,52,2,50,2022-05-03_11-02-08,fp7d
2021-03-05,NE,10,10,0,10,2022-05-03_11-02-08,fp7d
2021-03-05,NW,6,5,0,5,2022-05-03_11-02-08,fp7d
2021-03-05,OW,0,0,0,0,2022-05-03_11-02-08,fp7d
2021-03-05,SG,54,55,1,54,2022-05-03_11-02-08,fp7d
2021-03-05,SH,8,8,0,8,2022-05-03_11-02-08,fp7d
2021-03-05,SO,17,25,8,17,2022-05-03_11-02-08,fp7d
2021-03-05,SZ,12,11,0,11,2022-05-03_11-02-08,fp7d
2021-03-05,TG,21,36,15,21,2022-05-03_11-02-08,fp7d
2021-03-05,TI,53,74,21,53,2022-05-03_11-02-08,fp7d
2021-03-05,UR,6,6,0,6,2022-05-03_11-02-08,fp7d
2021-03-05,VD,85,112,27,85,2022-05-03_11-02-08,fp7d
2021-03-05,VS,14,15,1,14,2022-05-03_11-02-08,fp7d
2021-03-05,ZG,8,8,0,8,2022-05-03_11-02-08,fp7d
2021-03-05,ZH,190,211,29,182,2022-05-03_11-02-08,fp7d
2021-03-06,AG,52,50,0,50,2022-05-03_11-02-08,fp7d
2021-03-06,AI,0,0,0,0,2022-05-03_11-02-08,fp7d
2021-03-06,AR,6,6,0,6,2022-05-03_11-02-08,fp7d
2021-03-06,BE,104,102,6,96,2022-05-03_11-02-08,fp7d
2021-03-06,BL,20,16,0,16,2022-05-03_11-02-08,fp7d
2021-03-06,BS,54,50,0,50,2022-05-03_11-02-08,fp7d
2021-03-06,FR,24,24,0,24,2022-05-03_11-02-08,fp7d
2021-03-06,GE,38,50,12,38,2022-05-03_11-02-08,fp7d
2021-03-06,GL,6,6,0,6,2022-05-03_11-02-08,fp7d
2021-03-06,GR,16,16,0,16,2022-05-03_11-02-08,fp7d
2021-03-06,JU,6,6,0,6,2022-05-03_11-02-08,fp7d
2021-03-06,LU,54,52,2,50,2022-05-03_11-02-08,fp7d
2021-03-06,NE,10,10,0,10,2022-05-03_11-02-08,fp7d
2021-03-06,NW,6,5,0,5,2022-05-03_11-02-08,fp7d
2021-03-06,OW,0,0,0,0,2022-05-03_11-02-08,fp7d
2021-03-06,SG,54,55,1,54,2022-05-03_11-02-08,fp7d
2021-03-06,SH,8,8,0,8,2022-05-03_11-02-08,fp7d
2021-03-06,SO,17,25,8,17,2022-05-03_11-02-08,fp7d
2021-03-06,SZ,12,11,0,11,2022-05-03_11-02-08,fp7d
2021-03-06,TG,21,36,15,21,2022-05-03_11-02-08,fp7d
2021-03-06,TI,53,74,21,53,2022-05-03_11-02-08,fp7d
2021-03-06,UR,6,6,0,6,2022-05-03_11-02-08,fp7d
2021-03-06,VD,85,112,27,85,2022-05-03_11-02-08,fp7d
2021-03-06,VS,14,15,1,14,2022-05-03_11-02-08,fp7d
2021-03-06,ZG,8,8,0,8,2022-05-03_11-02-08,fp7d
2021-03-06,ZH,190,209,27,182,2022-05-03_11-02-08,fp7d
2021-03-07,AG,52,50,0,50,2022-05-03_11-02-08,fp7d
2021-03-07,AI,0,0,0,0,2022-05-03_11-02-08,fp7d
2021-03-07,AR,6,6,0,6,2022-05-03_11-02-08,fp7d
2021-03-07,BE,104,101,6,95,2022-05-03_11-02-08,fp7d
2021-03-07,BL,20,16,0,16,2022-05-03_11-02-08,fp7d
2021-03-07,BS,54,46,0,46,2022-05-03_11-02-08,fp7d
2021-03-07,FR,24,24,0,24,2022-05-03_11-02-08,fp7d
2021-03-07,GE,38,50,12,38,2022-05-03_11-02-08,fp7d
2021-03-07,GL,6,6,0,6,2022-05-03_11-02-08,fp7d
2021-03-07,GR,16,16,0,16,2022-05-03_11-02-08,fp7d
2021-03-07,JU,6,6,0,6,2022-05-03_11-02-08,fp7d
2021-03-07,LU,54,52,2,50,2022-05-03_11-02-08,fp7d
2021-03-07,NE,10,10,0,10,2022-05-03_11-02-08,fp7d
2021-03-07,NW,6,5,0,5,2022-05-03_11-02-08,fp7d
2021-03-07,OW,0,0,0,0,2022-05-03_11-02-08,fp7d
2021-03-07,SG,54,55,1,54,2022-05-03_11-02-08,fp7d
2021-03-07,SH,8,8,0,8,2022-05-03_11-02-08,fp7d
2021-03-07,SO,17,25,8,17,2022-05-03_11-02-08,fp7d
2021-03-07,SZ,12,11,0,11,2022-05-03_11-02-08,fp7d
2021-03-07,TG,21,36,15,21,2022-05-03_11-02-08,fp7d
2021-03-07,TI,53,74,21,53,2022-05-03_11-02-08,fp7d
2021-03-07,UR,6,6,0,6,2022-05-03_11-02-08,fp7d
2021-03-07,VD,85,112,27,85,2022-05-03_11-02-08,fp7d
2021-03-07,VS,14,15,1,14,2022-05-03_11-02-08,fp7d
2021-03-07,ZG,8,8,0,8,2022-05-03_11-02-08,fp7d
2021-03-07,ZH,190,209,28,181,2022-05-03_11-02-08,fp7d
2021-03-08,AG,52,50,0,50,2022-05-03_11-02-08,fp7d
2021-03-08,AI,0,0,0,0,2022-05-03_11-02-08,fp7d
2021-03-08,AR,6,6,0,6,2022-05-03_11-02-08,fp7d
2021-03-08,BE,104,101,6,95,2022-05-03_11-02-08,fp7d
2021-03-08,BL,20,16,0,16,2022-05-03_11-02-08,fp7d
2021-03-08,BS,54,50,0,50,2022-05-03_11-02-08,fp7d
2021-03-08,FR,24,24,0,24,2022-05-03_11-02-08,fp7d
2021-03-08,GE,38,50,12,38,2022-05-03_11-02-08,fp7d
2021-03-08,GL,6,6,0,6,2022-05-03_11-02-08,fp7d
2021-03-08,GR,16,16,0,16,2022-05-03_11-02-08,fp7d
2021-03-08,JU,6,6,0,6,2022-05-03_11-02-08,fp7d
2021-03-08,LU,54,52,2,50,2022-05-03_11-02-08,fp7d
2021-03-08,NE,10,10,0,10,2022-05-03_11-02-08,fp7d
2021-03-08,NW,6,5,0,5,2022-05-03_11-02-08,fp7d
2021-03-08,OW,0,0,0,0,2022-05-03_11-02-08,fp7d
2021-03-08,SG,54,55,1,54,2022-05-03_11-02-08,fp7d
2021-03-08,SH,8,8,0,8,2022-05-03_11-02-08,fp7d
2021-03-08,SO,17,25,8,17,2022-05-03_11-02-08,fp7d
2021-03-08,SZ,12,11,0,11,2022-05-03_11-02-08,fp7d
2021-03-08,TG,21,36,15,21,2022-05-03_11-02-08,fp7d
2021-03-08,TI,53,74,21,53,2022-05-03_11-02-08,fp7d
2021-03-08,UR,6,6,0,6,2022-05-03_11-02-08,fp7d
2021-03-08,VD,85,112,27,85,2022-05-03_11-02-08,fp7d
2021-03-08,VS,20,21,1,20,2022-05-03_11-02-08,fp7d
2021-03-08,ZG,8,8,0,8,2022-05-03_11-02-08,fp7d
2021-03-08,ZH,190,209,27,182,2022-05-03_11-02-08,fp7d
2021-03-09,AG,52,50,0,50,2022-05-03_11-02-08,fp7d
2021-03-09,AI,0,0,0,0,2022-05-03_11-02-08,fp7d
2021-03-09,AR,6,6,0,6,2022-05-03_11-02-08,fp7d
2021-03-09,BE,104,101,6,95,2022-05-03_11-02-08,fp7d
2021-03-09,BL,20,16,0,16,2022-05-03_11-02-08,fp7d
2021-03-09,BS,54,50,0,50,2022-05-03_11-02-08,fp7d
2021-03-09,FR,24,24,0,24,2022-05-03_11-02-08,fp7d
2021-03-09,GE,38,50,12,38,2022-05-03_11-02-08,fp7d
2021-03-09,GL,6,6,0,6,2022-05-03_11-02-08,fp7d
2021-03-09,GR,16,16,0,16,2022-05-03_11-02-08,fp7d
2021-03-09,JU,6,6,0,6,2022-05-03_11-02-08,fp7d
2021-03-09,LU,54,52,2,50,2022-05-03_11-02-08,fp7d
2021-03-09,NE,10,10,0,10,2022-05-03_11-02-08,fp7d
2021-03-09,NW,6,5,0,5,2022-05-03_11-02-08,fp7d
2021-03-09,OW,0,0,0,0,2022-05-03_11-02-08,fp7d
2021-03-09,SG,54,55,1,54,2022-05-03_11-02-08,fp7d
2021-03-09,SH,8,8,0,8,2022-05-03_11-02-08,fp7d
2021-03-09,SO,17,25,8,17,2022-05-03_11-02-08,fp7d
2021-03-09,SZ,12,11,0,11,2022-05-03_11-02-08,fp7d
2021-03-09,TG,21,36,15,21,2022-05-03_11-02-08,fp7d
2021-03-09,TI,53,74,21,53,2022-05-03_11-02-08,fp7d
2021-03-09,UR,6,6,0,6,2022-05-03_11-02-08,fp7d
2021-03-09,VD,85,112,27,85,2022-05-03_11-02-08,fp7d
2021-03-09,VS,20,21,1,20,2022-05-03_11-02-08,fp7d
2021-03-09,ZG,8,8,0,8,2022-05-03_11-02-08,fp7d
2021-03-09,ZH,190,216,33,183,2022-05-03_11-02-08,fp7d
2021-03-10,AG,52,50,0,50,2022-05-03_11-02-08,fp7d
2021-03-10,AI,0,0,0,0,2022-05-03_11-02-08,fp7d
2021-03-10,AR,6,6,0,6,2022-05-03_11-02-08,fp7d
2021-03-10,BE,104,101,6,95,2022-05-03_11-02-08,fp7d
2021-03-10,BL,20,16,0,16,2022-05-03_11-02-08,fp7d
2021-03-10,BS,54,50,0,50,2022-05-03_11-02-08,fp7d
2021-03-10,FR,24,24,0,24,2022-05-03_11-02-08,fp7d
2021-03-10,GE,38,56,18,38,2022-05-03_11-02-08,fp7d
2021-03-10,GL,6,6,0,6,2022-05-03_11-02-08,fp7d
2021-03-10,GR,16,16,0,16,2022-05-03_11-02-08,fp7d
2021-03-10,JU,6,6,0,6,2022-05-03_11-02-08,fp7d
2021-03-10,LU,54,52,2,50,2022-05-03_11-02-08,fp7d
2021-03-10,NE,10,10,0,10,2022-05-03_11-02-08,fp7d
2021-03-10,NW,6,5,0,5,2022-05-03_11-02-08,fp7d
2021-03-10,OW,0,0,0,0,2022-05-03_11-02-08,fp7d
2021-03-10,SG,54,55,1,54,2022-05-03_11-02-08,fp7d
2021-03-10,SH,8,8,0,8,2022-05-03_11-02-08,fp7d
2021-03-10,SO,17,25,8,17,2022-05-03_11-02-08,fp7d
2021-03-10,SZ,12,11,0,11,2022-05-03_11-02-08,fp7d
2021-03-10,TG,21,36,15,21,2022-05-03_11-02-08,fp7d
2021-03-10,TI,53,74,21,53,2022-05-03_11-02-08,fp7d
2021-03-10,UR,6,6,0,6,2022-05-03_11-02-08,fp7d
2021-03-10,VD,85,111,26,85,2022-05-03_11-02-08,fp7d
2021-03-10,VS,20,21,1,20,2022-05-03_11-02-08,fp7d
2021-03-10,ZG,8,8,0,8,2022-05-03_11-02-08,fp7d
2021-03-10,ZH,190,214,33,181,2022-05-03_11-02-08,fp7d
2021-03-11,AG,52,50,0,50,2022-05-03_11-02-08,fp7d
2021-03-11,AI,0,0,0,0,2022-05-03_11-02-08,fp7d
2021-03-11,AR,6,6,0,6,2022-05-03_11-02-08,fp7d
2021-03-11,BE,92,90,6,84,2022-05-03_11-02-08,fp7d
2021-03-11,BL,20,16,0,16,2022-05-03_11-02-08,fp7d
2021-03-11,BS,54,50,0,50,2022-05-03_11-02-08,fp7d
2021-03-11,FR,24,24,0,24,2022-05-03_11-02-08,fp7d
2021-03-11,GE,38,56,18,38,2022-05-03_11-02-08,fp7d
2021-03-11,GL,6,6,0,6,2022-05-03_11-02-08,fp7d
2021-03-11,GR,16,16,0,16,2022-05-03_11-02-08,fp7d
2021-03-11,JU,6,6,0,6,2022-05-03_11-02-08,fp7d
2021-03-11,LU,54,52,2,50,2022-05-03_11-02-08,fp7d
2021-03-11,NE,10,10,0,10,2022-05-03_11-02-08,fp7d
2021-03-11,NW,6,5,0,5,2022-05-03_11-02-08,fp7d
2021-03-11,OW,0,0,0,0,2022-05-03_11-02-08,fp7d
2021-03-11,SG,54,55,1,54,2022-05-03_11-02-08,fp7d
2021-03-11,SH,8,8,0,8,2022-05-03_11-02-08,fp7d
2021-03-11,SO,17,25,8,17,2022-05-03_11-02-08,fp7d
2021-03-11,SZ,12,11,0,11,2022-05-03_11-02-08,fp7d
2021-03-11,TG,21,36,15,21,2022-05-03_11-02-08,fp7d
2021-03-11,TI,53,74,21,53,2022-05-03_11-02-08,fp7d
2021-03-11,UR,6,6,0,6,2022-05-03_11-02-08,fp7d
2021-03-11,VD,85,111,26,85,2022-05-03_11-02-08,fp7d
2021-03-11,VS,20,21,1,20,2022-05-03_11-02-08,fp7d
2021-03-11,ZG,8,8,0,8,2022-05-03_11-02-08,fp7d
2021-03-11,ZH,190,215,32,183,2022-05-03_11-02-08,fp7d
2021-03-12,AG,52,50,0,50,2022-05-03_11-02-08,fp7d
2021-03-12,AI,0,0,0,0,2022-05-03_11-02-08,fp7d
2021-03-12,AR,6,6,0,6,2022-05-03_11-02-08,fp7d
2021-03-12,BE,92,89,6,83,2022-05-03_11-02-08,fp7d
2021-03-12,BL,20,16,0,16,2022-05-03_11-02-08,fp7d
2021-03-12,BS,54,50,0,50,2022-05-03_11-02-08,fp7d
2021-03-12,FR,24,24,0,24,2022-05-03_11-02-08,fp7d
2021-03-12,GE,38,56,18,38,2022-05-03_11-02-08,fp7d
2021-03-12,GL,6,6,0,6,2022-05-03_11-02-08,fp7d
2021-03-12,GR,16,16,0,16,2022-05-03_11-02-08,fp7d
2021-03-12,JU,6,6,0,6,2022-05-03_11-02-08,fp7d
2021-03-12,LU,54,52,2,50,2022-05-03_11-02-08,fp7d
2021-03-12,NE,10,10,0,10,2022-05-03_11-02-08,fp7d
2021-03-12,NW,6,5,0,5,2022-05-03_11-02-08,fp7d
2021-03-12,OW,0,0,0,0,2022-05-03_11-02-08,fp7d
2021-03-12,SG,54,55,1,54,2022-05-03_11-02-08,fp7d
2021-03-12,SH,8,8,0,8,2022-05-03_11-02-08,fp7d
2021-03-12,SO,17,25,8,17,2022-05-03_11-02-08,fp7d
2021-03-12,SZ,12,11,0,11,2022-05-03_11-02-08,fp7d
2021-03-12,TG,21,36,15,21,2022-05-03_11-02-08,fp7d
2021-03-12,TI,53,74,21,53,2022-05-03_11-02-08,fp7d
2021-03-12,UR,6,6,0,6,2022-05-03_11-02-08,fp7d
2021-03-12,VD,85,111,26,85,2022-05-03_11-02-08,fp7d
2021-03-12,VS,20,21,1,20,2022-05-03_11-02-08,fp7d
2021-03-12,ZG,8,8,0,8,2022-05-03_11-02-08,fp7d
2021-03-12,ZH,190,214,30,184,2022-05-03_11-02-08,fp7d
2021-03-13,AG,52,50,0,50,2022-05-03_11-02-08,fp7d
2021-03-13,AI,0,0,0,0,2022-05-03_11-02-08,fp7d
2021-03-13,AR,6,6,0,6,2022-05-03_11-02-08,fp7d
2021-03-13,BE,92,89,6,83,2022-05-03_11-02-08,fp7d
2021-03-13,BL,20,16,0,16,2022-05-03_11-02-08,fp7d
2021-03-13,BS,54,50,0,50,2022-05-03_11-02-08,fp7d
2021-03-13,FR,24,24,0,24,2022-05-03_11-02-08,fp7d
2021-03-13,GE,38,56,18,38,2022-05-03_11-02-08,fp7d
2021-03-13,GL,6,6,0,6,2022-05-03_11-02-08,fp7d
2021-03-13,GR,16,16,0,16,2022-05-03_11-02-08,fp7d
2021-03-13,JU,6,6,0,6,2022-05-03_11-02-08,fp7d
2021-03-13,LU,54,50,0,50,2022-05-03_11-02-08,fp7d
2021-03-13,NE,10,10,0,10,2022-05-03_11-02-08,fp7d
2021-03-13,NW,6,5,0,5,2022-05-03_11-02-08,fp7d
2021-03-13,OW,0,0,0,0,2022-05-03_11-02-08,fp7d
2021-03-13,SG,54,55,1,54,2022-05-03_11-02-08,fp7d
2021-03-13,SH,8,8,0,8,2022-05-03_11-02-08,fp7d
2021-03-13,SO,17,25,8,17,2022-05-03_11-02-08,fp7d
2021-03-13,SZ,12,11,0,11,2022-05-03_11-02-08,fp7d
2021-03-13,TG,21,36,15,21,2022-05-03_11-02-08,fp7d
2021-03-13,TI,53,74,21,53,2022-05-03_11-02-08,fp7d
2021-03-13,UR,6,6,0,6,2022-05-03_11-02-08,fp7d
2021-03-13,VD,85,111,26,85,2022-05-03_11-02-08,fp7d
2021-03-13,VS,20,21,1,20,2022-05-03_11-02-08,fp7d
2021-03-13,ZG,8,8,0,8,2022-05-03_11-02-08,fp7d
2021-03-13,ZH,190,215,31,184,2022-05-03_11-02-08,fp7d
2021-03-14,AG,52,50,0,50,2022-05-03_11-02-08,fp7d
2021-03-14,AI,0,0,0,0,2022-05-03_11-02-08,fp7d
2021-03-14,AR,6,6,0,6,2022-05-03_11-02-08,fp7d
2021-03-14,BE,92,89,6,83,2022-05-03_11-02-08,fp7d
2021-03-14,BL,20,16,0,16,2022-05-03_11-02-08,fp7d
2021-03-14,BS,54,48,0,48,2022-05-03_11-02-08,fp7d
2021-03-14,FR,24,24,0,24,2022-05-03_11-02-08,fp7d
2021-03-14,GE,38,56,18,38,2022-05-03_11-02-08,fp7d
2021-03-14,GL,6,6,0,6,2022-05-03_11-02-08,fp7d
2021-03-14,GR,16,16,0,16,2022-05-03_11-02-08,fp7d
2021-03-14,JU,6,6,0,6,2022-05-03_11-02-08,fp7d
2021-03-14,LU,54,50,0,50,2022-05-03_11-02-08,fp7d
2021-03-14,NE,10,10,0,10,2022-05-03_11-02-08,fp7d
2021-03-14,NW,6,5,0,5,2022-05-03_11-02-08,fp7d
2021-03-14,OW,0,0,0,0,2022-05-03_11-02-08,fp7d
2021-03-14,SG,54,55,1,54,2022-05-03_11-02-08,fp7d
2021-03-14,SH,8,8,0,8,2022-05-03_11-02-08,fp7d
2021-03-14,SO,17,25,8,17,2022-05-03_11-02-08,fp7d
2021-03-14,SZ,12,11,0,11,2022-05-03_11-02-08,fp7d
2021-03-14,TG,21,36,15,21,2022-05-03_11-02-08,fp7d
2021-03-14,TI,53,74,21,53,2022-05-03_11-02-08,fp7d
2021-03-14,UR,6,6,0,6,2022-05-03_11-02-08,fp7d
2021-03-14,VD,85,111,26,85,2022-05-03_11-02-08,fp7d
2021-03-14,VS,20,21,1,20,2022-05-03_11-02-08,fp7d
2021-03-14,ZG,8,8,0,8,2022-05-03_11-02-08,fp7d
2021-03-14,ZH,190,215,31,184,2022-05-03_11-02-08,fp7d
2021-03-15,AG,52,50,0,50,2022-05-03_11-02-08,fp7d
2021-03-15,AI,0,0,0,0,2022-05-03_11-02-08,fp7d
2021-03-15,AR,6,6,0,6,2022-05-03_11-02-08,fp7d
2021-03-15,BE,104,103,6,97,2022-05-03_11-02-08,fp7d
2021-03-15,BL,20,16,0,16,2022-05-03_11-02-08,fp7d
2021-03-15,BS,54,50,0,50,2022-05-03_11-02-08,fp7d
2021-03-15,FR,24,24,0,24,2022-05-03_11-02-08,fp7d
2021-03-15,GE,38,56,18,38,2022-05-03_11-02-08,fp7d
2021-03-15,GL,6,6,0,6,2022-05-03_11-02-08,fp7d
2021-03-15,GR,16,16,0,16,2022-05-03_11-02-08,fp7d
2021-03-15,JU,6,6,0,6,2022-05-03_11-02-08,fp7d
2021-03-15,LU,40,42,2,40,2022-05-03_11-02-08,fp7d
2021-03-15,NE,10,10,0,10,2022-05-03_11-02-08,fp7d
2021-03-15,NW,6,5,0,5,2022-05-03_11-02-08,fp7d
2021-03-15,OW,0,0,0,0,2022-05-03_11-02-08,fp7d
2021-03-15,SG,54,55,1,54,2022-05-03_11-02-08,fp7d
2021-03-15,SH,8,8,0,8,2022-05-03_11-02-08,fp7d
2021-03-15,SO,17,25,8,17,2022-05-03_11-02-08,fp7d
2021-03-15,SZ,12,11,0,11,2022-05-03_11-02-08,fp7d
2021-03-15,TG,21,36,15,21,2022-05-03_11-02-08,fp7d
2021-03-15,TI,53,74,21,53,2022-05-03_11-02-08,fp7d
2021-03-15,UR,6,6,0,6,2022-05-03_11-02-08,fp7d
2021-03-15,VD,85,111,26,85,2022-05-03_11-02-08,fp7d
2021-03-15,VS,14,15,1,14,2022-05-03_11-02-08,fp7d
2021-03-15,ZG,8,8,0,8,2022-05-03_11-02-08,fp7d
2021-03-15,ZH,190,214,31,183,2022-05-03_11-02-08,fp7d
2021-03-16,AG,52,50,0,50,2022-05-03_11-02-08,fp7d
2021-03-16,AI,0,0,0,0,2022-05-03_11-02-08,fp7d
2021-03-16,AR,6,6,0,6,2022-05-03_11-02-08,fp7d
2021-03-16,BE,104,102,6,96,2022-05-03_11-02-08,fp7d
2021-03-16,BL,20,16,0,16,2022-05-03_11-02-08,fp7d
2021-03-16,BS,54,50,0,50,2022-05-03_11-02-08,fp7d
2021-03-16,FR,24,24,0,24,2022-05-03_11-02-08,fp7d
2021-03-16,GE,38,56,18,38,2022-05-03_11-02-08,fp7d
2021-03-16,GL,6,6,0,6,2022-05-03_11-02-08,fp7d
2021-03-16,GR,16,16,0,16,2022-05-03_11-02-08,fp7d
2021-03-16,JU,6,6,0,6,2022-05-03_11-02-08,fp7d
2021-03-16,LU,40,42,2,40,2022-05-03_11-02-08,fp7d
2021-03-16,NE,10,10,0,10,2022-05-03_11-02-08,fp7d
2021-03-16,NW,6,5,0,5,2022-05-03_11-02-08,fp7d
2021-03-16,OW,0,0,0,0,2022-05-03_11-02-08,fp7d
2021-03-16,SG,54,55,1,54,2022-05-03_11-02-08,fp7d
2021-03-16,SH,8,8,0,8,2022-05-03_11-02-08,fp7d
2021-03-16,SO,17,25,8,17,2022-05-03_11-02-08,fp7d
2021-03-16,SZ,12,11,0,11,2022-05-03_11-02-08,fp7d
2021-03-16,TG,21,36,15,21,2022-05-03_11-02-08,fp7d
2021-03-16,TI,53,74,21,53,2022-05-03_11-02-08,fp7d
2021-03-16,UR,6,6,0,6,2022-05-03_11-02-08,fp7d
2021-03-16,VD,85,108,23,85,2022-05-03_11-02-08,fp7d
2021-03-16,VS,14,14,0,14,2022-05-03_11-02-08,fp7d
2021-03-16,ZG,8,8,0,8,2022-05-03_11-02-08,fp7d
2021-03-16,ZH,190,213,31,182,2022-05-03_11-02-08,fp7d
2021-03-17,AG,52,50,0,50,2022-05-03_11-02-08,fp7d
2021-03-17,AI,0,0,0,0,2022-05-03_11-02-08,fp7d
2021-03-17,AR,6,6,0,6,2022-05-03_11-02-08,fp7d
2021-03-17,BE,104,102,6,96,2022-05-03_11-02-08,fp7d
2021-03-17,BL,20,16,0,16,2022-05-03_11-02-08,fp7d
2021-03-17,BS,54,50,0,50,2022-05-03_11-02-08,fp7d
2021-03-17,FR,24,24,0,24,2022-05-03_11-02-08,fp7d
2021-03-17,GE,38,50,12,38,2022-05-03_11-02-08,fp7d
2021-03-17,GL,6,6,0,6,2022-05-03_11-02-08,fp7d
2021-03-17,GR,16,16,0,16,2022-05-03_11-02-08,fp7d
2021-03-17,JU,6,6,0,6,2022-05-03_11-02-08,fp7d
2021-03-17,LU,40,42,2,40,2022-05-03_11-02-08,fp7d
2021-03-17,NE,10,10,0,10,2022-05-03_11-02-08,fp7d
2021-03-17,NW,6,5,0,5,2022-05-03_11-02-08,fp7d
2021-03-17,OW,0,0,0,0,2022-05-03_11-02-08,fp7d
2021-03-17,SG,54,55,1,54,2022-05-03_11-02-08,fp7d
2021-03-17,SH,8,8,0,8,2022-05-03_11-02-08,fp7d
2021-03-17,SO,17,25,8,17,2022-05-03_11-02-08,fp7d
2021-03-17,SZ,12,11,0,11,2022-05-03_11-02-08,fp7d
2021-03-17,TG,21,36,15,21,2022-05-03_11-02-08,fp7d
2021-03-17,TI,53,74,21,53,2022-05-03_11-02-08,fp7d
2021-03-17,UR,6,6,0,6,2022-05-03_11-02-08,fp7d
2021-03-17,VD,85,108,23,85,2022-05-03_11-02-08,fp7d
2021-03-17,VS,14,14,0,14,2022-05-03_11-02-08,fp7d
2021-03-17,ZG,8,8,0,8,2022-05-03_11-02-08,fp7d
2021-03-17,ZH,190,213,31,182,2022-05-03_11-02-08,fp7d
2021-03-18,AG,52,50,0,50,2022-05-03_11-02-08,fp7d
2021-03-18,AI,0,0,0,0,2022-05-03_11-02-08,fp7d
2021-03-18,AR,6,6,0,6,2022-05-03_11-02-08,fp7d
2021-03-18,BE,104,103,6,97,2022-05-03_11-02-08,fp7d
2021-03-18,BL,20,16,0,16,2022-05-03_11-02-08,fp7d
2021-03-18,BS,54,50,0,50,2022-05-03_11-02-08,fp7d
2021-03-18,FR,24,24,0,24,2022-05-03_11-02-08,fp7d
2021-03-18,GE,38,50,12,38,2022-05-03_11-02-08,fp7d
2021-03-18,GL,6,6,0,6,2022-05-03_11-02-08,fp7d
2021-03-18,GR,16,16,0,16,2022-05-03_11-02-08,fp7d
2021-03-18,JU,6,6,0,6,2022-05-03_11-02-08,fp7d
2021-03-18,LU,40,42,2,40,2022-05-03_11-02-08,fp7d
2021-03-18,NE,10,10,0,10,2022-05-03_11-02-08,fp7d
2021-03-18,NW,6,5,0,5,2022-05-03_11-02-08,fp7d
2021-03-18,OW,0,0,0,0,2022-05-03_11-02-08,fp7d
2021-03-18,SG,54,55,1,54,2022-05-03_11-02-08,fp7d
2021-03-18,SH,8,8,0,8,2022-05-03_11-02-08,fp7d
2021-03-18,SO,17,25,8,17,2022-05-03_11-02-08,fp7d
2021-03-18,SZ,12,11,0,11,2022-05-03_11-02-08,fp7d
2021-03-18,TG,21,36,15,21,2022-05-03_11-02-08,fp7d
2021-03-18,TI,53,74,21,53,2022-05-03_11-02-08,fp7d
2021-03-18,UR,6,6,0,6,2022-05-03_11-02-08,fp7d
2021-03-18,VD,85,108,23,85,2022-05-03_11-02-08,fp7d
2021-03-18,VS,14,14,0,14,2022-05-03_11-02-08,fp7d
2021-03-18,ZG,8,8,0,8,2022-05-03_11-02-08,fp7d
2021-03-18,ZH,190,213,31,182,2022-05-03_11-02-08,fp7d
2021-03-19,AG,52,50,0,50,2022-05-03_11-02-08,fp7d
2021-03-19,AI,0,0,0,0,2022-05-03_11-02-08,fp7d
2021-03-19,AR,6,6,0,6,2022-05-03_11-02-08,fp7d
2021-03-19,BE,104,103,6,97,2022-05-03_11-02-08,fp7d
2021-03-19,BL,20,16,0,16,2022-05-03_11-02-08,fp7d
2021-03-19,BS,54,50,0,50,2022-05-03_11-02-08,fp7d
2021-03-19,FR,24,24,0,24,2022-05-03_11-02-08,fp7d
2021-03-19,GE,38,50,12,38,2022-05-03_11-02-08,fp7d
2021-03-19,GL,6,6,0,6,2022-05-03_11-02-08,fp7d
2021-03-19,GR,16,16,0,16,2022-05-03_11-02-08,fp7d
2021-03-19,JU,6,6,0,6,2022-05-03_11-02-08,fp7d
2021-03-19,LU,40,42,2,40,2022-05-03_11-02-08,fp7d
2021-03-19,NE,10,10,0,10,2022-05-03_11-02-08,fp7d
2021-03-19,NW,6,5,0,5,2022-05-03_11-02-08,fp7d
2021-03-19,OW,0,0,0,0,2022-05-03_11-02-08,fp7d
2021-03-19,SG,54,55,1,54,2022-05-03_11-02-08,fp7d
2021-03-19,SH,8,8,0,8,2022-05-03_11-02-08,fp7d
2021-03-19,SO,17,25,8,17,2022-05-03_11-02-08,fp7d
2021-03-19,SZ,12,11,0,11,2022-05-03_11-02-08,fp7d
2021-03-19,TG,21,36,15,21,2022-05-03_11-02-08,fp7d
2021-03-19,TI,53,74,21,53,2022-05-03_11-02-08,fp7d
2021-03-19,UR,6,6,0,6,2022-05-03_11-02-08,fp7d
2021-03-19,VD,85,108,23,85,2022-05-03_11-02-08,fp7d
2021-03-19,VS,14,14,0,14,2022-05-03_11-02-08,fp7d
2021-03-19,ZG,8,8,0,8,2022-05-03_11-02-08,fp7d
2021-03-19,ZH,190,215,33,182,2022-05-03_11-02-08,fp7d
2021-03-20,AG,52,50,0,50,2022-05-03_11-02-08,fp7d
2021-03-20,AI,0,0,0,0,2022-05-03_11-02-08,fp7d
2021-03-20,AR,6,6,0,6,2022-05-03_11-02-08,fp7d
2021-03-20,BE,104,103,6,97,2022-05-03_11-02-08,fp7d
2021-03-20,BL,20,16,0,16,2022-05-03_11-02-08,fp7d
2021-03-20,BS,54,46,0,46,2022-05-03_11-02-08,fp7d
2021-03-20,FR,24,24,0,24,2022-05-03_11-02-08,fp7d
2021-03-20,GE,38,50,12,38,2022-05-03_11-02-08,fp7d
2021-03-20,GL,6,6,0,6,2022-05-03_11-02-08,fp7d
2021-03-20,GR,16,16,0,16,2022-05-03_11-02-08,fp7d
2021-03-20,JU,6,6,0,6,2022-05-03_11-02-08,fp7d
2021-03-20,LU,40,38,0,38,2022-05-03_11-02-08,fp7d
2021-03-20,NE,10,10,0,10,2022-05-03_11-02-08,fp7d
2021-03-20,NW,6,5,0,5,2022-05-03_11-02-08,fp7d
2021-03-20,OW,0,0,0,0,2022-05-03_11-02-08,fp7d
2021-03-20,SG,54,55,1,54,2022-05-03_11-02-08,fp7d
2021-03-20,SH,8,8,0,8,2022-05-03_11-02-08,fp7d
2021-03-20,SO,17,25,8,17,2022-05-03_11-02-08,fp7d
2021-03-20,SZ,12,11,0,11,2022-05-03_11-02-08,fp7d
2021-03-20,TG,21,36,15,21,2022-05-03_11-02-08,fp7d
2021-03-20,TI,53,74,21,53,2022-05-03_11-02-08,fp7d
2021-03-20,UR,6,6,0,6,2022-05-03_11-02-08,fp7d
2021-03-20,VD,85,108,23,85,2022-05-03_11-02-08,fp7d
2021-03-20,VS,14,14,0,14,2022-05-03_11-02-08,fp7d
2021-03-20,ZG,8,8,0,8,2022-05-03_11-02-08,fp7d
2021-03-20,ZH,190,213,31,182,2022-05-03_11-02-08,fp7d
2021-03-21,AG,52,50,0,50,2022-05-03_11-02-08,fp7d
2021-03-21,AI,0,0,0,0,2022-05-03_11-02-08,fp7d
2021-03-21,AR,6,6,0,6,2022-05-03_11-02-08,fp7d
2021-03-21,BE,104,103,6,97,2022-05-03_11-02-08,fp7d
2021-03-21,BL,20,16,0,16,2022-05-03_11-02-08,fp7d
2021-03-21,BS,54,46,0,46,2022-05-03_11-02-08,fp7d
2021-03-21,FR,24,24,0,24,2022-05-03_11-02-08,fp7d
2021-03-21,GE,38,50,12,38,2022-05-03_11-02-08,fp7d
2021-03-21,GL,6,6,0,6,2022-05-03_11-02-08,fp7d
2021-03-21,GR,16,16,0,16,2022-05-03_11-02-08,fp7d
2021-03-21,JU,6,6,0,6,2022-05-03_11-02-08,fp7d
2021-03-21,LU,40,38,0,38,2022-05-03_11-02-08,fp7d
2021-03-21,NE,10,10,0,10,2022-05-03_11-02-08,fp7d
2021-03-21,NW,6,6,0,6,2022-05-03_11-02-08,fp7d
2021-03-21,OW,0,0,0,0,2022-05-03_11-02-08,fp7d
2021-03-21,SG,54,55,1,54,2022-05-03_11-02-08,fp7d
2021-03-21,SH,8,8,0,8,2022-05-03_11-02-08,fp7d
2021-03-21,SO,17,25,8,17,2022-05-03_11-02-08,fp7d
2021-03-21,SZ,12,11,0,11,2022-05-03_11-02-08,fp7d
2021-03-21,TG,21,36,15,21,2022-05-03_11-02-08,fp7d
2021-03-21,TI,53,74,21,53,2022-05-03_11-02-08,fp7d
2021-03-21,UR,6,6,0,6,2022-05-03_11-02-08,fp7d
2021-03-21,VD,85,109,24,85,2022-05-03_11-02-08,fp7d
2021-03-21,VS,14,14,0,14,2022-05-03_11-02-08,fp7d
2021-03-21,ZG,8,8,0,8,2022-05-03_11-02-08,fp7d
2021-03-21,ZH,190,213,30,183,2022-05-03_11-02-08,fp7d
2021-03-22,AG,52,50,0,50,2022-05-03_11-02-08,fp7d
2021-03-22,AI,0,0,0,0,2022-05-03_11-02-08,fp7d
2021-03-22,AR,6,6,0,6,2022-05-03_11-02-08,fp7d
2021-03-22,BE,92,91,6,85,2022-05-03_11-02-08,fp7d
2021-03-22,BL,20,16,0,16,2022-05-03_11-02-08,fp7d
2021-03-22,BS,54,50,0,50,2022-05-03_11-02-08,fp7d
2021-03-22,FR,24,24,0,24,2022-05-03_11-02-08,fp7d
2021-03-22,GE,38,50,12,38,2022-05-03_11-02-08,fp7d
2021-03-22,GL,6,6,0,6,2022-05-03_11-02-08,fp7d
2021-03-22,GR,16,16,0,16,2022-05-03_11-02-08,fp7d
2021-03-22,JU,6,6,0,6,2022-05-03_11-02-08,fp7d
2021-03-22,LU,40,40,0,40,2022-05-03_11-02-08,fp7d
2021-03-22,NE,10,10,0,10,2022-05-03_11-02-08,fp7d
2021-03-22,NW,6,5,0,5,2022-05-03_11-02-08,fp7d
2021-03-22,OW,0,0,0,0,2022-05-03_11-02-08,fp7d
2021-03-22,SG,54,55,1,54,2022-05-03_11-02-08,fp7d
2021-03-22,SH,8,8,0,8,2022-05-03_11-02-08,fp7d
2021-03-22,SO,17,25,8,17,2022-05-03_11-02-08,fp7d
2021-03-22,SZ,12,11,0,11,2022-05-03_11-02-08,fp7d
2021-03-22,TG,21,36,15,21,2022-05-03_11-02-08,fp7d
2021-03-22,TI,53,74,21,53,2022-05-03_11-02-08,fp7d
2021-03-22,UR,6,6,0,6,2022-05-03_11-02-08,fp7d
2021-03-22,VD,85,108,23,85,2022-05-03_11-02-08,fp7d
2021-03-22,VS,14,14,0,14,2022-05-03_11-02-08,fp7d
2021-03-22,ZG,8,8,0,8,2022-05-03_11-02-08,fp7d
2021-03-22,ZH,190,213,30,183,2022-05-03_11-02-08,fp7d
2021-03-23,AG,52,50,0,50,2022-05-03_11-02-08,fp7d
2021-03-23,AI,0,0,0,0,2022-05-03_11-02-08,fp7d
2021-03-23,AR,6,6,0,6,2022-05-03_11-02-08,fp7d
2021-03-23,BE,92,91,6,85,2022-05-03_11-02-08,fp7d
2021-03-23,BL,20,16,0,16,2022-05-03_11-02-08,fp7d
2021-03-23,BS,54,50,0,50,2022-05-03_11-02-08,fp7d
2021-03-23,FR,24,24,0,24,2022-05-03_11-02-08,fp7d
2021-03-23,GE,38,50,12,38,2022-05-03_11-02-08,fp7d
2021-03-23,GL,6,6,0,6,2022-05-03_11-02-08,fp7d
2021-03-23,GR,16,16,0,16,2022-05-03_11-02-08,fp7d
2021-03-23,JU,6,6,0,6,2022-05-03_11-02-08,fp7d
2021-03-23,LU,40,40,0,40,2022-05-03_11-02-08,fp7d
2021-03-23,NE,10,10,0,10,2022-05-03_11-02-08,fp7d
2021-03-23,NW,6,5,0,5,2022-05-03_11-02-08,fp7d
2021-03-23,OW,0,0,0,0,2022-05-03_11-02-08,fp7d
2021-03-23,SG,54,55,1,54,2022-05-03_11-02-08,fp7d
2021-03-23,SH,8,8,0,8,2022-05-03_11-02-08,fp7d
2021-03-23,SO,17,25,8,17,2022-05-03_11-02-08,fp7d
2021-03-23,SZ,12,11,0,11,2022-05-03_11-02-08,fp7d
2021-03-23,TG,21,36,15,21,2022-05-03_11-02-08,fp7d
2021-03-23,TI,53,74,21,53,2022-05-03_11-02-08,fp7d
2021-03-23,UR,6,6,0,6,2022-05-03_11-02-08,fp7d
2021-03-23,VD,85,108,23,85,2022-05-03_11-02-08,fp7d
2021-03-23,VS,14,14,0,14,2022-05-03_11-02-08,fp7d
2021-03-23,ZG,8,8,0,8,2022-05-03_11-02-08,fp7d
2021-03-23,ZH,190,213,30,183,2022-05-03_11-02-08,fp7d
2021-03-24,AG,52,50,0,50,2022-05-03_11-02-08,fp7d
2021-03-24,AI,0,0,0,0,2022-05-03_11-02-08,fp7d
2021-03-24,AR,6,6,0,6,2022-05-03_11-02-08,fp7d
2021-03-24,BE,92,91,6,85,2022-05-03_11-02-08,fp7d
2021-03-24,BL,20,16,0,16,2022-05-03_11-02-08,fp7d
2021-03-24,BS,54,50,0,50,2022-05-03_11-02-08,fp7d
2021-03-24,FR,24,24,0,24,2022-05-03_11-02-08,fp7d
2021-03-24,GE,38,50,12,38,2022-05-03_11-02-08,fp7d
2021-03-24,GL,6,6,0,6,2022-05-03_11-02-08,fp7d
2021-03-24,GR,16,16,0,16,2022-05-03_11-02-08,fp7d
2021-03-24,JU,6,6,0,6,2022-05-03_11-02-08,fp7d
2021-03-24,LU,40,40,0,40,2022-05-03_11-02-08,fp7d
2021-03-24,NE,10,10,0,10,2022-05-03_11-02-08,fp7d
2021-03-24,NW,6,6,0,6,2022-05-03_11-02-08,fp7d
2021-03-24,OW,0,0,0,0,2022-05-03_11-02-08,fp7d
2021-03-24,SG,54,55,1,54,2022-05-03_11-02-08,fp7d
2021-03-24,SH,8,8,0,8,2022-05-03_11-02-08,fp7d
2021-03-24,SO,17,25,8,17,2022-05-03_11-02-08,fp7d
2021-03-24,SZ,12,11,0,11,2022-05-03_11-02-08,fp7d
2021-03-24,TG,21,36,15,21,2022-05-03_11-02-08,fp7d
2021-03-24,TI,53,74,21,53,2022-05-03_11-02-08,fp7d
2021-03-24,UR,6,6,0,6,2022-05-03_11-02-08,fp7d
2021-03-24,VD,85,108,23,85,2022-05-03_11-02-08,fp7d
2021-03-24,VS,14,14,0,14,2022-05-03_11-02-08,fp7d
2021-03-24,ZG,8,8,0,8,2022-05-03_11-02-08,fp7d
2021-03-24,ZH,190,213,30,183,2022-05-03_11-02-08,fp7d
2021-03-25,AG,52,50,0,50,2022-05-03_11-02-08,fp7d
2021-03-25,AI,0,0,0,0,2022-05-03_11-02-08,fp7d
2021-03-25,AR,6,6,0,6,2022-05-03_11-02-08,fp7d
2021-03-25,BE,92,89,6,83,2022-05-03_11-02-08,fp7d
2021-03-25,BL,20,16,0,16,2022-05-03_11-02-08,fp7d
2021-03-25,BS,54,50,0,50,2022-05-03_11-02-08,fp7d
2021-03-25,FR,24,24,0,24,2022-05-03_11-02-08,fp7d
2021-03-25,GE,38,50,12,38,2022-05-03_11-02-08,fp7d
2021-03-25,GL,6,6,0,6,2022-05-03_11-02-08,fp7d
2021-03-25,GR,16,16,0,16,2022-05-03_11-02-08,fp7d
2021-03-25,JU,6,6,0,6,2022-05-03_11-02-08,fp7d
2021-03-25,LU,40,42,2,40,2022-05-03_11-02-08,fp7d
2021-03-25,NE,10,10,0,10,2022-05-03_11-02-08,fp7d
2021-03-25,NW,6,6,0,6,2022-05-03_11-02-08,fp7d
2021-03-25,OW,0,0,0,0,2022-05-03_11-02-08,fp7d
2021-03-25,SG,54,55,1,54,2022-05-03_11-02-08,fp7d
2021-03-25,SH,8,8,0,8,2022-05-03_11-02-08,fp7d
2021-03-25,SO,17,25,8,17,2022-05-03_11-02-08,fp7d
2021-03-25,SZ,12,11,0,11,2022-05-03_11-02-08,fp7d
2021-03-25,TG,21,36,15,21,2022-05-03_11-02-08,fp7d
2021-03-25,TI,53,76,23,53,2022-05-03_11-02-08,fp7d
2021-03-25,UR,6,6,0,6,2022-05-03_11-02-08,fp7d
2021-03-25,VD,85,109,24,85,2022-05-03_11-02-08,fp7d
2021-03-25,VS,14,14,0,14,2022-05-03_11-02-08,fp7d
2021-03-25,ZG,8,8,0,8,2022-05-03_11-02-08,fp7d
2021-03-25,ZH,190,214,31,183,2022-05-03_11-02-08,fp7d
2021-03-26,AG,52,50,0,50,2022-05-03_11-02-08,fp7d
2021-03-26,AI,0,0,0,0,2022-05-03_11-02-08,fp7d
2021-03-26,AR,6,6,0,6,2022-05-03_11-02-08,fp7d
2021-03-26,BE,92,89,6,83,2022-05-03_11-02-08,fp7d
2021-03-26,BL,20,16,0,16,2022-05-03_11-02-08,fp7d
2021-03-26,BS,54,50,0,50,2022-05-03_11-02-08,fp7d
2021-03-26,FR,24,24,0,24,2022-05-03_11-02-08,fp7d
2021-03-26,GE,38,50,12,38,2022-05-03_11-02-08,fp7d
2021-03-26,GL,6,6,0,6,2022-05-03_11-02-08,fp7d
2021-03-26,GR,16,16,0,16,2022-05-03_11-02-08,fp7d
2021-03-26,JU,6,6,0,6,2022-05-03_11-02-08,fp7d
2021-03-26,LU,40,42,2,40,2022-05-03_11-02-08,fp7d
2021-03-26,NE,10,10,0,10,2022-05-03_11-02-08,fp7d
2021-03-26,NW,6,6,0,6,2022-05-03_11-02-08,fp7d
2021-03-26,OW,0,0,0,0,2022-05-03_11-02-08,fp7d
2021-03-26,SG,54,55,1,54,2022-05-03_11-02-08,fp7d
2021-03-26,SH,8,8,0,8,2022-05-03_11-02-08,fp7d
2021-03-26,SO,17,25,8,17,2022-05-03_11-02-08,fp7d
2021-03-26,SZ,12,11,0,11,2022-05-03_11-02-08,fp7d
2021-03-26,TG,21,36,15,21,2022-05-03_11-02-08,fp7d
2021-03-26,TI,53,76,23,53,2022-05-03_11-02-08,fp7d
2021-03-26,UR,6,6,0,6,2022-05-03_11-02-08,fp7d
2021-03-26,VD,85,106,21,85,2022-05-03_11-02-08,fp7d
2021-03-26,VS,14,14,0,14,2022-05-03_11-02-08,fp7d
2021-03-26,ZG,8,8,0,8,2022-05-03_11-02-08,fp7d
2021-03-26,ZH,190,214,31,183,2022-05-03_11-02-08,fp7d
2021-03-27,AG,52,51,0,51,2022-05-03_11-02-08,fp7d
2021-03-27,AI,0,0,0,0,2022-05-03_11-02-08,fp7d
2021-03-27,AR,6,6,0,6,2022-05-03_11-02-08,fp7d
2021-03-27,BE,92,89,6,83,2022-05-03_11-02-08,fp7d
2021-03-27,BL,20,16,0,16,2022-05-03_11-02-08,fp7d
2021-03-27,BS,54,46,0,46,2022-05-03_11-02-08,fp7d
2021-03-27,FR,24,24,0,24,2022-05-03_11-02-08,fp7d
2021-03-27,GE,38,50,12,38,2022-05-03_11-02-08,fp7d
2021-03-27,GL,6,6,0,6,2022-05-03_11-02-08,fp7d
2021-03-27,GR,16,16,0,16,2022-05-03_11-02-08,fp7d
2021-03-27,JU,6,6,0,6,2022-05-03_11-02-08,fp7d
2021-03-27,LU,40,42,2,40,2022-05-03_11-02-08,fp7d
2021-03-27,NE,10,10,0,10,2022-05-03_11-02-08,fp7d
2021-03-27,NW,6,6,0,6,2022-05-03_11-02-08,fp7d
2021-03-27,OW,0,0,0,0,2022-05-03_11-02-08,fp7d
2021-03-27,SG,54,55,1,54,2022-05-03_11-02-08,fp7d
2021-03-27,SH,8,8,0,8,2022-05-03_11-02-08,fp7d
2021-03-27,SO,17,25,8,17,2022-05-03_11-02-08,fp7d
2021-03-27,SZ,12,11,0,11,2022-05-03_11-02-08,fp7d
2021-03-27,TG,21,36,15,21,2022-05-03_11-02-08,fp7d
2021-03-27,TI,53,76,23,53,2022-05-03_11-02-08,fp7d
2021-03-27,UR,6,6,0,6,2022-05-03_11-02-08,fp7d
2021-03-27,VD,85,106,21,85,2022-05-03_11-02-08,fp7d
2021-03-27,VS,14,14,0,14,2022-05-03_11-02-08,fp7d
2021-03-27,ZG,8,8,0,8,2022-05-03_11-02-08,fp7d
2021-03-27,ZH,190,214,31,183,2022-05-03_11-02-08,fp7d
2021-03-28,AG,52,50,0,50,2022-05-03_11-02-08,fp7d
2021-03-28,AI,0,0,0,0,2022-05-03_11-02-08,fp7d
2021-03-28,AR,6,6,0,6,2022-05-03_11-02-08,fp7d
2021-03-28,BE,92,89,6,83,2022-05-03_11-02-08,fp7d
2021-03-28,BL,20,16,0,16,2022-05-03_11-02-08,fp7d
2021-03-28,BS,54,46,0,46,2022-05-03_11-02-08,fp7d
2021-03-28,FR,24,24,0,24,2022-05-03_11-02-08,fp7d
2021-03-28,GE,38,50,12,38,2022-05-03_11-02-08,fp7d
2021-03-28,GL,6,6,0,6,2022-05-03_11-02-08,fp7d
2021-03-28,GR,16,16,0,16,2022-05-03_11-02-08,fp7d
2021-03-28,JU,6,6,0,6,2022-05-03_11-02-08,fp7d
2021-03-28,LU,40,42,2,40,2022-05-03_11-02-08,fp7d
2021-03-28,NE,10,10,0,10,2022-05-03_11-02-08,fp7d
2021-03-28,NW,6,6,0,6,2022-05-03_11-02-08,fp7d
2021-03-28,OW,0,0,0,0,2022-05-03_11-02-08,fp7d
2021-03-28,SG,54,55,1,54,2022-05-03_11-02-08,fp7d
2021-03-28,SH,8,8,0,8,2022-05-03_11-02-08,fp7d
2021-03-28,SO,17,25,8,17,2022-05-03_11-02-08,fp7d
2021-03-28,SZ,12,11,0,11,2022-05-03_11-02-08,fp7d
2021-03-28,TG,21,36,15,21,2022-05-03_11-02-08,fp7d
2021-03-28,TI,53,76,23,53,2022-05-03_11-02-08,fp7d
2021-03-28,UR,6,6,0,6,2022-05-03_11-02-08,fp7d
2021-03-28,VD,85,106,21,85,2022-05-03_11-02-08,fp7d
2021-03-28,VS,14,14,0,14,2022-05-03_11-02-08,fp7d
2021-03-28,ZG,8,8,0,8,2022-05-03_11-02-08,fp7d
2021-03-28,ZH,190,216,33,183,2022-05-03_11-02-08,fp7d
2021-03-29,AG,52,50,0,50,2022-05-03_11-02-08,fp7d
2021-03-29,AI,0,0,0,0,2022-05-03_11-02-08,fp7d
2021-03-29,AR,6,6,0,6,2022-05-03_11-02-08,fp7d
2021-03-29,BE,104,100,6,94,2022-05-03_11-02-08,fp7d
2021-03-29,BL,20,16,0,16,2022-05-03_11-02-08,fp7d
2021-03-29,BS,54,50,0,50,2022-05-03_11-02-08,fp7d
2021-03-29,FR,24,24,0,24,2022-05-03_11-02-08,fp7d
2021-03-29,GE,38,50,12,38,2022-05-03_11-02-08,fp7d
2021-03-29,GL,6,6,0,6,2022-05-03_11-02-08,fp7d
2021-03-29,GR,16,16,0,16,2022-05-03_11-02-08,fp7d
2021-03-29,JU,6,6,0,6,2022-05-03_11-02-08,fp7d
2021-03-29,LU,40,42,2,40,2022-05-03_11-02-08,fp7d
2021-03-29,NE,10,10,0,10,2022-05-03_11-02-08,fp7d
2021-03-29,NW,6,6,0,6,2022-05-03_11-02-08,fp7d
2021-03-29,OW,0,0,0,0,2022-05-03_11-02-08,fp7d
2021-03-29,SG,54,55,1,54,2022-05-03_11-02-08,fp7d
2021-03-29,SH,8,8,0,8,2022-05-03_11-02-08,fp7d
2021-03-29,SO,17,25,8,17,2022-05-03_11-02-08,fp7d
2021-03-29,SZ,12,11,0,11,2022-05-03_11-02-08,fp7d
2021-03-29,TG,21,36,15,21,2022-05-03_11-02-08,fp7d
2021-03-29,TI,53,76,23,53,2022-05-03_11-02-08,fp7d
2021-03-29,UR,6,6,0,6,2022-05-03_11-02-08,fp7d
2021-03-29,VD,85,106,21,85,2022-05-03_11-02-08,fp7d
2021-03-29,VS,14,14,0,14,2022-05-03_11-02-08,fp7d
2021-03-29,ZG,8,8,0,8,2022-05-03_11-02-08,fp7d
2021-03-29,ZH,190,212,29,183,2022-05-03_11-02-08,fp7d
2021-03-30,AG,52,50,0,50,2022-05-03_11-02-08,fp7d
2021-03-30,AI,0,0,0,0,2022-05-03_11-02-08,fp7d
2021-03-30,AR,6,6,0,6,2022-05-03_11-02-08,fp7d
2021-03-30,BE,104,100,6,94,2022-05-03_11-02-08,fp7d
2021-03-30,BL,20,16,0,16,2022-05-03_11-02-08,fp7d
2021-03-30,BS,54,50,0,50,2022-05-03_11-02-08,fp7d
2021-03-30,FR,24,24,0,24,2022-05-03_11-02-08,fp7d
2021-03-30,GE,38,50,12,38,2022-05-03_11-02-08,fp7d
2021-03-30,GL,6,6,0,6,2022-05-03_11-02-08,fp7d
2021-03-30,GR,16,16,0,16,2022-05-03_11-02-08,fp7d
2021-03-30,JU,6,6,0,6,2022-05-03_11-02-08,fp7d
2021-03-30,LU,40,42,2,40,2022-05-03_11-02-08,fp7d
2021-03-30,NE,10,10,0,10,2022-05-03_11-02-08,fp7d
2021-03-30,NW,6,6,0,6,2022-05-03_11-02-08,fp7d
2021-03-30,OW,0,0,0,0,2022-05-03_11-02-08,fp7d
2021-03-30,SG,54,55,1,54,2022-05-03_11-02-08,fp7d
2021-03-30,SH,8,8,0,8,2022-05-03_11-02-08,fp7d
2021-03-30,SO,17,25,8,17,2022-05-03_11-02-08,fp7d
2021-03-30,SZ,12,11,0,11,2022-05-03_11-02-08,fp7d
2021-03-30,TG,21,36,15,21,2022-05-03_11-02-08,fp7d
2021-03-30,TI,53,76,23,53,2022-05-03_11-02-08,fp7d
2021-03-30,UR,6,6,0,6,2022-05-03_11-02-08,fp7d
2021-03-30,VD,85,103,18,85,2022-05-03_11-02-08,fp7d
2021-03-30,VS,14,14,0,14,2022-05-03_11-02-08,fp7d
2021-03-30,ZG,8,8,0,8,2022-05-03_11-02-08,fp7d
2021-03-30,ZH,190,213,30,183,2022-05-03_11-02-08,fp7d
2021-03-31,AG,52,50,0,50,2022-05-03_11-02-08,fp7d
2021-03-31,AI,0,0,0,0,2022-05-03_11-02-08,fp7d
2021-03-31,AR,6,6,0,6,2022-05-03_11-02-08,fp7d
2021-03-31,BE,104,100,6,94,2022-05-03_11-02-08,fp7d
2021-03-31,BL,20,16,0,16,2022-05-03_11-02-08,fp7d
2021-03-31,BS,54,50,0,50,2022-05-03_11-02-08,fp7d
2021-03-31,FR,24,24,0,24,2022-05-03_11-02-08,fp7d
2021-03-31,GE,38,50,12,38,2022-05-03_11-02-08,fp7d
2021-03-31,GL,6,6,0,6,2022-05-03_11-02-08,fp7d
2021-03-31,GR,16,16,0,16,2022-05-03_11-02-08,fp7d
2021-03-31,JU,6,6,0,6,2022-05-03_11-02-08,fp7d
2021-03-31,LU,40,42,2,40,2022-05-03_11-02-08,fp7d
2021-03-31,NE,10,10,0,10,2022-05-03_11-02-08,fp7d
2021-03-31,NW,6,6,0,6,2022-05-03_11-02-08,fp7d
2021-03-31,OW,0,0,0,0,2022-05-03_11-02-08,fp7d
2021-03-31,SG,54,55,1,54,2022-05-03_11-02-08,fp7d
2021-03-31,SH,8,8,0,8,2022-05-03_11-02-08,fp7d
2021-03-31,SO,17,25,8,17,2022-05-03_11-02-08,fp7d
2021-03-31,SZ,12,11,0,11,2022-05-03_11-02-08,fp7d
2021-03-31,TG,21,36,15,21,2022-05-03_11-02-08,fp7d
2021-03-31,TI,53,76,23,53,2022-05-03_11-02-08,fp7d
2021-03-31,UR,6,6,0,6,2022-05-03_11-02-08,fp7d
2021-03-31,VD,85,100,15,85,2022-05-03_11-02-08,fp7d
2021-03-31,VS,14,14,0,14,2022-05-03_11-02-08,fp7d
2021-03-31,ZG,8,8,0,8,2022-05-03_11-02-08,fp7d
2021-03-31,ZH,190,213,30,183,2022-05-03_11-02-08,fp7d
2021-04-01,AG,52,50,0,50,2022-05-03_11-02-08,fp7d
2021-04-01,AI,0,0,0,0,2022-05-03_11-02-08,fp7d
2021-04-01,AR,6,6,0,6,2022-05-03_11-02-08,fp7d
2021-04-01,BE,104,101,6,95,2022-05-03_11-02-08,fp7d
2021-04-01,BL,20,16,0,16,2022-05-03_11-02-08,fp7d
2021-04-01,BS,54,50,0,50,2022-05-03_11-02-08,fp7d
2021-04-01,FR,24,24,0,24,2022-05-03_11-02-08,fp7d
2021-04-01,GE,38,50,12,38,2022-05-03_11-02-08,fp7d
2021-04-01,GL,6,6,0,6,2022-05-03_11-02-08,fp7d
2021-04-01,GR,16,16,0,16,2022-05-03_11-02-08,fp7d
2021-04-01,JU,6,6,0,6,2022-05-03_11-02-08,fp7d
2021-04-01,LU,40,42,2,40,2022-05-03_11-02-08,fp7d
2021-04-01,NE,10,10,0,10,2022-05-03_11-02-08,fp7d
2021-04-01,NW,6,6,0,6,2022-05-03_11-02-08,fp7d
2021-04-01,OW,0,0,0,0,2022-05-03_11-02-08,fp7d
2021-04-01,SG,54,55,1,54,2022-05-03_11-02-08,fp7d
2021-04-01,SH,8,8,0,8,2022-05-03_11-02-08,fp7d
2021-04-01,SO,17,25,8,17,2022-05-03_11-02-08,fp7d
2021-04-01,SZ,12,11,0,11,2022-05-03_11-02-08,fp7d
2021-04-01,TG,21,36,15,21,2022-05-03_11-02-08,fp7d
2021-04-01,TI,53,76,23,53,2022-05-03_11-02-08,fp7d
2021-04-01,UR,6,6,0,6,2022-05-03_11-02-08,fp7d
2021-04-01,VD,85,100,15,85,2022-05-03_11-02-08,fp7d
2021-04-01,VS,14,14,0,14,2022-05-03_11-02-08,fp7d
2021-04-01,ZG,8,8,0,8,2022-05-03_11-02-08,fp7d
2021-04-01,ZH,190,213,30,183,2022-05-03_11-02-08,fp7d
2021-04-02,AG,52,50,0,50,2022-05-03_11-02-08,fp7d
2021-04-02,AI,0,0,0,0,2022-05-03_11-02-08,fp7d
2021-04-02,AR,6,6,0,6,2022-05-03_11-02-08,fp7d
2021-04-02,BE,104,94,6,88,2022-05-03_11-02-08,fp7d
2021-04-02,BL,20,16,0,16,2022-05-03_11-02-08,fp7d
2021-04-02,BS,54,46,0,46,2022-05-03_11-02-08,fp7d
2021-04-02,FR,24,24,0,24,2022-05-03_11-02-08,fp7d
2021-04-02,GE,38,50,12,38,2022-05-03_11-02-08,fp7d
2021-04-02,GL,6,6,0,6,2022-05-03_11-02-08,fp7d
2021-04-02,GR,16,16,0,16,2022-05-03_11-02-08,fp7d
2021-04-02,JU,6,6,0,6,2022-05-03_11-02-08,fp7d
2021-04-02,LU,40,42,2,40,2022-05-03_11-02-08,fp7d
2021-04-02,NE,10,10,0,10,2022-05-03_11-02-08,fp7d
2021-04-02,NW,6,6,0,6,2022-05-03_11-02-08,fp7d
2021-04-02,OW,0,0,0,0,2022-05-03_11-02-08,fp7d
2021-04-02,SG,54,55,1,54,2022-05-03_11-02-08,fp7d
2021-04-02,SH,8,8,0,8,2022-05-03_11-02-08,fp7d
2021-04-02,SO,17,25,8,17,2022-05-03_11-02-08,fp7d
2021-04-02,SZ,12,11,0,11,2022-05-03_11-02-08,fp7d
2021-04-02,TG,21,36,15,21,2022-05-03_11-02-08,fp7d
2021-04-02,TI,53,76,23,53,2022-05-03_11-02-08,fp7d
2021-04-02,UR,6,6,0,6,2022-05-03_11-02-08,fp7d
2021-04-02,VD,85,100,15,85,2022-05-03_11-02-08,fp7d
2021-04-02,VS,20,20,0,20,2022-05-03_11-02-08,fp7d
2021-04-02,ZG,8,8,0,8,2022-05-03_11-02-08,fp7d
2021-04-02,ZH,190,212,29,183,2022-05-03_11-02-08,fp7d
2021-04-03,AG,52,50,0,50,2022-05-03_11-02-08,fp7d
2021-04-03,AI,0,0,0,0,2022-05-03_11-02-08,fp7d
2021-04-03,AR,6,6,0,6,2022-05-03_11-02-08,fp7d
2021-04-03,BE,104,95,6,89,2022-05-03_11-02-08,fp7d
2021-04-03,BL,20,16,0,16,2022-05-03_11-02-08,fp7d
2021-04-03,BS,54,46,0,46,2022-05-03_11-02-08,fp7d
2021-04-03,FR,24,24,0,24,2022-05-03_11-02-08,fp7d
2021-04-03,GE,38,50,12,38,2022-05-03_11-02-08,fp7d
2021-04-03,GL,6,6,0,6,2022-05-03_11-02-08,fp7d
2021-04-03,GR,16,16,0,16,2022-05-03_11-02-08,fp7d
2021-04-03,JU,6,6,0,6,2022-05-03_11-02-08,fp7d
2021-04-03,LU,40,42,2,40,2022-05-03_11-02-08,fp7d
2021-04-03,NE,10,10,0,10,2022-05-03_11-02-08,fp7d
2021-04-03,NW,6,6,0,6,2022-05-03_11-02-08,fp7d
2021-04-03,OW,0,0,0,0,2022-05-03_11-02-08,fp7d
2021-04-03,SG,54,55,1,54,2022-05-03_11-02-08,fp7d
2021-04-03,SH,8,8,0,8,2022-05-03_11-02-08,fp7d
2021-04-03,SO,17,25,8,17,2022-05-03_11-02-08,fp7d
2021-04-03,SZ,12,11,0,11,2022-05-03_11-02-08,fp7d
2021-04-03,TG,21,35,14,21,2022-05-03_11-02-08,fp7d
2021-04-03,TI,53,76,23,53,2022-05-03_11-02-08,fp7d
2021-04-03,UR,6,6,0,6,2022-05-03_11-02-08,fp7d
2021-04-03,VD,85,100,15,85,2022-05-03_11-02-08,fp7d
2021-04-03,VS,20,20,0,20,2022-05-03_11-02-08,fp7d
2021-04-03,ZG,8,8,0,8,2022-05-03_11-02-08,fp7d
2021-04-03,ZH,190,212,29,183,2022-05-03_11-02-08,fp7d
2021-04-04,AG,52,50,0,50,2022-05-03_11-02-08,fp7d
2021-04-04,AI,0,0,0,0,2022-05-03_11-02-08,fp7d
2021-04-04,AR,6,6,0,6,2022-05-03_11-02-08,fp7d
2021-04-04,BE,104,94,6,88,2022-05-03_11-02-08,fp7d
2021-04-04,BL,20,16,0,16,2022-05-03_11-02-08,fp7d
2021-04-04,BS,54,46,0,46,2022-05-03_11-02-08,fp7d
2021-04-04,FR,24,24,0,24,2022-05-03_11-02-08,fp7d
2021-04-04,GE,38,50,12,38,2022-05-03_11-02-08,fp7d
2021-04-04,GL,6,6,0,6,2022-05-03_11-02-08,fp7d
2021-04-04,GR,16,16,0,16,2022-05-03_11-02-08,fp7d
2021-04-04,JU,6,6,0,6,2022-05-03_11-02-08,fp7d
2021-04-04,LU,40,42,2,40,2022-05-03_11-02-08,fp7d
2021-04-04,NE,10,10,0,10,2022-05-03_11-02-08,fp7d
2021-04-04,NW,6,6,0,6,2022-05-03_11-02-08,fp7d
2021-04-04,OW,0,0,0,0,2022-05-03_11-02-08,fp7d
2021-04-04,SG,54,55,1,54,2022-05-03_11-02-08,fp7d
2021-04-04,SH,8,8,0,8,2022-05-03_11-02-08,fp7d
2021-04-04,SO,17,25,8,17,2022-05-03_11-02-08,fp7d
2021-04-04,SZ,12,11,0,11,2022-05-03_11-02-08,fp7d
2021-04-04,TG,21,35,14,21,2022-05-03_11-02-08,fp7d
2021-04-04,TI,53,76,23,53,2022-05-03_11-02-08,fp7d
2021-04-04,UR,6,6,0,6,2022-05-03_11-02-08,fp7d
2021-04-04,VD,85,100,15,85,2022-05-03_11-02-08,fp7d
2021-04-04,VS,20,20,0,20,2022-05-03_11-02-08,fp7d
2021-04-04,ZG,8,8,0,8,2022-05-03_11-02-08,fp7d
2021-04-04,ZH,190,212,29,183,2022-05-03_11-02-08,fp7d
2021-04-05,AG,52,50,0,50,2022-05-03_11-02-08,fp7d
2021-04-05,AI,0,0,0,0,2022-05-03_11-02-08,fp7d
2021-04-05,AR,6,6,0,6,2022-05-03_11-02-08,fp7d
2021-04-05,BE,92,82,6,76,2022-05-03_11-02-08,fp7d
2021-04-05,BL,20,16,0,16,2022-05-03_11-02-08,fp7d
2021-04-05,BS,54,46,0,46,2022-05-03_11-02-08,fp7d
2021-04-05,FR,24,24,0,24,2022-05-03_11-02-08,fp7d
2021-04-05,GE,38,50,12,38,2022-05-03_11-02-08,fp7d
2021-04-05,GL,6,6,0,6,2022-05-03_11-02-08,fp7d
2021-04-05,GR,16,16,0,16,2022-05-03_11-02-08,fp7d
2021-04-05,JU,6,6,0,6,2022-05-03_11-02-08,fp7d
2021-04-05,LU,40,42,2,40,2022-05-03_11-02-08,fp7d
2021-04-05,NE,10,10,0,10,2022-05-03_11-02-08,fp7d
2021-04-05,NW,6,6,0,6,2022-05-03_11-02-08,fp7d
2021-04-05,OW,0,0,0,0,2022-05-03_11-02-08,fp7d
2021-04-05,SG,54,55,1,54,2022-05-03_11-02-08,fp7d
2021-04-05,SH,8,8,0,8,2022-05-03_11-02-08,fp7d
2021-04-05,SO,17,25,8,17,2022-05-03_11-02-08,fp7d
2021-04-05,SZ,12,11,0,11,2022-05-03_11-02-08,fp7d
2021-04-05,TG,21,35,14,21,2022-05-03_11-02-08,fp7d
2021-04-05,TI,53,76,23,53,2022-05-03_11-02-08,fp7d
2021-04-05,UR,6,6,0,6,2022-05-03_11-02-08,fp7d
2021-04-05,VD,85,100,15,85,2022-05-03_11-02-08,fp7d
2021-04-05,VS,20,20,0,20,2022-05-03_11-02-08,fp7d
2021-04-05,ZG,8,8,0,8,2022-05-03_11-02-08,fp7d
2021-04-05,ZH,190,213,30,183,2022-05-03_11-02-08,fp7d
2021-04-06,AG,52,50,0,50,2022-05-03_11-02-08,fp7d
2021-04-06,AI,0,0,0,0,2022-05-03_11-02-08,fp7d
2021-04-06,AR,6,6,0,6,2022-05-03_11-02-08,fp7d
2021-04-06,BE,92,85,6,79,2022-05-03_11-02-08,fp7d
2021-04-06,BL,20,16,0,16,2022-05-03_11-02-08,fp7d
2021-04-06,BS,54,50,0,50,2022-05-03_11-02-08,fp7d
2021-04-06,FR,24,24,0,24,2022-05-03_11-02-08,fp7d
2021-04-06,GE,38,50,12,38,2022-05-03_11-02-08,fp7d
2021-04-06,GL,6,6,0,6,2022-05-03_11-02-08,fp7d
2021-04-06,GR,16,16,0,16,2022-05-03_11-02-08,fp7d
2021-04-06,JU,6,6,0,6,2022-05-03_11-02-08,fp7d
2021-04-06,LU,40,42,2,40,2022-05-03_11-02-08,fp7d
2021-04-06,NE,10,10,0,10,2022-05-03_11-02-08,fp7d
2021-04-06,NW,6,6,0,6,2022-05-03_11-02-08,fp7d
2021-04-06,OW,0,0,0,0,2022-05-03_11-02-08,fp7d
2021-04-06,SG,54,55,1,54,2022-05-03_11-02-08,fp7d
2021-04-06,SH,8,8,0,8,2022-05-03_11-02-08,fp7d
2021-04-06,SO,17,25,8,17,2022-05-03_11-02-08,fp7d
2021-04-06,SZ,12,11,0,11,2022-05-03_11-02-08,fp7d
2021-04-06,TG,21,35,14,21,2022-05-03_11-02-08,fp7d
2021-04-06,TI,53,76,23,53,2022-05-03_11-02-08,fp7d
2021-04-06,UR,6,6,0,6,2022-05-03_11-02-08,fp7d
2021-04-06,VD,85,106,21,85,2022-05-03_11-02-08,fp7d
2021-04-06,VS,20,20,0,20,2022-05-03_11-02-08,fp7d
2021-04-06,ZG,8,8,0,8,2022-05-03_11-02-08,fp7d
2021-04-06,ZH,190,214,31,183,2022-05-03_11-02-08,fp7d
2021-04-07,AG,52,50,0,50,2022-05-03_11-02-08,fp7d
2021-04-07,AI,0,0,0,0,2022-05-03_11-02-08,fp7d
2021-04-07,AR,6,6,0,6,2022-05-03_11-02-08,fp7d
2021-04-07,BE,92,86,6,80,2022-05-03_11-02-08,fp7d
2021-04-07,BL,20,16,0,16,2022-05-03_11-02-08,fp7d
2021-04-07,BS,54,50,0,50,2022-05-03_11-02-08,fp7d
2021-04-07,FR,24,24,0,24,2022-05-03_11-02-08,fp7d
2021-04-07,GE,38,50,12,38,2022-05-03_11-02-08,fp7d
2021-04-07,GL,6,6,0,6,2022-05-03_11-02-08,fp7d
2021-04-07,GR,16,16,0,16,2022-05-03_11-02-08,fp7d
2021-04-07,JU,6,6,0,6,2022-05-03_11-02-08,fp7d
2021-04-07,LU,40,42,2,40,2022-05-03_11-02-08,fp7d
2021-04-07,NE,10,10,0,10,2022-05-03_11-02-08,fp7d
2021-04-07,NW,6,6,0,6,2022-05-03_11-02-08,fp7d
2021-04-07,OW,0,0,0,0,2022-05-03_11-02-08,fp7d
2021-04-07,SG,54,55,1,54,2022-05-03_11-02-08,fp7d
2021-04-07,SH,8,8,0,8,2022-05-03_11-02-08,fp7d
2021-04-07,SO,17,17,0,17,2022-05-03_11-02-08,fp7d
2021-04-07,SZ,12,11,0,11,2022-05-03_11-02-08,fp7d
2021-04-07,TG,21,35,14,21,2022-05-03_11-02-08,fp7d
2021-04-07,TI,53,76,23,53,2022-05-03_11-02-08,fp7d
2021-04-07,UR,6,6,0,6,2022-05-03_11-02-08,fp7d
2021-04-07,VD,85,106,21,85,2022-05-03_11-02-08,fp7d
2021-04-07,VS,20,20,0,20,2022-05-03_11-02-08,fp7d
2021-04-07,ZG,8,8,0,8,2022-05-03_11-02-08,fp7d
2021-04-07,ZH,190,213,30,183,2022-05-03_11-02-08,fp7d
2021-04-08,AG,52,50,0,50,2022-05-03_11-02-08,fp7d
2021-04-08,AI,0,0,0,0,2022-05-03_11-02-08,fp7d
2021-04-08,AR,6,6,0,6,2022-05-03_11-02-08,fp7d
2021-04-08,BE,92,81,6,75,2022-05-03_11-02-08,fp7d
2021-04-08,BL,20,16,0,16,2022-05-03_11-02-08,fp7d
2021-04-08,BS,54,50,0,50,2022-05-03_11-02-08,fp7d
2021-04-08,FR,24,24,0,24,2022-05-03_11-02-08,fp7d
2021-04-08,GE,38,50,12,38,2022-05-03_11-02-08,fp7d
2021-04-08,GL,6,6,0,6,2022-05-03_11-02-08,fp7d
2021-04-08,GR,16,16,0,16,2022-05-03_11-02-08,fp7d
2021-04-08,JU,6,6,0,6,2022-05-03_11-02-08,fp7d
2021-04-08,LU,40,42,2,40,2022-05-03_11-02-08,fp7d
2021-04-08,NE,10,10,0,10,2022-05-03_11-02-08,fp7d
2021-04-08,NW,6,6,0,6,2022-05-03_11-02-08,fp7d
2021-04-08,OW,0,0,0,0,2022-05-03_11-02-08,fp7d
2021-04-08,SG,54,55,1,54,2022-05-03_11-02-08,fp7d
2021-04-08,SH,8,8,0,8,2022-05-03_11-02-08,fp7d
2021-04-08,SO,17,17,0,17,2022-05-03_11-02-08,fp7d
2021-04-08,SZ,12,11,0,11,2022-05-03_11-02-08,fp7d
2021-04-08,TG,21,35,14,21,2022-05-03_11-02-08,fp7d
2021-04-08,TI,53,76,23,53,2022-05-03_11-02-08,fp7d
2021-04-08,UR,6,6,0,6,2022-05-03_11-02-08,fp7d
2021-04-08,VD,85,100,15,85,2022-05-03_11-02-08,fp7d
2021-04-08,VS,20,20,0,20,2022-05-03_11-02-08,fp7d
2021-04-08,ZG,8,8,0,8,2022-05-03_11-02-08,fp7d
2021-04-08,ZH,190,209,28,181,2022-05-03_11-02-08,fp7d
2021-04-09,AG,52,50,0,50,2022-05-03_11-02-08,fp7d
2021-04-09,AI,0,0,0,0,2022-05-03_11-02-08,fp7d
2021-04-09,AR,6,6,0,6,2022-05-03_11-02-08,fp7d
2021-04-09,BE,92,83,6,77,2022-05-03_11-02-08,fp7d
2021-04-09,BL,20,16,0,16,2022-05-03_11-02-08,fp7d
2021-04-09,BS,54,50,0,50,2022-05-03_11-02-08,fp7d
2021-04-09,FR,24,24,0,24,2022-05-03_11-02-08,fp7d
2021-04-09,GE,38,50,12,38,2022-05-03_11-02-08,fp7d
2021-04-09,GL,6,6,0,6,2022-05-03_11-02-08,fp7d
2021-04-09,GR,16,16,0,16,2022-05-03_11-02-08,fp7d
2021-04-09,JU,6,6,0,6,2022-05-03_11-02-08,fp7d
2021-04-09,LU,40,42,2,40,2022-05-03_11-02-08,fp7d
2021-04-09,NE,10,10,0,10,2022-05-03_11-02-08,fp7d
2021-04-09,NW,6,6,0,6,2022-05-03_11-02-08,fp7d
2021-04-09,OW,0,0,0,0,2022-05-03_11-02-08,fp7d
2021-04-09,SG,54,55,1,54,2022-05-03_11-02-08,fp7d
2021-04-09,SH,8,7,0,7,2022-05-03_11-02-08,fp7d
2021-04-09,SO,17,17,0,17,2022-05-03_11-02-08,fp7d
2021-04-09,SZ,12,11,0,11,2022-05-03_11-02-08,fp7d
2021-04-09,TG,21,35,14,21,2022-05-03_11-02-08,fp7d
2021-04-09,TI,53,76,23,53,2022-05-03_11-02-08,fp7d
2021-04-09,UR,6,6,0,6,2022-05-03_11-02-08,fp7d
2021-04-09,VD,85,100,15,85,2022-05-03_11-02-08,fp7d
2021-04-09,VS,20,20,0,20,2022-05-03_11-02-08,fp7d
2021-04-09,ZG,8,8,0,8,2022-05-03_11-02-08,fp7d
2021-04-09,ZH,190,208,28,180,2022-05-03_11-02-08,fp7d
2021-04-10,AG,52,50,0,50,2022-05-03_11-02-08,fp7d
2021-04-10,AI,0,0,0,0,2022-05-03_11-02-08,fp7d
2021-04-10,AR,6,6,0,6,2022-05-03_11-02-08,fp7d
2021-04-10,BE,92,83,6,77,2022-05-03_11-02-08,fp7d
2021-04-10,BL,20,16,0,16,2022-05-03_11-02-08,fp7d
2021-04-10,BS,54,46,0,46,2022-05-03_11-02-08,fp7d
2021-04-10,FR,24,24,0,24,2022-05-03_11-02-08,fp7d
2021-04-10,GE,38,50,12,38,2022-05-03_11-02-08,fp7d
2021-04-10,GL,6,6,0,6,2022-05-03_11-02-08,fp7d
2021-04-10,GR,16,16,0,16,2022-05-03_11-02-08,fp7d
2021-04-10,JU,6,6,0,6,2022-05-03_11-02-08,fp7d
2021-04-10,LU,40,40,0,40,2022-05-03_11-02-08,fp7d
2021-04-10,NE,10,10,0,10,2022-05-03_11-02-08,fp7d
2021-04-10,NW,6,6,0,6,2022-05-03_11-02-08,fp7d
2021-04-10,OW,0,0,0,0,2022-05-03_11-02-08,fp7d
2021-04-10,SG,54,55,1,54,2022-05-03_11-02-08,fp7d
2021-04-10,SH,8,7,0,7,2022-05-03_11-02-08,fp7d
2021-04-10,SO,17,17,0,17,2022-05-03_11-02-08,fp7d
2021-04-10,SZ,12,11,0,11,2022-05-03_11-02-08,fp7d
2021-04-10,TG,21,35,14,21,2022-05-03_11-02-08,fp7d
2021-04-10,TI,53,76,23,53,2022-05-03_11-02-08,fp7d
2021-04-10,UR,6,6,0,6,2022-05-03_11-02-08,fp7d
2021-04-10,VD,85,100,15,85,2022-05-03_11-02-08,fp7d
2021-04-10,VS,20,20,0,20,2022-05-03_11-02-08,fp7d
2021-04-10,ZG,8,8,0,8,2022-05-03_11-02-08,fp7d
2021-04-10,ZH,190,207,27,180,2022-05-03_11-02-08,fp7d
2021-04-11,AG,52,50,0,50,2022-05-03_11-02-08,fp7d
2021-04-11,AI,0,0,0,0,2022-05-03_11-02-08,fp7d
2021-04-11,AR,6,6,0,6,2022-05-03_11-02-08,fp7d
2021-04-11,BE,92,83,6,77,2022-05-03_11-02-08,fp7d
2021-04-11,BL,20,16,0,16,2022-05-03_11-02-08,fp7d
2021-04-11,BS,54,46,0,46,2022-05-03_11-02-08,fp7d
2021-04-11,FR,24,24,0,24,2022-05-03_11-02-08,fp7d
2021-04-11,GE,38,50,12,38,2022-05-03_11-02-08,fp7d
2021-04-11,GL,6,6,0,6,2022-05-03_11-02-08,fp7d
2021-04-11,GR,16,16,0,16,2022-05-03_11-02-08,fp7d
2021-04-11,JU,6,6,0,6,2022-05-03_11-02-08,fp7d
2021-04-11,LU,40,40,0,40,2022-05-03_11-02-08,fp7d
2021-04-11,NE,10,10,0,10,2022-05-03_11-02-08,fp7d
2021-04-11,NW,6,6,0,6,2022-05-03_11-02-08,fp7d
2021-04-11,OW,0,0,0,0,2022-05-03_11-02-08,fp7d
2021-04-11,SG,54,55,1,54,2022-05-03_11-02-08,fp7d
2021-04-11,SH,8,7,0,7,2022-05-03_11-02-08,fp7d
2021-04-11,SO,17,17,0,17,2022-05-03_11-02-08,fp7d
2021-04-11,SZ,12,11,0,11,2022-05-03_11-02-08,fp7d
2021-04-11,TG,21,35,14,21,2022-05-03_11-02-08,fp7d
2021-04-11,TI,53,76,23,53,2022-05-03_11-02-08,fp7d
2021-04-11,UR,6,6,0,6,2022-05-03_11-02-08,fp7d
2021-04-11,VD,85,101,16,85,2022-05-03_11-02-08,fp7d
2021-04-11,VS,20,20,0,20,2022-05-03_11-02-08,fp7d
2021-04-11,ZG,8,8,0,8,2022-05-03_11-02-08,fp7d
2021-04-11,ZH,190,209,28,181,2022-05-03_11-02-08,fp7d
2021-04-12,AG,52,48,0,48,2022-05-03_11-02-08,fp7d
2021-04-12,AI,0,0,0,0,2022-05-03_11-02-08,fp7d
2021-04-12,AR,6,6,0,6,2022-05-03_11-02-08,fp7d
2021-04-12,BE,92,86,6,80,2022-05-03_11-02-08,fp7d
2021-04-12,BL,20,16,0,16,2022-05-03_11-02-08,fp7d
2021-04-12,BS,54,50,0,50,2022-05-03_11-02-08,fp7d
2021-04-12,FR,24,24,0,24,2022-05-03_11-02-08,fp7d
2021-04-12,GE,38,50,12,38,2022-05-03_11-02-08,fp7d
2021-04-12,GL,6,6,0,6,2022-05-03_11-02-08,fp7d
2021-04-12,GR,16,16,0,16,2022-05-03_11-02-08,fp7d
2021-04-12,JU,6,6,0,6,2022-05-03_11-02-08,fp7d
2021-04-12,LU,40,40,0,40,2022-05-03_11-02-08,fp7d
2021-04-12,NE,10,10,0,10,2022-05-03_11-02-08,fp7d
2021-04-12,NW,6,6,0,6,2022-05-03_11-02-08,fp7d
2021-04-12,OW,0,0,0,0,2022-05-03_11-02-08,fp7d
2021-04-12,SG,54,55,1,54,2022-05-03_11-02-08,fp7d
2021-04-12,SH,8,7,0,7,2022-05-03_11-02-08,fp7d
2021-04-12,SO,17,17,0,17,2022-05-03_11-02-08,fp7d
2021-04-12,SZ,12,12,0,12,2022-05-03_11-02-08,fp7d
2021-04-12,TG,21,35,14,21,2022-05-03_11-02-08,fp7d
2021-04-12,TI,53,74,21,53,2022-05-03_11-02-08,fp7d
2021-04-12,UR,6,6,0,6,2022-05-03_11-02-08,fp7d
2021-04-12,VD,85,101,16,85,2022-05-03_11-02-08,fp7d
2021-04-12,VS,20,20,0,20,2022-05-03_11-02-08,fp7d
2021-04-12,ZG,8,8,0,8,2022-05-03_11-02-08,fp7d
2021-04-12,ZH,190,197,16,181,2022-05-03_11-02-08,fp7d
2021-04-13,AG,52,48,0,48,2022-05-03_11-02-08,fp7d
2021-04-13,AI,0,0,0,0,2022-05-03_11-02-08,fp7d
2021-04-13,AR,6,6,0,6,2022-05-03_11-02-08,fp7d
2021-04-13,BE,92,88,6,82,2022-05-03_11-02-08,fp7d
2021-04-13,BL,20,16,0,16,2022-05-03_11-02-08,fp7d
2021-04-13,BS,54,50,0,50,2022-05-03_11-02-08,fp7d
2021-04-13,FR,24,24,0,24,2022-05-03_11-02-08,fp7d
2021-04-13,GE,38,50,12,38,2022-05-03_11-02-08,fp7d
2021-04-13,GL,6,6,0,6,2022-05-03_11-02-08,fp7d
2021-04-13,GR,16,16,0,16,2022-05-03_11-02-08,fp7d
2021-04-13,JU,6,6,0,6,2022-05-03_11-02-08,fp7d
2021-04-13,LU,40,40,0,40,2022-05-03_11-02-08,fp7d
2021-04-13,NE,10,10,0,10,2022-05-03_11-02-08,fp7d
2021-04-13,NW,6,6,0,6,2022-05-03_11-02-08,fp7d
2021-04-13,OW,0,0,0,0,2022-05-03_11-02-08,fp7d
2021-04-13,SG,54,55,1,54,2022-05-03_11-02-08,fp7d
2021-04-13,SH,8,7,0,7,2022-05-03_11-02-08,fp7d
2021-04-13,SO,17,17,0,17,2022-05-03_11-02-08,fp7d
2021-04-13,SZ,12,12,0,12,2022-05-03_11-02-08,fp7d
2021-04-13,TG,21,35,14,21,2022-05-03_11-02-08,fp7d
2021-04-13,TI,53,76,23,53,2022-05-03_11-02-08,fp7d
2021-04-13,UR,6,6,0,6,2022-05-03_11-02-08,fp7d
2021-04-13,VD,85,102,17,85,2022-05-03_11-02-08,fp7d
2021-04-13,VS,20,20,0,20,2022-05-03_11-02-08,fp7d
2021-04-13,ZG,8,8,0,8,2022-05-03_11-02-08,fp7d
2021-04-13,ZH,190,198,17,181,2022-05-03_11-02-08,fp7d
2021-04-14,AG,52,48,0,48,2022-05-03_11-02-08,fp7d
2021-04-14,AI,0,0,0,0,2022-05-03_11-02-08,fp7d
2021-04-14,AR,6,6,0,6,2022-05-03_11-02-08,fp7d
2021-04-14,BE,104,98,6,92,2022-05-03_11-02-08,fp7d
2021-04-14,BL,20,16,0,16,2022-05-03_11-02-08,fp7d
2021-04-14,BS,54,50,0,50,2022-05-03_11-02-08,fp7d
2021-04-14,FR,24,24,0,24,2022-05-03_11-02-08,fp7d
2021-04-14,GE,38,50,12,38,2022-05-03_11-02-08,fp7d
2021-04-14,GL,6,6,0,6,2022-05-03_11-02-08,fp7d
2021-04-14,GR,16,16,0,16,2022-05-03_11-02-08,fp7d
2021-04-14,JU,6,6,0,6,2022-05-03_11-02-08,fp7d
2021-04-14,LU,40,40,0,40,2022-05-03_11-02-08,fp7d
2021-04-14,NE,10,10,0,10,2022-05-03_11-02-08,fp7d
2021-04-14,NW,6,6,0,6,2022-05-03_11-02-08,fp7d
2021-04-14,OW,0,0,0,0,2022-05-03_11-02-08,fp7d
2021-04-14,SG,54,55,1,54,2022-05-03_11-02-08,fp7d
2021-04-14,SH,8,7,0,7,2022-05-03_11-02-08,fp7d
2021-04-14,SO,17,17,0,17,2022-05-03_11-02-08,fp7d
2021-04-14,SZ,12,12,0,12,2022-05-03_11-02-08,fp7d
2021-04-14,TG,21,33,12,21,2022-05-03_11-02-08,fp7d
2021-04-14,TI,53,76,23,53,2022-05-03_11-02-08,fp7d
2021-04-14,UR,6,6,0,6,2022-05-03_11-02-08,fp7d
2021-04-14,VD,85,102,17,85,2022-05-03_11-02-08,fp7d
2021-04-14,VS,20,20,0,20,2022-05-03_11-02-08,fp7d
2021-04-14,ZG,8,8,0,8,2022-05-03_11-02-08,fp7d
2021-04-14,ZH,190,199,17,182,2022-05-03_11-02-08,fp7d
2021-04-15,AG,52,48,0,48,2022-05-03_11-02-08,fp7d
2021-04-15,AI,0,0,0,0,2022-05-03_11-02-08,fp7d
2021-04-15,AR,6,6,0,6,2022-05-03_11-02-08,fp7d
2021-04-15,BE,104,96,6,90,2022-05-03_11-02-08,fp7d
2021-04-15,BL,20,16,0,16,2022-05-03_11-02-08,fp7d
2021-04-15,BS,54,50,0,50,2022-05-03_11-02-08,fp7d
2021-04-15,FR,24,24,0,24,2022-05-03_11-02-08,fp7d
2021-04-15,GE,38,50,12,38,2022-05-03_11-02-08,fp7d
2021-04-15,GL,6,6,0,6,2022-05-03_11-02-08,fp7d
2021-04-15,GR,16,16,0,16,2022-05-03_11-02-08,fp7d
2021-04-15,JU,6,6,0,6,2022-05-03_11-02-08,fp7d
2021-04-15,LU,40,42,2,40,2022-05-03_11-02-08,fp7d
2021-04-15,NE,10,10,0,10,2022-05-03_11-02-08,fp7d
2021-04-15,NW,6,6,0,6,2022-05-03_11-02-08,fp7d
2021-04-15,OW,0,0,0,0,2022-05-03_11-02-08,fp7d
2021-04-15,SG,54,55,1,54,2022-05-03_11-02-08,fp7d
2021-04-15,SH,8,7,0,7,2022-05-03_11-02-08,fp7d
2021-04-15,SO,17,17,0,17,2022-05-03_11-02-08,fp7d
2021-04-15,SZ,12,12,0,12,2022-05-03_11-02-08,fp7d
2021-04-15,TG,21,33,12,21,2022-05-03_11-02-08,fp7d
2021-04-15,TI,53,76,23,53,2022-05-03_11-02-08,fp7d
2021-04-15,UR,6,6,0,6,2022-05-03_11-02-08,fp7d
2021-04-15,VD,85,102,17,85,2022-05-03_11-02-08,fp7d
2021-04-15,VS,20,20,0,20,2022-05-03_11-02-08,fp7d
2021-04-15,ZG,8,8,0,8,2022-05-03_11-02-08,fp7d
2021-04-15,ZH,190,200,19,181,2022-05-03_11-02-08,fp7d
2021-04-16,AG,52,48,0,48,2022-05-03_11-02-08,fp7d
2021-04-16,AI,0,0,0,0,2022-05-03_11-02-08,fp7d
2021-04-16,AR,6,6,0,6,2022-05-03_11-02-08,fp7d
2021-04-16,BE,104,96,6,90,2022-05-03_11-02-08,fp7d
2021-04-16,BL,20,16,0,16,2022-05-03_11-02-08,fp7d
2021-04-16,BS,54,50,0,50,2022-05-03_11-02-08,fp7d
2021-04-16,FR,24,24,0,24,2022-05-03_11-02-08,fp7d
2021-04-16,GE,38,50,12,38,2022-05-03_11-02-08,fp7d
2021-04-16,GL,6,6,0,6,2022-05-03_11-02-08,fp7d
2021-04-16,GR,16,16,0,16,2022-05-03_11-02-08,fp7d
2021-04-16,JU,6,6,0,6,2022-05-03_11-02-08,fp7d
2021-04-16,LU,40,42,2,40,2022-05-03_11-02-08,fp7d
2021-04-16,NE,10,10,0,10,2022-05-03_11-02-08,fp7d
2021-04-16,NW,6,6,0,6,2022-05-03_11-02-08,fp7d
2021-04-16,OW,0,0,0,0,2022-05-03_11-02-08,fp7d
2021-04-16,SG,54,55,1,54,2022-05-03_11-02-08,fp7d
2021-04-16,SH,8,7,0,7,2022-05-03_11-02-08,fp7d
2021-04-16,SO,17,17,0,17,2022-05-03_11-02-08,fp7d
2021-04-16,SZ,12,12,0,12,2022-05-03_11-02-08,fp7d
2021-04-16,TG,21,33,12,21,2022-05-03_11-02-08,fp7d
2021-04-16,TI,53,76,23,53,2022-05-03_11-02-08,fp7d
2021-04-16,UR,6,6,0,6,2022-05-03_11-02-08,fp7d
2021-04-16,VD,85,102,17,85,2022-05-03_11-02-08,fp7d
2021-04-16,VS,20,22,2,20,2022-05-03_11-02-08,fp7d
2021-04-16,ZG,8,8,0,8,2022-05-03_11-02-08,fp7d
2021-04-16,ZH,190,198,18,180,2022-05-03_11-02-08,fp7d
2021-04-17,AG,52,48,0,48,2022-05-03_11-02-08,fp7d
2021-04-17,AI,0,0,0,0,2022-05-03_11-02-08,fp7d
2021-04-17,AR,6,6,0,6,2022-05-03_11-02-08,fp7d
2021-04-17,BE,104,96,6,90,2022-05-03_11-02-08,fp7d
2021-04-17,BL,20,16,0,16,2022-05-03_11-02-08,fp7d
2021-04-17,BS,54,46,0,46,2022-05-03_11-02-08,fp7d
2021-04-17,FR,24,24,0,24,2022-05-03_11-02-08,fp7d
2021-04-17,GE,38,50,12,38,2022-05-03_11-02-08,fp7d
2021-04-17,GL,6,6,0,6,2022-05-03_11-02-08,fp7d
2021-04-17,GR,16,16,0,16,2022-05-03_11-02-08,fp7d
2021-04-17,JU,6,6,0,6,2022-05-03_11-02-08,fp7d
2021-04-17,LU,40,40,0,40,2022-05-03_11-02-08,fp7d
2021-04-17,NE,10,10,0,10,2022-05-03_11-02-08,fp7d
2021-04-17,NW,6,6,0,6,2022-05-03_11-02-08,fp7d
2021-04-17,OW,0,0,0,0,2022-05-03_11-02-08,fp7d
2021-04-17,SG,54,55,1,54,2022-05-03_11-02-08,fp7d
2021-04-17,SH,8,7,0,7,2022-05-03_11-02-08,fp7d
2021-04-17,SO,17,17,0,17,2022-05-03_11-02-08,fp7d
2021-04-17,SZ,12,12,0,12,2022-05-03_11-02-08,fp7d
2021-04-17,TG,21,33,12,21,2022-05-03_11-02-08,fp7d
2021-04-17,TI,53,76,23,53,2022-05-03_11-02-08,fp7d
2021-04-17,UR,6,6,0,6,2022-05-03_11-02-08,fp7d
2021-04-17,VD,85,102,17,85,2022-05-03_11-02-08,fp7d
2021-04-17,VS,20,22,2,20,2022-05-03_11-02-08,fp7d
2021-04-17,ZG,8,8,0,8,2022-05-03_11-02-08,fp7d
2021-04-17,ZH,190,199,17,182,2022-05-03_11-02-08,fp7d
2021-04-18,AG,52,48,0,48,2022-05-03_11-02-08,fp7d
2021-04-18,AI,0,0,0,0,2022-05-03_11-02-08,fp7d
2021-04-18,AR,6,6,0,6,2022-05-03_11-02-08,fp7d
2021-04-18,BE,104,96,6,90,2022-05-03_11-02-08,fp7d
2021-04-18,BL,20,16,0,16,2022-05-03_11-02-08,fp7d
2021-04-18,BS,54,46,0,46,2022-05-03_11-02-08,fp7d
2021-04-18,FR,24,24,0,24,2022-05-03_11-02-08,fp7d
2021-04-18,GE,38,50,12,38,2022-05-03_11-02-08,fp7d
2021-04-18,GL,6,6,0,6,2022-05-03_11-02-08,fp7d
2021-04-18,GR,16,16,0,16,2022-05-03_11-02-08,fp7d
2021-04-18,JU,6,6,0,6,2022-05-03_11-02-08,fp7d
2021-04-18,LU,40,40,0,40,2022-05-03_11-02-08,fp7d
2021-04-18,NE,10,10,0,10,2022-05-03_11-02-08,fp7d
2021-04-18,NW,6,6,0,6,2022-05-03_11-02-08,fp7d
2021-04-18,OW,0,0,0,0,2022-05-03_11-02-08,fp7d
2021-04-18,SG,54,55,1,54,2022-05-03_11-02-08,fp7d
2021-04-18,SH,8,7,0,7,2022-05-03_11-02-08,fp7d
2021-04-18,SO,17,17,0,17,2022-05-03_11-02-08,fp7d
2021-04-18,SZ,12,12,0,12,2022-05-03_11-02-08,fp7d
2021-04-18,TG,21,31,10,21,2022-05-03_11-02-08,fp7d
2021-04-18,TI,53,76,23,53,2022-05-03_11-02-08,fp7d
2021-04-18,UR,6,6,0,6,2022-05-03_11-02-08,fp7d
2021-04-18,VD,85,102,17,85,2022-05-03_11-02-08,fp7d
2021-04-18,VS,20,22,2,20,2022-05-03_11-02-08,fp7d
2021-04-18,ZG,8,8,0,8,2022-05-03_11-02-08,fp7d
2021-04-18,ZH,190,200,18,182,2022-05-03_11-02-08,fp7d
2021-04-19,AG,52,48,0,48,2022-05-03_11-02-08,fp7d
2021-04-19,AI,0,0,0,0,2022-05-03_11-02-08,fp7d
2021-04-19,AR,6,6,0,6,2022-05-03_11-02-08,fp7d
2021-04-19,BE,104,96,6,90,2022-05-03_11-02-08,fp7d
2021-04-19,BL,20,16,0,16,2022-05-03_11-02-08,fp7d
2021-04-19,BS,54,50,0,50,2022-05-03_11-02-08,fp7d
2021-04-19,FR,24,24,0,24,2022-05-03_11-02-08,fp7d
2021-04-19,GE,38,50,12,38,2022-05-03_11-02-08,fp7d
2021-04-19,GL,6,6,0,6,2022-05-03_11-02-08,fp7d
2021-04-19,GR,16,16,0,16,2022-05-03_11-02-08,fp7d
2021-04-19,JU,6,6,0,6,2022-05-03_11-02-08,fp7d
2021-04-19,LU,40,42,2,40,2022-05-03_11-02-08,fp7d
2021-04-19,NE,10,10,0,10,2022-05-03_11-02-08,fp7d
2021-04-19,NW,6,6,0,6,2022-05-03_11-02-08,fp7d
2021-04-19,OW,0,0,0,0,2022-05-03_11-02-08,fp7d
2021-04-19,SG,54,55,1,54,2022-05-03_11-02-08,fp7d
2021-04-19,SH,8,6,0,6,2022-05-03_11-02-08,fp7d
2021-04-19,SO,17,17,0,17,2022-05-03_11-02-08,fp7d
2021-04-19,SZ,12,12,0,12,2022-05-03_11-02-08,fp7d
2021-04-19,TG,21,31,10,21,2022-05-03_11-02-08,fp7d
2021-04-19,TI,53,76,23,53,2022-05-03_11-02-08,fp7d
2021-04-19,UR,6,6,0,6,2022-05-03_11-02-08,fp7d
2021-04-19,VD,85,102,17,85,2022-05-03_11-02-08,fp7d
2021-04-19,VS,20,22,2,20,2022-05-03_11-02-08,fp7d
2021-04-19,ZG,8,8,0,8,2022-05-03_11-02-08,fp7d
2021-04-19,ZH,190,201,19,182,2022-05-03_11-02-08,fp7d
2021-04-20,AG,52,48,0,48,2022-05-03_11-02-08,fp7d
2021-04-20,AI,0,0,0,0,2022-05-03_11-02-08,fp7d
2021-04-20,AR,6,6,0,6,2022-05-03_11-02-08,fp7d
2021-04-20,BE,104,99,7,92,2022-05-03_11-02-08,fp7d
2021-04-20,BL,20,16,0,16,2022-05-03_11-02-08,fp7d
2021-04-20,BS,54,50,0,50,2022-05-03_11-02-08,fp7d
2021-04-20,FR,24,24,0,24,2022-05-03_11-02-08,fp7d
2021-04-20,GE,38,56,18,38,2022-05-03_11-02-08,fp7d
2021-04-20,GL,6,6,0,6,2022-05-03_11-02-08,fp7d
2021-04-20,GR,16,16,0,16,2022-05-03_11-02-08,fp7d
2021-04-20,JU,6,6,0,6,2022-05-03_11-02-08,fp7d
2021-04-20,LU,40,42,2,40,2022-05-03_11-02-08,fp7d
2021-04-20,NE,10,10,0,10,2022-05-03_11-02-08,fp7d
2021-04-20,NW,6,6,0,6,2022-05-03_11-02-08,fp7d
2021-04-20,OW,0,0,0,0,2022-05-03_11-02-08,fp7d
2021-04-20,SG,54,55,1,54,2022-05-03_11-02-08,fp7d
2021-04-20,SH,8,6,0,6,2022-05-03_11-02-08,fp7d
2021-04-20,SO,17,17,0,17,2022-05-03_11-02-08,fp7d
2021-04-20,SZ,12,12,0,12,2022-05-03_11-02-08,fp7d
2021-04-20,TG,21,31,10,21,2022-05-03_11-02-08,fp7d
2021-04-20,TI,53,76,23,53,2022-05-03_11-02-08,fp7d
2021-04-20,UR,6,6,0,6,2022-05-03_11-02-08,fp7d
2021-04-20,VD,85,101,16,85,2022-05-03_11-02-08,fp7d
2021-04-20,VS,20,22,2,20,2022-05-03_11-02-08,fp7d
2021-04-20,ZG,8,8,0,8,2022-05-03_11-02-08,fp7d
2021-04-20,ZH,190,201,17,184,2022-05-03_11-02-08,fp7d
2021-04-21,AG,52,48,0,48,2022-05-03_11-02-08,fp7d
2021-04-21,AI,0,0,0,0,2022-05-03_11-02-08,fp7d
2021-04-21,AR,6,6,0,6,2022-05-03_11-02-08,fp7d
2021-04-21,BE,92,88,6,82,2022-05-03_11-02-08,fp7d
2021-04-21,BL,20,16,0,16,2022-05-03_11-02-08,fp7d
2021-04-21,BS,54,50,0,50,2022-05-03_11-02-08,fp7d
2021-04-21,FR,24,24,0,24,2022-05-03_11-02-08,fp7d
2021-04-21,GE,38,56,18,38,2022-05-03_11-02-08,fp7d
2021-04-21,GL,6,6,0,6,2022-05-03_11-02-08,fp7d
2021-04-21,GR,16,16,0,16,2022-05-03_11-02-08,fp7d
2021-04-21,JU,6,6,0,6,2022-05-03_11-02-08,fp7d
2021-04-21,LU,40,42,2,40,2022-05-03_11-02-08,fp7d
2021-04-21,NE,10,10,0,10,2022-05-03_11-02-08,fp7d
2021-04-21,NW,6,6,0,6,2022-05-03_11-02-08,fp7d
2021-04-21,OW,0,0,0,0,2022-05-03_11-02-08,fp7d
2021-04-21,SG,54,55,1,54,2022-05-03_11-02-08,fp7d
2021-04-21,SH,8,6,0,6,2022-05-03_11-02-08,fp7d
2021-04-21,SO,17,17,0,17,2022-05-03_11-02-08,fp7d
2021-04-21,SZ,12,12,0,12,2022-05-03_11-02-08,fp7d
2021-04-21,TG,21,31,10,21,2022-05-03_11-02-08,fp7d
2021-04-21,TI,53,76,23,53,2022-05-03_11-02-08,fp7d
2021-04-21,UR,6,6,0,6,2022-05-03_11-02-08,fp7d
2021-04-21,VD,85,101,16,85,2022-05-03_11-02-08,fp7d
2021-04-21,VS,20,22,2,20,2022-05-03_11-02-08,fp7d
2021-04-21,ZG,8,8,0,8,2022-05-03_11-02-08,fp7d
2021-04-21,ZH,190,201,17,184,2022-05-03_11-02-08,fp7d
2021-04-22,AG,52,48,0,48,2022-05-03_11-02-08,fp7d
2021-04-22,AI,0,0,0,0,2022-05-03_11-02-08,fp7d
2021-04-22,AR,6,6,0,6,2022-05-03_11-02-08,fp7d
2021-04-22,BE,92,86,6,80,2022-05-03_11-02-08,fp7d
2021-04-22,BL,20,16,0,16,2022-05-03_11-02-08,fp7d
2021-04-22,BS,54,50,0,50,2022-05-03_11-02-08,fp7d
2021-04-22,FR,24,24,0,24,2022-05-03_11-02-08,fp7d
2021-04-22,GE,38,56,18,38,2022-05-03_11-02-08,fp7d
2021-04-22,GL,6,6,0,6,2022-05-03_11-02-08,fp7d
2021-04-22,GR,16,16,0,16,2022-05-03_11-02-08,fp7d
2021-04-22,JU,6,6,0,6,2022-05-03_11-02-08,fp7d
2021-04-22,LU,40,42,2,40,2022-05-03_11-02-08,fp7d
2021-04-22,NE,10,10,0,10,2022-05-03_11-02-08,fp7d
2021-04-22,NW,6,6,0,6,2022-05-03_11-02-08,fp7d
2021-04-22,OW,0,0,0,0,2022-05-03_11-02-08,fp7d
2021-04-22,SG,54,55,1,54,2022-05-03_11-02-08,fp7d
2021-04-22,SH,8,6,0,6,2022-05-03_11-02-08,fp7d
2021-04-22,SO,17,17,0,17,2022-05-03_11-02-08,fp7d
2021-04-22,SZ,12,12,0,12,2022-05-03_11-02-08,fp7d
2021-04-22,TG,21,32,11,21,2022-05-03_11-02-08,fp7d
2021-04-22,TI,53,76,23,53,2022-05-03_11-02-08,fp7d
2021-04-22,UR,6,6,0,6,2022-05-03_11-02-08,fp7d
2021-04-22,VD,85,101,16,85,2022-05-03_11-02-08,fp7d
2021-04-22,VS,20,22,2,20,2022-05-03_11-02-08,fp7d
2021-04-22,ZG,8,8,0,8,2022-05-03_11-02-08,fp7d
2021-04-22,ZH,190,201,17,184,2022-05-03_11-02-08,fp7d
2021-04-23,AG,52,48,0,48,2022-05-03_11-02-08,fp7d
2021-04-23,AI,0,0,0,0,2022-05-03_11-02-08,fp7d
2021-04-23,AR,6,6,0,6,2022-05-03_11-02-08,fp7d
2021-04-23,BE,92,86,6,80,2022-05-03_11-02-08,fp7d
2021-04-23,BL,20,16,0,16,2022-05-03_11-02-08,fp7d
2021-04-23,BS,54,50,0,50,2022-05-03_11-02-08,fp7d
2021-04-23,FR,24,24,0,24,2022-05-03_11-02-08,fp7d
2021-04-23,GE,38,56,18,38,2022-05-03_11-02-08,fp7d
2021-04-23,GL,6,6,0,6,2022-05-03_11-02-08,fp7d
2021-04-23,GR,16,16,0,16,2022-05-03_11-02-08,fp7d
2021-04-23,JU,6,6,0,6,2022-05-03_11-02-08,fp7d
2021-04-23,LU,40,42,2,40,2022-05-03_11-02-08,fp7d
2021-04-23,NE,10,10,0,10,2022-05-03_11-02-08,fp7d
2021-04-23,NW,6,6,0,6,2022-05-03_11-02-08,fp7d
2021-04-23,OW,0,0,0,0,2022-05-03_11-02-08,fp7d
2021-04-23,SG,54,55,1,54,2022-05-03_11-02-08,fp7d
2021-04-23,SH,8,6,0,6,2022-05-03_11-02-08,fp7d
2021-04-23,SO,17,17,0,17,2022-05-03_11-02-08,fp7d
2021-04-23,SZ,12,12,0,12,2022-05-03_11-02-08,fp7d
2021-04-23,TG,21,32,11,21,2022-05-03_11-02-08,fp7d
2021-04-23,TI,53,77,25,52,2022-05-03_11-02-08,fp7d
2021-04-23,UR,6,6,0,6,2022-05-03_11-02-08,fp7d
2021-04-23,VD,85,101,16,85,2022-05-03_11-02-08,fp7d
2021-04-23,VS,20,22,2,20,2022-05-03_11-02-08,fp7d
2021-04-23,ZG,8,8,0,8,2022-05-03_11-02-08,fp7d
2021-04-23,ZH,190,199,17,182,2022-05-03_11-02-08,fp7d
2021-04-24,AG,52,48,0,48,2022-05-03_11-02-08,fp7d
2021-04-24,AI,0,0,0,0,2022-05-03_11-02-08,fp7d
2021-04-24,AR,6,6,0,6,2022-05-03_11-02-08,fp7d
2021-04-24,BE,92,84,6,78,2022-05-03_11-02-08,fp7d
2021-04-24,BL,20,16,0,16,2022-05-03_11-02-08,fp7d
2021-04-24,BS,54,48,2,46,2022-05-03_11-02-08,fp7d
2021-04-24,FR,24,24,0,24,2022-05-03_11-02-08,fp7d
2021-04-24,GE,38,56,18,38,2022-05-03_11-02-08,fp7d
2021-04-24,GL,6,6,0,6,2022-05-03_11-02-08,fp7d
2021-04-24,GR,16,16,0,16,2022-05-03_11-02-08,fp7d
2021-04-24,JU,6,6,0,6,2022-05-03_11-02-08,fp7d
2021-04-24,LU,40,42,2,40,2022-05-03_11-02-08,fp7d
2021-04-24,NE,10,10,0,10,2022-05-03_11-02-08,fp7d
2021-04-24,NW,6,6,0,6,2022-05-03_11-02-08,fp7d
2021-04-24,OW,0,0,0,0,2022-05-03_11-02-08,fp7d
2021-04-24,SG,54,55,1,54,2022-05-03_11-02-08,fp7d
2021-04-24,SH,8,6,0,6,2022-05-03_11-02-08,fp7d
2021-04-24,SO,17,17,0,17,2022-05-03_11-02-08,fp7d
2021-04-24,SZ,12,12,0,12,2022-05-03_11-02-08,fp7d
2021-04-24,TG,21,32,11,21,2022-05-03_11-02-08,fp7d
2021-04-24,TI,53,77,25,52,2022-05-03_11-02-08,fp7d
2021-04-24,UR,6,6,0,6,2022-05-03_11-02-08,fp7d
2021-04-24,VD,85,101,16,85,2022-05-03_11-02-08,fp7d
2021-04-24,VS,20,22,2,20,2022-05-03_11-02-08,fp7d
2021-04-24,ZG,8,8,0,8,2022-05-03_11-02-08,fp7d
2021-04-24,ZH,190,198,17,181,2022-05-03_11-02-08,fp7d
2021-04-25,AG,52,48,0,48,2022-05-03_11-02-08,fp7d
2021-04-25,AI,0,0,0,0,2022-05-03_11-02-08,fp7d
2021-04-25,AR,6,6,0,6,2022-05-03_11-02-08,fp7d
2021-04-25,BE,92,84,6,78,2022-05-03_11-02-08,fp7d
2021-04-25,BL,20,16,0,16,2022-05-03_11-02-08,fp7d
2021-04-25,BS,54,48,2,46,2022-05-03_11-02-08,fp7d
2021-04-25,FR,24,24,0,24,2022-05-03_11-02-08,fp7d
2021-04-25,GE,38,56,18,38,2022-05-03_11-02-08,fp7d
2021-04-25,GL,6,6,0,6,2022-05-03_11-02-08,fp7d
2021-04-25,GR,16,16,0,16,2022-05-03_11-02-08,fp7d
2021-04-25,JU,6,6,0,6,2022-05-03_11-02-08,fp7d
2021-04-25,LU,40,40,0,40,2022-05-03_11-02-08,fp7d
2021-04-25,NE,10,10,0,10,2022-05-03_11-02-08,fp7d
2021-04-25,NW,6,6,0,6,2022-05-03_11-02-08,fp7d
2021-04-25,OW,0,0,0,0,2022-05-03_11-02-08,fp7d
2021-04-25,SG,54,55,1,54,2022-05-03_11-02-08,fp7d
2021-04-25,SH,8,6,0,6,2022-05-03_11-02-08,fp7d
2021-04-25,SO,17,17,0,17,2022-05-03_11-02-08,fp7d
2021-04-25,SZ,12,12,0,12,2022-05-03_11-02-08,fp7d
2021-04-25,TG,21,32,11,21,2022-05-03_11-02-08,fp7d
2021-04-25,TI,53,77,25,52,2022-05-03_11-02-08,fp7d
2021-04-25,UR,6,6,0,6,2022-05-03_11-02-08,fp7d
2021-04-25,VD,85,101,16,85,2022-05-03_11-02-08,fp7d
2021-04-25,VS,20,22,2,20,2022-05-03_11-02-08,fp7d
2021-04-25,ZG,8,8,0,8,2022-05-03_11-02-08,fp7d
2021-04-25,ZH,190,198,17,181,2022-05-03_11-02-08,fp7d
2021-04-26,AG,52,48,0,48,2022-05-03_11-02-08,fp7d
2021-04-26,AI,0,0,0,0,2022-05-03_11-02-08,fp7d
2021-04-26,AR,6,6,0,6,2022-05-03_11-02-08,fp7d
2021-04-26,BE,92,88,6,82,2022-05-03_11-02-08,fp7d
2021-04-26,BL,20,16,0,16,2022-05-03_11-02-08,fp7d
2021-04-26,BS,54,52,2,50,2022-05-03_11-02-08,fp7d
2021-04-26,FR,24,24,0,24,2022-05-03_11-02-08,fp7d
2021-04-26,GE,38,56,18,38,2022-05-03_11-02-08,fp7d
2021-04-26,GL,6,6,0,6,2022-05-03_11-02-08,fp7d
2021-04-26,GR,16,16,0,16,2022-05-03_11-02-08,fp7d
2021-04-26,JU,6,6,0,6,2022-05-03_11-02-08,fp7d
2021-04-26,LU,40,40,0,40,2022-05-03_11-02-08,fp7d
2021-04-26,NE,10,10,0,10,2022-05-03_11-02-08,fp7d
2021-04-26,NW,6,6,0,6,2022-05-03_11-02-08,fp7d
2021-04-26,OW,0,0,0,0,2022-05-03_11-02-08,fp7d
2021-04-26,SG,54,55,1,54,2022-05-03_11-02-08,fp7d
2021-04-26,SH,8,7,0,7,2022-05-03_11-02-08,fp7d
2021-04-26,SO,17,17,0,17,2022-05-03_11-02-08,fp7d
2021-04-26,SZ,12,12,0,12,2022-05-03_11-02-08,fp7d
2021-04-26,TG,21,32,11,21,2022-05-03_11-02-08,fp7d
2021-04-26,TI,53,80,27,53,2022-05-03_11-02-08,fp7d
2021-04-26,UR,6,6,0,6,2022-05-03_11-02-08,fp7d
2021-04-26,VD,85,101,16,85,2022-05-03_11-02-08,fp7d
2021-04-26,VS,20,22,2,20,2022-05-03_11-02-08,fp7d
2021-04-26,ZG,8,8,0,8,2022-05-03_11-02-08,fp7d
2021-04-26,ZH,190,198,17,181,2022-05-03_11-02-08,fp7d
2021-04-27,AG,52,49,1,48,2022-05-03_11-02-08,fp7d
2021-04-27,AI,0,0,0,0,2022-05-03_11-02-08,fp7d
2021-04-27,AR,6,6,0,6,2022-05-03_11-02-08,fp7d
2021-04-27,BE,92,86,6,80,2022-05-03_11-02-08,fp7d
2021-04-27,BL,20,16,0,16,2022-05-03_11-02-08,fp7d
2021-04-27,BS,54,52,2,50,2022-05-03_11-02-08,fp7d
2021-04-27,FR,24,24,0,24,2022-05-03_11-02-08,fp7d
2021-04-27,GE,38,56,18,38,2022-05-03_11-02-08,fp7d
2021-04-27,GL,6,6,0,6,2022-05-03_11-02-08,fp7d
2021-04-27,GR,16,16,0,16,2022-05-03_11-02-08,fp7d
2021-04-27,JU,6,6,0,6,2022-05-03_11-02-08,fp7d
2021-04-27,LU,40,42,2,40,2022-05-03_11-02-08,fp7d
2021-04-27,NE,10,10,0,10,2022-05-03_11-02-08,fp7d
2021-04-27,NW,6,6,0,6,2022-05-03_11-02-08,fp7d
2021-04-27,OW,0,0,0,0,2022-05-03_11-02-08,fp7d
2021-04-27,SG,54,55,1,54,2022-05-03_11-02-08,fp7d
2021-04-27,SH,8,7,0,7,2022-05-03_11-02-08,fp7d
2021-04-27,SO,17,17,0,17,2022-05-03_11-02-08,fp7d
2021-04-27,SZ,12,12,0,12,2022-05-03_11-02-08,fp7d
2021-04-27,TG,21,28,7,21,2022-05-03_11-02-08,fp7d
2021-04-27,TI,53,80,27,53,2022-05-03_11-02-08,fp7d
2021-04-27,UR,6,6,0,6,2022-05-03_11-02-08,fp7d
2021-04-27,VD,85,101,16,85,2022-05-03_11-02-08,fp7d
2021-04-27,VS,20,22,2,20,2022-05-03_11-02-08,fp7d
2021-04-27,ZG,8,8,0,8,2022-05-03_11-02-08,fp7d
2021-04-27,ZH,190,197,15,182,2022-05-03_11-02-08,fp7d
2021-04-28,AG,52,48,0,48,2022-05-03_11-02-08,fp7d
2021-04-28,AI,0,0,0,0,2022-05-03_11-02-08,fp7d
2021-04-28,AR,6,6,0,6,2022-05-03_11-02-08,fp7d
2021-04-28,BE,92,86,6,80,2022-05-03_11-02-08,fp7d
2021-04-28,BL,20,16,0,16,2022-05-03_11-02-08,fp7d
2021-04-28,BS,54,50,0,50,2022-05-03_11-02-08,fp7d
2021-04-28,FR,24,24,0,24,2022-05-03_11-02-08,fp7d
2021-04-28,GE,38,56,18,38,2022-05-03_11-02-08,fp7d
2021-04-28,GL,6,6,0,6,2022-05-03_11-02-08,fp7d
2021-04-28,GR,16,16,0,16,2022-05-03_11-02-08,fp7d
2021-04-28,JU,6,6,0,6,2022-05-03_11-02-08,fp7d
2021-04-28,LU,40,42,2,40,2022-05-03_11-02-08,fp7d
2021-04-28,NE,10,10,0,10,2022-05-03_11-02-08,fp7d
2021-04-28,NW,6,4,0,4,2022-05-03_11-02-08,fp7d
2021-04-28,OW,0,0,0,0,2022-05-03_11-02-08,fp7d
2021-04-28,SG,54,55,1,54,2022-05-03_11-02-08,fp7d
2021-04-28,SH,8,7,0,7,2022-05-03_11-02-08,fp7d
2021-04-28,SO,17,17,0,17,2022-05-03_11-02-08,fp7d
2021-04-28,SZ,12,12,0,12,2022-05-03_11-02-08,fp7d
2021-04-28,TG,21,29,8,21,2022-05-03_11-02-08,fp7d
2021-04-28,TI,53,80,27,53,2022-05-03_11-02-08,fp7d
2021-04-28,UR,6,6,0,6,2022-05-03_11-02-08,fp7d
2021-04-28,VD,85,101,16,85,2022-05-03_11-02-08,fp7d
2021-04-28,VS,20,22,2,20,2022-05-03_11-02-08,fp7d
2021-04-28,ZG,8,8,0,8,2022-05-03_11-02-08,fp7d
2021-04-28,ZH,190,198,16,182,2022-05-03_11-02-08,fp7d
2021-04-29,AG,52,48,0,48,2022-05-03_11-02-08,fp7d
2021-04-29,AI,0,0,0,0,2022-05-03_11-02-08,fp7d
2021-04-29,AR,6,6,0,6,2022-05-03_11-02-08,fp7d
2021-04-29,BE,92,86,6,80,2022-05-03_11-02-08,fp7d
2021-04-29,BL,20,16,0,16,2022-05-03_11-02-08,fp7d
2021-04-29,BS,54,50,0,50,2022-05-03_11-02-08,fp7d
2021-04-29,FR,24,24,0,24,2022-05-03_11-02-08,fp7d
2021-04-29,GE,38,56,18,38,2022-05-03_11-02-08,fp7d
2021-04-29,GL,6,6,0,6,2022-05-03_11-02-08,fp7d
2021-04-29,GR,16,16,0,16,2022-05-03_11-02-08,fp7d
2021-04-29,JU,6,6,0,6,2022-05-03_11-02-08,fp7d
2021-04-29,LU,40,42,2,40,2022-05-03_11-02-08,fp7d
2021-04-29,NE,10,10,0,10,2022-05-03_11-02-08,fp7d
2021-04-29,NW,6,4,0,4,2022-05-03_11-02-08,fp7d
2021-04-29,OW,0,0,0,0,2022-05-03_11-02-08,fp7d
2021-04-29,SG,54,55,1,54,2022-05-03_11-02-08,fp7d
2021-04-29,SH,8,7,0,7,2022-05-03_11-02-08,fp7d
2021-04-29,SO,17,17,0,17,2022-05-03_11-02-08,fp7d
2021-04-29,SZ,12,12,0,12,2022-05-03_11-02-08,fp7d
2021-04-29,TG,21,29,8,21,2022-05-03_11-02-08,fp7d
2021-04-29,TI,53,80,27,53,2022-05-03_11-02-08,fp7d
2021-04-29,UR,6,6,0,6,2022-05-03_11-02-08,fp7d
2021-04-29,VD,85,101,16,85,2022-05-03_11-02-08,fp7d
2021-04-29,VS,20,22,2,20,2022-05-03_11-02-08,fp7d
2021-04-29,ZG,8,8,0,8,2022-05-03_11-02-08,fp7d
2021-04-29,ZH,190,198,16,182,2022-05-03_11-02-08,fp7d
2021-04-30,AG,52,49,1,48,2022-05-03_11-02-08,fp7d
2021-04-30,AI,0,0,0,0,2022-05-03_11-02-08,fp7d
2021-04-30,AR,6,6,0,6,2022-05-03_11-02-08,fp7d
2021-04-30,BE,92,86,6,80,2022-05-03_11-02-08,fp7d
2021-04-30,BL,20,16,0,16,2022-05-03_11-02-08,fp7d
2021-04-30,BS,54,50,0,50,2022-05-03_11-02-08,fp7d
2021-04-30,FR,24,24,0,24,2022-05-03_11-02-08,fp7d
2021-04-30,GE,38,56,18,38,2022-05-03_11-02-08,fp7d
2021-04-30,GL,6,6,0,6,2022-05-03_11-02-08,fp7d
2021-04-30,GR,16,16,0,16,2022-05-03_11-02-08,fp7d
2021-04-30,JU,6,6,0,6,2022-05-03_11-02-08,fp7d
2021-04-30,LU,40,42,2,40,2022-05-03_11-02-08,fp7d
2021-04-30,NE,10,10,0,10,2022-05-03_11-02-08,fp7d
2021-04-30,NW,6,4,0,4,2022-05-03_11-02-08,fp7d
2021-04-30,OW,0,0,0,0,2022-05-03_11-02-08,fp7d
2021-04-30,SG,54,55,1,54,2022-05-03_11-02-08,fp7d
2021-04-30,SH,8,7,0,7,2022-05-03_11-02-08,fp7d
2021-04-30,SO,17,17,0,17,2022-05-03_11-02-08,fp7d
2021-04-30,SZ,12,12,0,12,2022-05-03_11-02-08,fp7d
2021-04-30,TG,21,29,8,21,2022-05-03_11-02-08,fp7d
2021-04-30,TI,53,80,27,53,2022-05-03_11-02-08,fp7d
2021-04-30,UR,6,6,0,6,2022-05-03_11-02-08,fp7d
2021-04-30,VD,85,101,16,85,2022-05-03_11-02-08,fp7d
2021-04-30,VS,20,22,2,20,2022-05-03_11-02-08,fp7d
2021-04-30,ZG,8,8,0,8,2022-05-03_11-02-08,fp7d
2021-04-30,ZH,190,198,16,182,2022-05-03_11-02-08,fp7d
2021-05-01,AG,52,49,1,48,2022-05-03_11-02-08,fp7d
2021-05-01,AI,0,0,0,0,2022-05-03_11-02-08,fp7d
2021-05-01,AR,6,6,0,6,2022-05-03_11-02-08,fp7d
2021-05-01,BE,92,84,6,78,2022-05-03_11-02-08,fp7d
2021-05-01,BL,20,16,0,16,2022-05-03_11-02-08,fp7d
2021-05-01,BS,54,46,0,46,2022-05-03_11-02-08,fp7d
2021-05-01,FR,24,24,0,24,2022-05-03_11-02-08,fp7d
2021-05-01,GE,38,56,18,38,2022-05-03_11-02-08,fp7d
2021-05-01,GL,6,6,0,6,2022-05-03_11-02-08,fp7d
2021-05-01,GR,16,16,0,16,2022-05-03_11-02-08,fp7d
2021-05-01,JU,6,6,0,6,2022-05-03_11-02-08,fp7d
2021-05-01,LU,40,40,0,40,2022-05-03_11-02-08,fp7d
2021-05-01,NE,10,10,0,10,2022-05-03_11-02-08,fp7d
2021-05-01,NW,6,4,0,4,2022-05-03_11-02-08,fp7d
2021-05-01,OW,0,0,0,0,2022-05-03_11-02-08,fp7d
2021-05-01,SG,54,55,1,54,2022-05-03_11-02-08,fp7d
2021-05-01,SH,8,7,0,7,2022-05-03_11-02-08,fp7d
2021-05-01,SO,17,17,0,17,2022-05-03_11-02-08,fp7d
2021-05-01,SZ,12,12,0,12,2022-05-03_11-02-08,fp7d
2021-05-01,TG,21,29,8,21,2022-05-03_11-02-08,fp7d
2021-05-01,TI,53,80,27,53,2022-05-03_11-02-08,fp7d
2021-05-01,UR,6,6,0,6,2022-05-03_11-02-08,fp7d
2021-05-01,VD,85,101,16,85,2022-05-03_11-02-08,fp7d
2021-05-01,VS,20,22,2,20,2022-05-03_11-02-08,fp7d
2021-05-01,ZG,8,8,0,8,2022-05-03_11-02-08,fp7d
2021-05-01,ZH,190,198,16,182,2022-05-03_11-02-08,fp7d
2021-05-02,AG,52,49,1,48,2022-05-03_11-02-08,fp7d
2021-05-02,AI,0,0,0,0,2022-05-03_11-02-08,fp7d
2021-05-02,AR,6,6,0,6,2022-05-03_11-02-08,fp7d
2021-05-02,BE,92,84,6,78,2022-05-03_11-02-08,fp7d
2021-05-02,BL,20,16,0,16,2022-05-03_11-02-08,fp7d
2021-05-02,BS,54,46,0,46,2022-05-03_11-02-08,fp7d
2021-05-02,FR,24,24,0,24,2022-05-03_11-02-08,fp7d
2021-05-02,GE,38,56,18,38,2022-05-03_11-02-08,fp7d
2021-05-02,GL,6,6,0,6,2022-05-03_11-02-08,fp7d
2021-05-02,GR,16,16,0,16,2022-05-03_11-02-08,fp7d
2021-05-02,JU,6,6,0,6,2022-05-03_11-02-08,fp7d
2021-05-02,LU,40,40,0,40,2022-05-03_11-02-08,fp7d
2021-05-02,NE,10,10,0,10,2022-05-03_11-02-08,fp7d
2021-05-02,NW,6,4,0,4,2022-05-03_11-02-08,fp7d
2021-05-02,OW,0,0,0,0,2022-05-03_11-02-08,fp7d
2021-05-02,SG,54,55,1,54,2022-05-03_11-02-08,fp7d
2021-05-02,SH,8,7,0,7,2022-05-03_11-02-08,fp7d
2021-05-02,SO,17,17,0,17,2022-05-03_11-02-08,fp7d
2021-05-02,SZ,12,12,0,12,2022-05-03_11-02-08,fp7d
2021-05-02,TG,21,29,8,21,2022-05-03_11-02-08,fp7d
2021-05-02,TI,53,79,27,52,2022-05-03_11-02-08,fp7d
2021-05-02,UR,6,6,0,6,2022-05-03_11-02-08,fp7d
2021-05-02,VD,85,101,16,85,2022-05-03_11-02-08,fp7d
2021-05-02,VS,20,22,2,20,2022-05-03_11-02-08,fp7d
2021-05-02,ZG,8,8,0,8,2022-05-03_11-02-08,fp7d
2021-05-02,ZH,190,197,16,181,2022-05-03_11-02-08,fp7d
2021-05-03,AG,52,49,1,48,2022-05-03_11-02-08,fp7d
2021-05-03,AI,0,0,0,0,2022-05-03_11-02-08,fp7d
2021-05-03,AR,6,6,0,6,2022-05-03_11-02-08,fp7d
2021-05-03,BE,92,84,6,78,2022-05-03_11-02-08,fp7d
2021-05-03,BL,20,16,0,16,2022-05-03_11-02-08,fp7d
2021-05-03,BS,54,46,0,46,2022-05-03_11-02-08,fp7d
2021-05-03,FR,24,24,0,24,2022-05-03_11-02-08,fp7d
2021-05-03,GE,38,56,18,38,2022-05-03_11-02-08,fp7d
2021-05-03,GL,6,6,0,6,2022-05-03_11-02-08,fp7d
2021-05-03,GR,16,16,0,16,2022-05-03_11-02-08,fp7d
2021-05-03,JU,6,6,0,6,2022-05-03_11-02-08,fp7d
2021-05-03,LU,40,40,0,40,2022-05-03_11-02-08,fp7d
2021-05-03,NE,10,10,0,10,2022-05-03_11-02-08,fp7d
2021-05-03,NW,6,4,0,4,2022-05-03_11-02-08,fp7d
2021-05-03,OW,0,0,0,0,2022-05-03_11-02-08,fp7d
2021-05-03,SG,54,55,1,54,2022-05-03_11-02-08,fp7d
2021-05-03,SH,8,7,0,7,2022-05-03_11-02-08,fp7d
2021-05-03,SO,17,17,0,17,2022-05-03_11-02-08,fp7d
2021-05-03,SZ,12,12,0,12,2022-05-03_11-02-08,fp7d
2021-05-03,TG,21,29,8,21,2022-05-03_11-02-08,fp7d
2021-05-03,TI,53,79,27,52,2022-05-03_11-02-08,fp7d
2021-05-03,UR,6,6,0,6,2022-05-03_11-02-08,fp7d
2021-05-03,VD,85,101,16,85,2022-05-03_11-02-08,fp7d
2021-05-03,VS,20,22,2,20,2022-05-03_11-02-08,fp7d
2021-05-03,ZG,8,8,0,8,2022-05-03_11-02-08,fp7d
2021-05-03,ZH,190,197,16,181,2022-05-03_11-02-08,fp7d
2021-05-04,AG,52,49,1,48,2022-05-03_11-02-08,fp7d
2021-05-04,AI,0,0,0,0,2022-05-03_11-02-08,fp7d
2021-05-04,AR,6,6,0,6,2022-05-03_11-02-08,fp7d
2021-05-04,BE,92,83,2,81,2022-05-03_11-02-08,fp7d
2021-05-04,BL,20,16,0,16,2022-05-03_11-02-08,fp7d
2021-05-04,BS,54,50,0,50,2022-05-03_11-02-08,fp7d
2021-05-04,FR,24,24,0,24,2022-05-03_11-02-08,fp7d
2021-05-04,GE,38,56,18,38,2022-05-03_11-02-08,fp7d
2021-05-04,GL,6,6,0,6,2022-05-03_11-02-08,fp7d
2021-05-04,GR,16,16,0,16,2022-05-03_11-02-08,fp7d
2021-05-04,JU,6,6,0,6,2022-05-03_11-02-08,fp7d
2021-05-04,LU,40,40,0,40,2022-05-03_11-02-08,fp7d
2021-05-04,NE,10,10,0,10,2022-05-03_11-02-08,fp7d
2021-05-04,NW,6,4,0,4,2022-05-03_11-02-08,fp7d
2021-05-04,OW,0,0,0,0,2022-05-03_11-02-08,fp7d
2021-05-04,SG,54,55,1,54,2022-05-03_11-02-08,fp7d
2021-05-04,SH,8,7,0,7,2022-05-03_11-02-08,fp7d
2021-05-04,SO,17,17,0,17,2022-05-03_11-02-08,fp7d
2021-05-04,SZ,12,12,0,12,2022-05-03_11-02-08,fp7d
2021-05-04,TG,21,28,7,21,2022-05-03_11-02-08,fp7d
2021-05-04,TI,53,79,27,52,2022-05-03_11-02-08,fp7d
2021-05-04,UR,6,6,0,6,2022-05-03_11-02-08,fp7d
2021-05-04,VD,85,99,14,85,2022-05-03_11-02-08,fp7d
2021-05-04,VS,20,22,2,20,2022-05-03_11-02-08,fp7d
2021-05-04,ZG,8,8,0,8,2022-05-03_11-02-08,fp7d
2021-05-04,ZH,190,196,16,180,2022-05-03_11-02-08,fp7d
2021-05-05,AG,52,51,1,50,2022-05-03_11-02-08,fp7d
2021-05-05,AI,0,0,0,0,2022-05-03_11-02-08,fp7d
2021-05-05,AR,6,6,0,6,2022-05-03_11-02-08,fp7d
2021-05-05,BE,92,83,2,81,2022-05-03_11-02-08,fp7d
2021-05-05,BL,20,16,0,16,2022-05-03_11-02-08,fp7d
2021-05-05,BS,54,50,0,50,2022-05-03_11-02-08,fp7d
2021-05-05,FR,24,24,0,24,2022-05-03_11-02-08,fp7d
2021-05-05,GE,38,56,18,38,2022-05-03_11-02-08,fp7d
2021-05-05,GL,6,6,0,6,2022-05-03_11-02-08,fp7d
2021-05-05,GR,16,16,0,16,2022-05-03_11-02-08,fp7d
2021-05-05,JU,6,6,0,6,2022-05-03_11-02-08,fp7d
2021-05-05,LU,54,50,0,50,2022-05-03_11-02-08,fp7d
2021-05-05,NE,10,10,0,10,2022-05-03_11-02-08,fp7d
2021-05-05,NW,6,4,0,4,2022-05-03_11-02-08,fp7d
2021-05-05,OW,0,0,0,0,2022-05-03_11-02-08,fp7d
2021-05-05,SG,54,55,1,54,2022-05-03_11-02-08,fp7d
2021-05-05,SH,8,7,0,7,2022-05-03_11-02-08,fp7d
2021-05-05,SO,17,17,0,17,2022-05-03_11-02-08,fp7d
2021-05-05,SZ,12,12,0,12,2022-05-03_11-02-08,fp7d
2021-05-05,TG,21,28,7,21,2022-05-03_11-02-08,fp7d
2021-05-05,TI,53,76,23,53,2022-05-03_11-02-08,fp7d
2021-05-05,UR,6,6,0,6,2022-05-03_11-02-08,fp7d
2021-05-05,VD,78,92,14,78,2022-05-03_11-02-08,fp7d
2021-05-05,VS,20,22,2,20,2022-05-03_11-02-08,fp7d
2021-05-05,ZG,8,8,0,8,2022-05-03_11-02-08,fp7d
2021-05-05,ZH,190,198,17,181,2022-05-03_11-02-08,fp7d
2021-05-06,AG,52,51,1,50,2022-05-03_11-02-08,fp7d
2021-05-06,AI,0,0,0,0,2022-05-03_11-02-08,fp7d
2021-05-06,AR,6,6,0,6,2022-05-03_11-02-08,fp7d
2021-05-06,BE,92,85,4,81,2022-05-03_11-02-08,fp7d
2021-05-06,BL,20,16,0,16,2022-05-03_11-02-08,fp7d
2021-05-06,BS,54,50,0,50,2022-05-03_11-02-08,fp7d
2021-05-06,FR,24,24,0,24,2022-05-03_11-02-08,fp7d
2021-05-06,GE,38,56,18,38,2022-05-03_11-02-08,fp7d
2021-05-06,GL,6,6,0,6,2022-05-03_11-02-08,fp7d
2021-05-06,GR,16,16,0,16,2022-05-03_11-02-08,fp7d
2021-05-06,JU,6,6,0,6,2022-05-03_11-02-08,fp7d
2021-05-06,LU,54,50,0,50,2022-05-03_11-02-08,fp7d
2021-05-06,NE,10,10,0,10,2022-05-03_11-02-08,fp7d
2021-05-06,NW,6,5,0,5,2022-05-03_11-02-08,fp7d
2021-05-06,OW,0,0,0,0,2022-05-03_11-02-08,fp7d
2021-05-06,SG,54,55,1,54,2022-05-03_11-02-08,fp7d
2021-05-06,SH,8,6,0,6,2022-05-03_11-02-08,fp7d
2021-05-06,SO,17,17,0,17,2022-05-03_11-02-08,fp7d
2021-05-06,SZ,12,12,0,12,2022-05-03_11-02-08,fp7d
2021-05-06,TG,21,28,7,21,2022-05-03_11-02-08,fp7d
2021-05-06,TI,53,76,23,53,2022-05-03_11-02-08,fp7d
2021-05-06,UR,6,6,0,6,2022-05-03_11-02-08,fp7d
2021-05-06,VD,85,99,14,85,2022-05-03_11-02-08,fp7d
2021-05-06,VS,20,22,2,20,2022-05-03_11-02-08,fp7d
2021-05-06,ZG,8,8,0,8,2022-05-03_11-02-08,fp7d
2021-05-06,ZH,190,196,15,181,2022-05-03_11-02-08,fp7d
2021-05-07,AG,52,50,0,50,2022-05-03_11-02-08,fp7d
2021-05-07,AI,0,0,0,0,2022-05-03_11-02-08,fp7d
2021-05-07,AR,6,6,0,6,2022-05-03_11-02-08,fp7d
2021-05-07,BE,92,85,4,81,2022-05-03_11-02-08,fp7d
2021-05-07,BL,20,16,0,16,2022-05-03_11-02-08,fp7d
2021-05-07,BS,54,50,0,50,2022-05-03_11-02-08,fp7d
2021-05-07,FR,24,24,0,24,2022-05-03_11-02-08,fp7d
2021-05-07,GE,38,50,12,38,2022-05-03_11-02-08,fp7d
2021-05-07,GL,6,5,0,5,2022-05-03_11-02-08,fp7d
2021-05-07,GR,16,16,0,16,2022-05-03_11-02-08,fp7d
2021-05-07,JU,6,6,0,6,2022-05-03_11-02-08,fp7d
2021-05-07,LU,54,50,0,50,2022-05-03_11-02-08,fp7d
2021-05-07,NE,10,10,0,10,2022-05-03_11-02-08,fp7d
2021-05-07,NW,6,5,0,5,2022-05-03_11-02-08,fp7d
2021-05-07,OW,0,0,0,0,2022-05-03_11-02-08,fp7d
2021-05-07,SG,54,55,1,54,2022-05-03_11-02-08,fp7d
2021-05-07,SH,8,6,0,6,2022-05-03_11-02-08,fp7d
2021-05-07,SO,17,17,0,17,2022-05-03_11-02-08,fp7d
2021-05-07,SZ,12,12,0,12,2022-05-03_11-02-08,fp7d
2021-05-07,TG,21,28,7,21,2022-05-03_11-02-08,fp7d
2021-05-07,TI,53,76,23,53,2022-05-03_11-02-08,fp7d
2021-05-07,UR,6,6,0,6,2022-05-03_11-02-08,fp7d
2021-05-07,VD,85,96,11,85,2022-05-03_11-02-08,fp7d
2021-05-07,VS,20,22,2,20,2022-05-03_11-02-08,fp7d
2021-05-07,ZG,8,8,0,8,2022-05-03_11-02-08,fp7d
2021-05-07,ZH,190,197,14,183,2022-05-03_11-02-08,fp7d
2021-05-08,AG,52,50,0,50,2022-05-03_11-02-08,fp7d
2021-05-08,AI,0,0,0,0,2022-05-03_11-02-08,fp7d
2021-05-08,AR,6,6,0,6,2022-05-03_11-02-08,fp7d
2021-05-08,BE,92,86,4,82,2022-05-03_11-02-08,fp7d
2021-05-08,BL,20,16,0,16,2022-05-03_11-02-08,fp7d
2021-05-08,BS,54,50,0,50,2022-05-03_11-02-08,fp7d
2021-05-08,FR,24,24,0,24,2022-05-03_11-02-08,fp7d
2021-05-08,GE,38,50,12,38,2022-05-03_11-02-08,fp7d
2021-05-08,GL,6,5,0,5,2022-05-03_11-02-08,fp7d
2021-05-08,GR,16,16,0,16,2022-05-03_11-02-08,fp7d
2021-05-08,JU,6,6,0,6,2022-05-03_11-02-08,fp7d
2021-05-08,LU,54,50,0,50,2022-05-03_11-02-08,fp7d
2021-05-08,NE,10,10,0,10,2022-05-03_11-02-08,fp7d
2021-05-08,NW,6,5,0,5,2022-05-03_11-02-08,fp7d
2021-05-08,OW,0,0,0,0,2022-05-03_11-02-08,fp7d
2021-05-08,SG,54,55,1,54,2022-05-03_11-02-08,fp7d
2021-05-08,SH,8,6,0,6,2022-05-03_11-02-08,fp7d
2021-05-08,SO,17,17,0,17,2022-05-03_11-02-08,fp7d
2021-05-08,SZ,12,12,0,12,2022-05-03_11-02-08,fp7d
2021-05-08,TG,21,28,7,21,2022-05-03_11-02-08,fp7d
2021-05-08,TI,53,76,23,53,2022-05-03_11-02-08,fp7d
2021-05-08,UR,6,6,0,6,2022-05-03_11-02-08,fp7d
2021-05-08,VD,85,96,11,85,2022-05-03_11-02-08,fp7d
2021-05-08,VS,20,22,2,20,2022-05-03_11-02-08,fp7d
2021-05-08,ZG,8,8,0,8,2022-05-03_11-02-08,fp7d
2021-05-08,ZH,190,198,15,183,2022-05-03_11-02-08,fp7d
2021-05-09,AG,52,51,1,50,2022-05-03_11-02-08,fp7d
2021-05-09,AI,0,0,0,0,2022-05-03_11-02-08,fp7d
2021-05-09,AR,6,6,0,6,2022-05-03_11-02-08,fp7d
2021-05-09,BE,92,86,4,82,2022-05-03_11-02-08,fp7d
2021-05-09,BL,20,16,0,16,2022-05-03_11-02-08,fp7d
2021-05-09,BS,54,46,0,46,2022-05-03_11-02-08,fp7d
2021-05-09,FR,24,24,0,24,2022-05-03_11-02-08,fp7d
2021-05-09,GE,38,50,12,38,2022-05-03_11-02-08,fp7d
2021-05-09,GL,6,5,0,5,2022-05-03_11-02-08,fp7d
2021-05-09,GR,16,16,0,16,2022-05-03_11-02-08,fp7d
2021-05-09,JU,6,6,0,6,2022-05-03_11-02-08,fp7d
2021-05-09,LU,54,50,0,50,2022-05-03_11-02-08,fp7d
2021-05-09,NE,10,10,0,10,2022-05-03_11-02-08,fp7d
2021-05-09,NW,6,5,0,5,2022-05-03_11-02-08,fp7d
2021-05-09,OW,0,0,0,0,2022-05-03_11-02-08,fp7d
2021-05-09,SG,54,55,1,54,2022-05-03_11-02-08,fp7d
2021-05-09,SH,8,6,0,6,2022-05-03_11-02-08,fp7d
2021-05-09,SO,17,17,0,17,2022-05-03_11-02-08,fp7d
2021-05-09,SZ,12,12,0,12,2022-05-03_11-02-08,fp7d
2021-05-09,TG,21,28,7,21,2022-05-03_11-02-08,fp7d
2021-05-09,TI,53,76,23,53,2022-05-03_11-02-08,fp7d
2021-05-09,UR,6,6,0,6,2022-05-03_11-02-08,fp7d
2021-05-09,VD,85,96,11,85,2022-05-03_11-02-08,fp7d
2021-05-09,VS,20,22,2,20,2022-05-03_11-02-08,fp7d
2021-05-09,ZG,8,8,0,8,2022-05-03_11-02-08,fp7d
2021-05-09,ZH,190,198,15,183,2022-05-03_11-02-08,fp7d
2021-05-10,AG,52,50,1,49,2022-05-03_11-02-08,fp7d
2021-05-10,AI,0,0,0,0,2022-05-03_11-02-08,fp7d
2021-05-10,AR,6,6,0,6,2022-05-03_11-02-08,fp7d
2021-05-10,BE,92,85,2,83,2022-05-03_11-02-08,fp7d
2021-05-10,BL,20,16,0,16,2022-05-03_11-02-08,fp7d
2021-05-10,BS,54,50,0,50,2022-05-03_11-02-08,fp7d
2021-05-10,FR,24,24,0,24,2022-05-03_11-02-08,fp7d
2021-05-10,GE,38,56,18,38,2022-05-03_11-02-08,fp7d
2021-05-10,GL,6,5,0,5,2022-05-03_11-02-08,fp7d
2021-05-10,GR,16,16,0,16,2022-05-03_11-02-08,fp7d
2021-05-10,JU,6,6,0,6,2022-05-03_11-02-08,fp7d
2021-05-10,LU,54,50,0,50,2022-05-03_11-02-08,fp7d
2021-05-10,NE,10,10,0,10,2022-05-03_11-02-08,fp7d
2021-05-10,NW,6,5,0,5,2022-05-03_11-02-08,fp7d
2021-05-10,OW,0,0,0,0,2022-05-03_11-02-08,fp7d
2021-05-10,SG,54,55,1,54,2022-05-03_11-02-08,fp7d
2021-05-10,SH,8,6,0,6,2022-05-03_11-02-08,fp7d
2021-05-10,SO,17,17,0,17,2022-05-03_11-02-08,fp7d
2021-05-10,SZ,12,12,0,12,2022-05-03_11-02-08,fp7d
2021-05-10,TG,21,28,7,21,2022-05-03_11-02-08,fp7d
2021-05-10,TI,53,76,23,53,2022-05-03_11-02-08,fp7d
2021-05-10,UR,6,6,0,6,2022-05-03_11-02-08,fp7d
2021-05-10,VD,85,96,11,85,2022-05-03_11-02-08,fp7d
2021-05-10,VS,20,22,2,20,2022-05-03_11-02-08,fp7d
2021-05-10,ZG,8,8,0,8,2022-05-03_11-02-08,fp7d
2021-05-10,ZH,190,199,16,183,2022-05-03_11-02-08,fp7d
2021-05-11,AG,52,49,0,49,2022-05-03_11-02-08,fp7d
2021-05-11,AI,0,0,0,0,2022-05-03_11-02-08,fp7d
2021-05-11,AR,6,6,0,6,2022-05-03_11-02-08,fp7d
2021-05-11,BE,91,84,2,82,2022-05-03_11-02-08,fp7d
2021-05-11,BL,20,16,0,16,2022-05-03_11-02-08,fp7d
2021-05-11,BS,54,50,0,50,2022-05-03_11-02-08,fp7d
2021-05-11,FR,24,24,0,24,2022-05-03_11-02-08,fp7d
2021-05-11,GE,38,56,18,38,2022-05-03_11-02-08,fp7d
2021-05-11,GL,6,5,0,5,2022-05-03_11-02-08,fp7d
2021-05-11,GR,16,16,0,16,2022-05-03_11-02-08,fp7d
2021-05-11,JU,6,6,0,6,2022-05-03_11-02-08,fp7d
2021-05-11,LU,54,50,0,50,2022-05-03_11-02-08,fp7d
2021-05-11,NE,10,10,0,10,2022-05-03_11-02-08,fp7d
2021-05-11,NW,6,5,0,5,2022-05-03_11-02-08,fp7d
2021-05-11,OW,0,0,0,0,2022-05-03_11-02-08,fp7d
2021-05-11,SG,54,55,1,54,2022-05-03_11-02-08,fp7d
2021-05-11,SH,8,6,0,6,2022-05-03_11-02-08,fp7d
2021-05-11,SO,17,17,0,17,2022-05-03_11-02-08,fp7d
2021-05-11,SZ,12,12,0,12,2022-05-03_11-02-08,fp7d
2021-05-11,TG,21,28,7,21,2022-05-03_11-02-08,fp7d
2021-05-11,TI,53,76,23,53,2022-05-03_11-02-08,fp7d
2021-05-11,UR,6,6,0,6,2022-05-03_11-02-08,fp7d
2021-05-11,VD,85,96,11,85,2022-05-03_11-02-08,fp7d
2021-05-11,VS,20,22,2,20,2022-05-03_11-02-08,fp7d
2021-05-11,ZG,8,8,0,8,2022-05-03_11-02-08,fp7d
2021-05-11,ZH,190,199,16,183,2022-05-03_11-02-08,fp7d
2021-05-12,AG,52,49,0,49,2022-05-03_11-02-08,fp7d
2021-05-12,AI,0,0,0,0,2022-05-03_11-02-08,fp7d
2021-05-12,AR,6,6,0,6,2022-05-03_11-02-08,fp7d
2021-05-12,BE,91,84,2,82,2022-05-03_11-02-08,fp7d
2021-05-12,BL,20,16,0,16,2022-05-03_11-02-08,fp7d
2021-05-12,BS,54,50,0,50,2022-05-03_11-02-08,fp7d
2021-05-12,FR,24,24,0,24,2022-05-03_11-02-08,fp7d
2021-05-12,GE,38,56,18,38,2022-05-03_11-02-08,fp7d
2021-05-12,GL,6,5,0,5,2022-05-03_11-02-08,fp7d
2021-05-12,GR,16,16,0,16,2022-05-03_11-02-08,fp7d
2021-05-12,JU,6,6,0,6,2022-05-03_11-02-08,fp7d
2021-05-12,LU,54,50,0,50,2022-05-03_11-02-08,fp7d
2021-05-12,NE,10,10,0,10,2022-05-03_11-02-08,fp7d
2021-05-12,NW,6,5,0,5,2022-05-03_11-02-08,fp7d
2021-05-12,OW,0,0,0,0,2022-05-03_11-02-08,fp7d
2021-05-12,SG,54,55,1,54,2022-05-03_11-02-08,fp7d
2021-05-12,SH,8,6,0,6,2022-05-03_11-02-08,fp7d
2021-05-12,SO,17,17,0,17,2022-05-03_11-02-08,fp7d
2021-05-12,SZ,12,12,0,12,2022-05-03_11-02-08,fp7d
2021-05-12,TG,21,28,7,21,2022-05-03_11-02-08,fp7d
2021-05-12,TI,53,74,21,53,2022-05-03_11-02-08,fp7d
2021-05-12,UR,6,6,0,6,2022-05-03_11-02-08,fp7d
2021-05-12,VD,85,96,11,85,2022-05-03_11-02-08,fp7d
2021-05-12,VS,20,22,2,20,2022-05-03_11-02-08,fp7d
2021-05-12,ZG,8,8,0,8,2022-05-03_11-02-08,fp7d
2021-05-12,ZH,190,198,16,182,2022-05-03_11-02-08,fp7d
2021-05-13,AG,52,49,0,49,2022-05-03_11-02-08,fp7d
2021-05-13,AI,0,0,0,0,2022-05-03_11-02-08,fp7d
2021-05-13,AR,6,6,0,6,2022-05-03_11-02-08,fp7d
2021-05-13,BE,91,84,2,82,2022-05-03_11-02-08,fp7d
2021-05-13,BL,20,16,0,16,2022-05-03_11-02-08,fp7d
2021-05-13,BS,54,46,0,46,2022-05-03_11-02-08,fp7d
2021-05-13,FR,24,24,0,24,2022-05-03_11-02-08,fp7d
2021-05-13,GE,38,56,18,38,2022-05-03_11-02-08,fp7d
2021-05-13,GL,6,5,0,5,2022-05-03_11-02-08,fp7d
2021-05-13,GR,16,16,0,16,2022-05-03_11-02-08,fp7d
2021-05-13,JU,6,6,0,6,2022-05-03_11-02-08,fp7d
2021-05-13,LU,54,50,0,50,2022-05-03_11-02-08,fp7d
2021-05-13,NE,10,10,0,10,2022-05-03_11-02-08,fp7d
2021-05-13,NW,6,5,0,5,2022-05-03_11-02-08,fp7d
2021-05-13,OW,0,0,0,0,2022-05-03_11-02-08,fp7d
2021-05-13,SG,54,55,1,54,2022-05-03_11-02-08,fp7d
2021-05-13,SH,8,6,0,6,2022-05-03_11-02-08,fp7d
2021-05-13,SO,17,17,0,17,2022-05-03_11-02-08,fp7d
2021-05-13,SZ,12,12,0,12,2022-05-03_11-02-08,fp7d
2021-05-13,TG,21,28,7,21,2022-05-03_11-02-08,fp7d
2021-05-13,TI,53,70,17,53,2022-05-03_11-02-08,fp7d
2021-05-13,UR,6,6,0,6,2022-05-03_11-02-08,fp7d
2021-05-13,VD,78,89,11,78,2022-05-03_11-02-08,fp7d
2021-05-13,VS,20,22,2,20,2022-05-03_11-02-08,fp7d
2021-05-13,ZG,8,8,0,8,2022-05-03_11-02-08,fp7d
2021-05-13,ZH,190,198,16,182,2022-05-03_11-02-08,fp7d
2021-05-14,AG,52,50,0,50,2022-05-03_11-02-08,fp7d
2021-05-14,AI,0,0,0,0,2022-05-03_11-02-08,fp7d
2021-05-14,AR,6,6,0,6,2022-05-03_11-02-08,fp7d
2021-05-14,BE,91,82,2,80,2022-05-03_11-02-08,fp7d
2021-05-14,BL,20,16,0,16,2022-05-03_11-02-08,fp7d
2021-05-14,BS,54,50,0,50,2022-05-03_11-02-08,fp7d
2021-05-14,FR,24,24,0,24,2022-05-03_11-02-08,fp7d
2021-05-14,GE,38,56,18,38,2022-05-03_11-02-08,fp7d
2021-05-14,GL,6,5,0,5,2022-05-03_11-02-08,fp7d
2021-05-14,GR,16,16,0,16,2022-05-03_11-02-08,fp7d
2021-05-14,JU,6,6,0,6,2022-05-03_11-02-08,fp7d
2021-05-14,LU,54,50,0,50,2022-05-03_11-02-08,fp7d
2021-05-14,NE,10,10,0,10,2022-05-03_11-02-08,fp7d
2021-05-14,NW,6,5,0,5,2022-05-03_11-02-08,fp7d
2021-05-14,OW,0,0,0,0,2022-05-03_11-02-08,fp7d
2021-05-14,SG,54,55,1,54,2022-05-03_11-02-08,fp7d
2021-05-14,SH,8,6,0,6,2022-05-03_11-02-08,fp7d
2021-05-14,SO,17,17,0,17,2022-05-03_11-02-08,fp7d
2021-05-14,SZ,12,12,0,12,2022-05-03_11-02-08,fp7d
2021-05-14,TG,21,28,7,21,2022-05-03_11-02-08,fp7d
2021-05-14,TI,53,70,17,53,2022-05-03_11-02-08,fp7d
2021-05-14,UR,6,6,0,6,2022-05-03_11-02-08,fp7d
2021-05-14,VD,78,89,11,78,2022-05-03_11-02-08,fp7d
2021-05-14,VS,20,22,2,20,2022-05-03_11-02-08,fp7d
2021-05-14,ZG,8,8,0,8,2022-05-03_11-02-08,fp7d
2021-05-14,ZH,190,197,16,181,2022-05-03_11-02-08,fp7d
2021-05-15,AG,52,50,0,50,2022-05-03_11-02-08,fp7d
2021-05-15,AI,0,0,0,0,2022-05-03_11-02-08,fp7d
2021-05-15,AR,6,6,0,6,2022-05-03_11-02-08,fp7d
2021-05-15,BE,91,81,2,79,2022-05-03_11-02-08,fp7d
2021-05-15,BL,20,16,0,16,2022-05-03_11-02-08,fp7d
2021-05-15,BS,54,46,0,46,2022-05-03_11-02-08,fp7d
2021-05-15,FR,24,24,0,24,2022-05-03_11-02-08,fp7d
2021-05-15,GE,38,56,18,38,2022-05-03_11-02-08,fp7d
2021-05-15,GL,6,5,0,5,2022-05-03_11-02-08,fp7d
2021-05-15,GR,16,16,0,16,2022-05-03_11-02-08,fp7d
2021-05-15,JU,6,6,0,6,2022-05-03_11-02-08,fp7d
2021-05-15,LU,54,50,0,50,2022-05-03_11-02-08,fp7d
2021-05-15,NE,10,10,0,10,2022-05-03_11-02-08,fp7d
2021-05-15,NW,6,5,0,5,2022-05-03_11-02-08,fp7d
2021-05-15,OW,0,0,0,0,2022-05-03_11-02-08,fp7d
2021-05-15,SG,54,55,1,54,2022-05-03_11-02-08,fp7d
2021-05-15,SH,8,6,0,6,2022-05-03_11-02-08,fp7d
2021-05-15,SO,17,17,0,17,2022-05-03_11-02-08,fp7d
2021-05-15,SZ,12,12,0,12,2022-05-03_11-02-08,fp7d
2021-05-15,TG,21,28,7,21,2022-05-03_11-02-08,fp7d
2021-05-15,TI,53,70,17,53,2022-05-03_11-02-08,fp7d
2021-05-15,UR,6,6,0,6,2022-05-03_11-02-08,fp7d
2021-05-15,VD,78,89,11,78,2022-05-03_11-02-08,fp7d
2021-05-15,VS,20,22,2,20,2022-05-03_11-02-08,fp7d
2021-05-15,ZG,8,8,0,8,2022-05-03_11-02-08,fp7d
2021-05-15,ZH,190,195,16,179,2022-05-03_11-02-08,fp7d
2021-05-16,AG,52,50,0,50,2022-05-03_11-02-08,fp7d
2021-05-16,AI,0,0,0,0,2022-05-03_11-02-08,fp7d
2021-05-16,AR,6,6,0,6,2022-05-03_11-02-08,fp7d
2021-05-16,BE,91,80,2,78,2022-05-03_11-02-08,fp7d
2021-05-16,BL,20,16,0,16,2022-05-03_11-02-08,fp7d
2021-05-16,BS,54,46,0,46,2022-05-03_11-02-08,fp7d
2021-05-16,FR,24,24,0,24,2022-05-03_11-02-08,fp7d
2021-05-16,GE,38,56,18,38,2022-05-03_11-02-08,fp7d
2021-05-16,GL,6,5,0,5,2022-05-03_11-02-08,fp7d
2021-05-16,GR,16,16,0,16,2022-05-03_11-02-08,fp7d
2021-05-16,JU,6,6,0,6,2022-05-03_11-02-08,fp7d
2021-05-16,LU,54,50,0,50,2022-05-03_11-02-08,fp7d
2021-05-16,NE,10,10,0,10,2022-05-03_11-02-08,fp7d
2021-05-16,NW,6,5,0,5,2022-05-03_11-02-08,fp7d
2021-05-16,OW,0,0,0,0,2022-05-03_11-02-08,fp7d
2021-05-16,SG,54,55,1,54,2022-05-03_11-02-08,fp7d
2021-05-16,SH,8,6,0,6,2022-05-03_11-02-08,fp7d
2021-05-16,SO,17,17,0,17,2022-05-03_11-02-08,fp7d
2021-05-16,SZ,12,12,0,12,2022-05-03_11-02-08,fp7d
2021-05-16,TG,21,28,7,21,2022-05-03_11-02-08,fp7d
2021-05-16,TI,53,70,17,53,2022-05-03_11-02-08,fp7d
2021-05-16,UR,6,6,0,6,2022-05-03_11-02-08,fp7d
2021-05-16,VD,78,89,11,78,2022-05-03_11-02-08,fp7d
2021-05-16,VS,20,22,2,20,2022-05-03_11-02-08,fp7d
2021-05-16,ZG,8,8,0,8,2022-05-03_11-02-08,fp7d
2021-05-16,ZH,190,195,16,179,2022-05-03_11-02-08,fp7d
2021-05-17,AG,52,50,0,50,2022-05-03_11-02-08,fp7d
2021-05-17,AI,0,0,0,0,2022-05-03_11-02-08,fp7d
2021-05-17,AR,6,6,0,6,2022-05-03_11-02-08,fp7d
2021-05-17,BE,91,83,2,81,2022-05-03_11-02-08,fp7d
2021-05-17,BL,20,16,0,16,2022-05-03_11-02-08,fp7d
2021-05-17,BS,54,50,0,50,2022-05-03_11-02-08,fp7d
2021-05-17,FR,24,24,0,24,2022-05-03_11-02-08,fp7d
2021-05-17,GE,38,56,18,38,2022-05-03_11-02-08,fp7d
2021-05-17,GL,6,6,0,6,2022-05-03_11-02-08,fp7d
2021-05-17,GR,16,16,0,16,2022-05-03_11-02-08,fp7d
2021-05-17,JU,6,6,0,6,2022-05-03_11-02-08,fp7d
2021-05-17,LU,54,50,0,50,2022-05-03_11-02-08,fp7d
2021-05-17,NE,10,10,0,10,2022-05-03_11-02-08,fp7d
2021-05-17,NW,6,5,0,5,2022-05-03_11-02-08,fp7d
2021-05-17,OW,0,0,0,0,2022-05-03_11-02-08,fp7d
2021-05-17,SG,54,55,1,54,2022-05-03_11-02-08,fp7d
2021-05-17,SH,8,6,0,6,2022-05-03_11-02-08,fp7d
2021-05-17,SO,17,17,0,17,2022-05-03_11-02-08,fp7d
2021-05-17,SZ,12,12,0,12,2022-05-03_11-02-08,fp7d
2021-05-17,TG,21,28,7,21,2022-05-03_11-02-08,fp7d
2021-05-17,TI,53,70,17,53,2022-05-03_11-02-08,fp7d
2021-05-17,UR,6,6,0,6,2022-05-03_11-02-08,fp7d
2021-05-17,VD,85,96,11,85,2022-05-03_11-02-08,fp7d
2021-05-17,VS,20,22,2,20,2022-05-03_11-02-08,fp7d
2021-05-17,ZG,8,8,0,8,2022-05-03_11-02-08,fp7d
2021-05-17,ZH,190,194,16,178,2022-05-03_11-02-08,fp7d
2021-05-18,AG,52,50,0,50,2022-05-03_11-02-08,fp7d
2021-05-18,AI,0,0,0,0,2022-05-03_11-02-08,fp7d
2021-05-18,AR,6,6,0,6,2022-05-03_11-02-08,fp7d
2021-05-18,BE,91,84,2,82,2022-05-03_11-02-08,fp7d
2021-05-18,BL,20,16,0,16,2022-05-03_11-02-08,fp7d
2021-05-18,BS,54,50,0,50,2022-05-03_11-02-08,fp7d
2021-05-18,FR,24,24,0,24,2022-05-03_11-02-08,fp7d
2021-05-18,GE,38,56,18,38,2022-05-03_11-02-08,fp7d
2021-05-18,GL,6,6,0,6,2022-05-03_11-02-08,fp7d
2021-05-18,GR,16,16,0,16,2022-05-03_11-02-08,fp7d
2021-05-18,JU,6,6,0,6,2022-05-03_11-02-08,fp7d
2021-05-18,LU,54,50,0,50,2022-05-03_11-02-08,fp7d
2021-05-18,NE,10,10,0,10,2022-05-03_11-02-08,fp7d
2021-05-18,NW,6,5,0,5,2022-05-03_11-02-08,fp7d
2021-05-18,OW,0,0,0,0,2022-05-03_11-02-08,fp7d
2021-05-18,SG,54,55,1,54,2022-05-03_11-02-08,fp7d
2021-05-18,SH,8,6,0,6,2022-05-03_11-02-08,fp7d
2021-05-18,SO,17,17,0,17,2022-05-03_11-02-08,fp7d
2021-05-18,SZ,12,12,0,12,2022-05-03_11-02-08,fp7d
2021-05-18,TG,21,28,7,21,2022-05-03_11-02-08,fp7d
2021-05-18,TI,53,70,17,53,2022-05-03_11-02-08,fp7d
2021-05-18,UR,6,6,0,6,2022-05-03_11-02-08,fp7d
2021-05-18,VD,85,96,11,85,2022-05-03_11-02-08,fp7d
2021-05-18,VS,20,22,2,20,2022-05-03_11-02-08,fp7d
2021-05-18,ZG,8,8,0,8,2022-05-03_11-02-08,fp7d
2021-05-18,ZH,190,194,16,178,2022-05-03_11-02-08,fp7d
2021-05-19,AG,52,50,0,50,2022-05-03_11-02-08,fp7d
2021-05-19,AI,0,0,0,0,2022-05-03_11-02-08,fp7d
2021-05-19,AR,6,6,0,6,2022-05-03_11-02-08,fp7d
2021-05-19,BE,91,84,2,82,2022-05-03_11-02-08,fp7d
2021-05-19,BL,20,16,0,16,2022-05-03_11-02-08,fp7d
2021-05-19,BS,54,50,0,50,2022-05-03_11-02-08,fp7d
2021-05-19,FR,24,24,0,24,2022-05-03_11-02-08,fp7d
2021-05-19,GE,38,56,18,38,2022-05-03_11-02-08,fp7d
2021-05-19,GL,6,6,0,6,2022-05-03_11-02-08,fp7d
2021-05-19,GR,16,16,0,16,2022-05-03_11-02-08,fp7d
2021-05-19,JU,6,6,0,6,2022-05-03_11-02-08,fp7d
2021-05-19,LU,54,52,2,50,2022-05-03_11-02-08,fp7d
2021-05-19,NE,10,10,0,10,2022-05-03_11-02-08,fp7d
2021-05-19,NW,6,5,0,5,2022-05-03_11-02-08,fp7d
2021-05-19,OW,0,0,0,0,2022-05-03_11-02-08,fp7d
2021-05-19,SG,54,55,1,54,2022-05-03_11-02-08,fp7d
2021-05-19,SH,8,6,0,6,2022-05-03_11-02-08,fp7d
2021-05-19,SO,17,17,0,17,2022-05-03_11-02-08,fp7d
2021-05-19,SZ,12,12,0,12,2022-05-03_11-02-08,fp7d
2021-05-19,TG,21,28,7,21,2022-05-03_11-02-08,fp7d
2021-05-19,TI,53,70,17,53,2022-05-03_11-02-08,fp7d
2021-05-19,UR,6,6,0,6,2022-05-03_11-02-08,fp7d
2021-05-19,VD,85,96,11,85,2022-05-03_11-02-08,fp7d
2021-05-19,VS,20,22,2,20,2022-05-03_11-02-08,fp7d
2021-05-19,ZG,8,8,0,8,2022-05-03_11-02-08,fp7d
2021-05-19,ZH,190,194,16,178,2022-05-03_11-02-08,fp7d
2021-05-20,AG,52,50,0,50,2022-05-03_11-02-08,fp7d
2021-05-20,AI,0,0,0,0,2022-05-03_11-02-08,fp7d
2021-05-20,AR,6,6,0,6,2022-05-03_11-02-08,fp7d
2021-05-20,BE,91,84,2,82,2022-05-03_11-02-08,fp7d
2021-05-20,BL,20,16,0,16,2022-05-03_11-02-08,fp7d
2021-05-20,BS,54,50,0,50,2022-05-03_11-02-08,fp7d
2021-05-20,FR,24,24,0,24,2022-05-03_11-02-08,fp7d
2021-05-20,GE,38,56,18,38,2022-05-03_11-02-08,fp7d
2021-05-20,GL,6,6,0,6,2022-05-03_11-02-08,fp7d
2021-05-20,GR,16,16,0,16,2022-05-03_11-02-08,fp7d
2021-05-20,JU,6,6,0,6,2022-05-03_11-02-08,fp7d
2021-05-20,LU,54,52,2,50,2022-05-03_11-02-08,fp7d
2021-05-20,NE,10,10,0,10,2022-05-03_11-02-08,fp7d
2021-05-20,NW,6,5,0,5,2022-05-03_11-02-08,fp7d
2021-05-20,OW,0,0,0,0,2022-05-03_11-02-08,fp7d
2021-05-20,SG,54,55,1,54,2022-05-03_11-02-08,fp7d
2021-05-20,SH,8,6,0,6,2022-05-03_11-02-08,fp7d
2021-05-20,SO,17,17,0,17,2022-05-03_11-02-08,fp7d
2021-05-20,SZ,12,12,0,12,2022-05-03_11-02-08,fp7d
2021-05-20,TG,21,28,7,21,2022-05-03_11-02-08,fp7d
2021-05-20,TI,53,70,17,53,2022-05-03_11-02-08,fp7d
2021-05-20,UR,6,6,0,6,2022-05-03_11-02-08,fp7d
2021-05-20,VD,85,86,1,85,2022-05-03_11-02-08,fp7d
2021-05-20,VS,20,22,2,20,2022-05-03_11-02-08,fp7d
2021-05-20,ZG,8,8,0,8,2022-05-03_11-02-08,fp7d
2021-05-20,ZH,190,197,18,179,2022-05-03_11-02-08,fp7d
2021-05-21,AG,52,50,0,50,2022-05-03_11-02-08,fp7d
2021-05-21,AI,0,0,0,0,2022-05-03_11-02-08,fp7d
2021-05-21,AR,6,6,0,6,2022-05-03_11-02-08,fp7d
2021-05-21,BE,91,82,2,80,2022-05-03_11-02-08,fp7d
2021-05-21,BL,20,16,0,16,2022-05-03_11-02-08,fp7d
2021-05-21,BS,54,50,0,50,2022-05-03_11-02-08,fp7d
2021-05-21,FR,24,24,0,24,2022-05-03_11-02-08,fp7d
2021-05-21,GE,38,56,18,38,2022-05-03_11-02-08,fp7d
2021-05-21,GL,6,6,0,6,2022-05-03_11-02-08,fp7d
2021-05-21,GR,16,16,0,16,2022-05-03_11-02-08,fp7d
2021-05-21,JU,6,6,0,6,2022-05-03_11-02-08,fp7d
2021-05-21,LU,54,52,2,50,2022-05-03_11-02-08,fp7d
2021-05-21,NE,10,10,0,10,2022-05-03_11-02-08,fp7d
2021-05-21,NW,6,5,0,5,2022-05-03_11-02-08,fp7d
2021-05-21,OW,0,0,0,0,2022-05-03_11-02-08,fp7d
2021-05-21,SG,54,55,1,54,2022-05-03_11-02-08,fp7d
2021-05-21,SH,8,6,0,6,2022-05-03_11-02-08,fp7d
2021-05-21,SO,17,17,0,17,2022-05-03_11-02-08,fp7d
2021-05-21,SZ,12,12,0,12,2022-05-03_11-02-08,fp7d
2021-05-21,TG,21,28,7,21,2022-05-03_11-02-08,fp7d
2021-05-21,TI,53,70,17,53,2022-05-03_11-02-08,fp7d
2021-05-21,UR,6,6,0,6,2022-05-03_11-02-08,fp7d
2021-05-21,VD,85,86,1,85,2022-05-03_11-02-08,fp7d
2021-05-21,VS,20,22,2,20,2022-05-03_11-02-08,fp7d
2021-05-21,ZG,8,8,0,8,2022-05-03_11-02-08,fp7d
2021-05-21,ZH,190,196,18,178,2022-05-03_11-02-08,fp7d
2021-05-22,AG,52,50,0,50,2022-05-03_11-02-08,fp7d
2021-05-22,AI,0,0,0,0,2022-05-03_11-02-08,fp7d
2021-05-22,AR,6,6,0,6,2022-05-03_11-02-08,fp7d
2021-05-22,BE,91,80,2,78,2022-05-03_11-02-08,fp7d
2021-05-22,BL,20,16,0,16,2022-05-03_11-02-08,fp7d
2021-05-22,BS,54,46,0,46,2022-05-03_11-02-08,fp7d
2021-05-22,FR,24,24,0,24,2022-05-03_11-02-08,fp7d
2021-05-22,GE,38,56,18,38,2022-05-03_11-02-08,fp7d
2021-05-22,GL,6,6,0,6,2022-05-03_11-02-08,fp7d
2021-05-22,GR,16,16,0,16,2022-05-03_11-02-08,fp7d
2021-05-22,JU,6,6,0,6,2022-05-03_11-02-08,fp7d
2021-05-22,LU,54,50,0,50,2022-05-03_11-02-08,fp7d
2021-05-22,NE,10,10,0,10,2022-05-03_11-02-08,fp7d
2021-05-22,NW,6,5,0,5,2022-05-03_11-02-08,fp7d
2021-05-22,OW,0,0,0,0,2022-05-03_11-02-08,fp7d
2021-05-22,SG,54,55,1,54,2022-05-03_11-02-08,fp7d
2021-05-22,SH,8,6,0,6,2022-05-03_11-02-08,fp7d
2021-05-22,SO,17,17,0,17,2022-05-03_11-02-08,fp7d
2021-05-22,SZ,12,12,0,12,2022-05-03_11-02-08,fp7d
2021-05-22,TG,21,28,7,21,2022-05-03_11-02-08,fp7d
2021-05-22,TI,53,68,15,53,2022-05-03_11-02-08,fp7d
2021-05-22,UR,6,6,0,6,2022-05-03_11-02-08,fp7d
2021-05-22,VD,85,86,1,85,2022-05-03_11-02-08,fp7d
2021-05-22,VS,20,22,2,20,2022-05-03_11-02-08,fp7d
2021-05-22,ZG,8,8,0,8,2022-05-03_11-02-08,fp7d
2021-05-22,ZH,190,195,17,178,2022-05-03_11-02-08,fp7d
2021-05-23,AG,52,50,0,50,2022-05-03_11-02-08,fp7d
2021-05-23,AI,0,0,0,0,2022-05-03_11-02-08,fp7d
2021-05-23,AR,6,6,0,6,2022-05-03_11-02-08,fp7d
2021-05-23,BE,91,80,2,78,2022-05-03_11-02-08,fp7d
2021-05-23,BL,20,16,0,16,2022-05-03_11-02-08,fp7d
2021-05-23,BS,54,46,0,46,2022-05-03_11-02-08,fp7d
2021-05-23,FR,24,24,0,24,2022-05-03_11-02-08,fp7d
2021-05-23,GE,38,56,18,38,2022-05-03_11-02-08,fp7d
2021-05-23,GL,6,6,0,6,2022-05-03_11-02-08,fp7d
2021-05-23,GR,16,16,0,16,2022-05-03_11-02-08,fp7d
2021-05-23,JU,6,6,0,6,2022-05-03_11-02-08,fp7d
2021-05-23,LU,54,50,0,50,2022-05-03_11-02-08,fp7d
2021-05-23,NE,10,10,0,10,2022-05-03_11-02-08,fp7d
2021-05-23,NW,6,5,0,5,2022-05-03_11-02-08,fp7d
2021-05-23,OW,0,0,0,0,2022-05-03_11-02-08,fp7d
2021-05-23,SG,54,55,1,54,2022-05-03_11-02-08,fp7d
2021-05-23,SH,8,6,0,6,2022-05-03_11-02-08,fp7d
2021-05-23,SO,17,17,0,17,2022-05-03_11-02-08,fp7d
2021-05-23,SZ,12,12,0,12,2022-05-03_11-02-08,fp7d
2021-05-23,TG,21,28,7,21,2022-05-03_11-02-08,fp7d
2021-05-23,TI,53,68,15,53,2022-05-03_11-02-08,fp7d
2021-05-23,UR,6,6,0,6,2022-05-03_11-02-08,fp7d
2021-05-23,VD,85,86,1,85,2022-05-03_11-02-08,fp7d
2021-05-23,VS,20,22,2,20,2022-05-03_11-02-08,fp7d
2021-05-23,ZG,8,8,0,8,2022-05-03_11-02-08,fp7d
2021-05-23,ZH,190,194,16,178,2022-05-03_11-02-08,fp7d
2021-05-24,AG,52,50,0,50,2022-05-03_11-02-08,fp7d
2021-05-24,AI,0,0,0,0,2022-05-03_11-02-08,fp7d
2021-05-24,AR,6,6,0,6,2022-05-03_11-02-08,fp7d
2021-05-24,BE,91,80,2,78,2022-05-03_11-02-08,fp7d
2021-05-24,BL,20,16,0,16,2022-05-03_11-02-08,fp7d
2021-05-24,BS,54,46,0,46,2022-05-03_11-02-08,fp7d
2021-05-24,FR,24,24,0,24,2022-05-03_11-02-08,fp7d
2021-05-24,GE,38,56,18,38,2022-05-03_11-02-08,fp7d
2021-05-24,GL,6,6,0,6,2022-05-03_11-02-08,fp7d
2021-05-24,GR,16,16,0,16,2022-05-03_11-02-08,fp7d
2021-05-24,JU,6,6,0,6,2022-05-03_11-02-08,fp7d
2021-05-24,LU,54,50,0,50,2022-05-03_11-02-08,fp7d
2021-05-24,NE,10,10,0,10,2022-05-03_11-02-08,fp7d
2021-05-24,NW,6,5,0,5,2022-05-03_11-02-08,fp7d
2021-05-24,OW,0,0,0,0,2022-05-03_11-02-08,fp7d
2021-05-24,SG,54,55,1,54,2022-05-03_11-02-08,fp7d
2021-05-24,SH,8,6,0,6,2022-05-03_11-02-08,fp7d
2021-05-24,SO,17,17,0,17,2022-05-03_11-02-08,fp7d
2021-05-24,SZ,12,12,0,12,2022-05-03_11-02-08,fp7d
2021-05-24,TG,21,28,7,21,2022-05-03_11-02-08,fp7d
2021-05-24,TI,53,68,15,53,2022-05-03_11-02-08,fp7d
2021-05-24,UR,6,6,0,6,2022-05-03_11-02-08,fp7d
2021-05-24,VD,85,86,1,85,2022-05-03_11-02-08,fp7d
2021-05-24,VS,20,22,2,20,2022-05-03_11-02-08,fp7d
2021-05-24,ZG,8,8,0,8,2022-05-03_11-02-08,fp7d
2021-05-24,ZH,190,194,16,178,2022-05-03_11-02-08,fp7d
2021-05-25,AG,52,50,0,50,2022-05-03_11-02-08,fp7d
2021-05-25,AI,0,0,0,0,2022-05-03_11-02-08,fp7d
2021-05-25,AR,6,6,0,6,2022-05-03_11-02-08,fp7d
2021-05-25,BE,91,82,2,80,2022-05-03_11-02-08,fp7d
2021-05-25,BL,20,16,0,16,2022-05-03_11-02-08,fp7d
2021-05-25,BS,54,50,0,50,2022-05-03_11-02-08,fp7d
2021-05-25,FR,24,24,0,24,2022-05-03_11-02-08,fp7d
2021-05-25,GE,38,56,18,38,2022-05-03_11-02-08,fp7d
2021-05-25,GL,6,6,0,6,2022-05-03_11-02-08,fp7d
2021-05-25,GR,16,16,0,16,2022-05-03_11-02-08,fp7d
2021-05-25,JU,6,6,0,6,2022-05-03_11-02-08,fp7d
2021-05-25,LU,54,52,2,50,2022-05-03_11-02-08,fp7d
2021-05-25,NE,10,10,0,10,2022-05-03_11-02-08,fp7d
2021-05-25,NW,6,5,0,5,2022-05-03_11-02-08,fp7d
2021-05-25,OW,0,0,0,0,2022-05-03_11-02-08,fp7d
2021-05-25,SG,54,55,1,54,2022-05-03_11-02-08,fp7d
2021-05-25,SH,8,6,0,6,2022-05-03_11-02-08,fp7d
2021-05-25,SO,17,17,0,17,2022-05-03_11-02-08,fp7d
2021-05-25,SZ,12,12,0,12,2022-05-03_11-02-08,fp7d
2021-05-25,TG,21,28,7,21,2022-05-03_11-02-08,fp7d
2021-05-25,TI,53,68,15,53,2022-05-03_11-02-08,fp7d
2021-05-25,UR,6,6,0,6,2022-05-03_11-02-08,fp7d
2021-05-25,VD,85,86,1,85,2022-05-03_11-02-08,fp7d
2021-05-25,VS,20,22,2,20,2022-05-03_11-02-08,fp7d
2021-05-25,ZG,8,8,0,8,2022-05-03_11-02-08,fp7d
2021-05-25,ZH,190,198,19,179,2022-05-03_11-02-08,fp7d
2021-05-26,AG,52,50,0,50,2022-05-03_11-02-08,fp7d
2021-05-26,AI,0,0,0,0,2022-05-03_11-02-08,fp7d
2021-05-26,AR,6,6,0,6,2022-05-03_11-02-08,fp7d
2021-05-26,BE,91,84,2,82,2022-05-03_11-02-08,fp7d
2021-05-26,BL,20,16,0,16,2022-05-03_11-02-08,fp7d
2021-05-26,BS,54,50,0,50,2022-05-03_11-02-08,fp7d
2021-05-26,FR,24,24,0,24,2022-05-03_11-02-08,fp7d
2021-05-26,GE,38,56,18,38,2022-05-03_11-02-08,fp7d
2021-05-26,GL,6,6,0,6,2022-05-03_11-02-08,fp7d
2021-05-26,GR,16,16,0,16,2022-05-03_11-02-08,fp7d
2021-05-26,JU,6,6,0,6,2022-05-03_11-02-08,fp7d
2021-05-26,LU,54,52,2,50,2022-05-03_11-02-08,fp7d
2021-05-26,NE,10,10,0,10,2022-05-03_11-02-08,fp7d
2021-05-26,NW,6,5,0,5,2022-05-03_11-02-08,fp7d
2021-05-26,OW,0,0,0,0,2022-05-03_11-02-08,fp7d
2021-05-26,SG,54,55,1,54,2022-05-03_11-02-08,fp7d
2021-05-26,SH,8,6,0,6,2022-05-03_11-02-08,fp7d
2021-05-26,SO,17,17,0,17,2022-05-03_11-02-08,fp7d
2021-05-26,SZ,12,12,0,12,2022-05-03_11-02-08,fp7d
2021-05-26,TG,21,28,7,21,2022-05-03_11-02-08,fp7d
2021-05-26,TI,44,59,15,44,2022-05-03_11-02-08,fp7d
2021-05-26,UR,6,6,0,6,2022-05-03_11-02-08,fp7d
2021-05-26,VD,85,86,1,85,2022-05-03_11-02-08,fp7d
2021-05-26,VS,20,22,2,20,2022-05-03_11-02-08,fp7d
2021-05-26,ZG,8,8,0,8,2022-05-03_11-02-08,fp7d
2021-05-26,ZH,190,196,16,180,2022-05-03_11-02-08,fp7d
2021-05-27,AG,52,50,0,50,2022-05-03_11-02-08,fp7d
2021-05-27,AI,0,0,0,0,2022-05-03_11-02-08,fp7d
2021-05-27,AR,6,6,0,6,2022-05-03_11-02-08,fp7d
2021-05-27,BE,91,84,2,82,2022-05-03_11-02-08,fp7d
2021-05-27,BL,20,16,0,16,2022-05-03_11-02-08,fp7d
2021-05-27,BS,54,50,0,50,2022-05-03_11-02-08,fp7d
2021-05-27,FR,24,24,0,24,2022-05-03_11-02-08,fp7d
2021-05-27,GE,38,56,18,38,2022-05-03_11-02-08,fp7d
2021-05-27,GL,6,6,0,6,2022-05-03_11-02-08,fp7d
2021-05-27,GR,16,16,0,16,2022-05-03_11-02-08,fp7d
2021-05-27,JU,6,6,0,6,2022-05-03_11-02-08,fp7d
2021-05-27,LU,54,52,2,50,2022-05-03_11-02-08,fp7d
2021-05-27,NE,10,10,0,10,2022-05-03_11-02-08,fp7d
2021-05-27,NW,6,5,0,5,2022-05-03_11-02-08,fp7d
2021-05-27,OW,0,0,0,0,2022-05-03_11-02-08,fp7d
2021-05-27,SG,54,55,1,54,2022-05-03_11-02-08,fp7d
2021-05-27,SH,8,6,0,6,2022-05-03_11-02-08,fp7d
2021-05-27,SO,17,17,0,17,2022-05-03_11-02-08,fp7d
2021-05-27,SZ,12,12,0,12,2022-05-03_11-02-08,fp7d
2021-05-27,TG,21,28,7,21,2022-05-03_11-02-08,fp7d
2021-05-27,TI,44,59,15,44,2022-05-03_11-02-08,fp7d
2021-05-27,UR,6,6,0,6,2022-05-03_11-02-08,fp7d
2021-05-27,VD,85,86,1,85,2022-05-03_11-02-08,fp7d
2021-05-27,VS,20,22,2,20,2022-05-03_11-02-08,fp7d
2021-05-27,ZG,8,8,0,8,2022-05-03_11-02-08,fp7d
2021-05-27,ZH,190,197,17,180,2022-05-03_11-02-08,fp7d
2021-05-28,AG,52,50,0,50,2022-05-03_11-02-08,fp7d
2021-05-28,AI,0,0,0,0,2022-05-03_11-02-08,fp7d
2021-05-28,AR,6,6,0,6,2022-05-03_11-02-08,fp7d
2021-05-28,BE,91,84,2,82,2022-05-03_11-02-08,fp7d
2021-05-28,BL,20,16,0,16,2022-05-03_11-02-08,fp7d
2021-05-28,BS,54,50,0,50,2022-05-03_11-02-08,fp7d
2021-05-28,FR,24,24,0,24,2022-05-03_11-02-08,fp7d
2021-05-28,GE,38,56,18,38,2022-05-03_11-02-08,fp7d
2021-05-28,GL,6,6,0,6,2022-05-03_11-02-08,fp7d
2021-05-28,GR,16,16,0,16,2022-05-03_11-02-08,fp7d
2021-05-28,JU,6,6,0,6,2022-05-03_11-02-08,fp7d
2021-05-28,LU,54,52,2,50,2022-05-03_11-02-08,fp7d
2021-05-28,NE,10,10,0,10,2022-05-03_11-02-08,fp7d
2021-05-28,NW,6,5,0,5,2022-05-03_11-02-08,fp7d
2021-05-28,OW,0,0,0,0,2022-05-03_11-02-08,fp7d
2021-05-28,SG,54,55,1,54,2022-05-03_11-02-08,fp7d
2021-05-28,SH,8,6,0,6,2022-05-03_11-02-08,fp7d
2021-05-28,SO,17,17,0,17,2022-05-03_11-02-08,fp7d
2021-05-28,SZ,12,12,0,12,2022-05-03_11-02-08,fp7d
2021-05-28,TG,21,26,7,19,2022-05-03_11-02-08,fp7d
2021-05-28,TI,53,68,15,53,2022-05-03_11-02-08,fp7d
2021-05-28,UR,6,6,0,6,2022-05-03_11-02-08,fp7d
2021-05-28,VD,85,86,1,85,2022-05-03_11-02-08,fp7d
2021-05-28,VS,20,22,2,20,2022-05-03_11-02-08,fp7d
2021-05-28,ZG,8,8,0,8,2022-05-03_11-02-08,fp7d
2021-05-28,ZH,190,196,16,180,2022-05-03_11-02-08,fp7d
2021-05-29,AG,52,50,0,50,2022-05-03_11-02-08,fp7d
2021-05-29,AI,0,0,0,0,2022-05-03_11-02-08,fp7d
2021-05-29,AR,6,6,0,6,2022-05-03_11-02-08,fp7d
2021-05-29,BE,91,82,2,80,2022-05-03_11-02-08,fp7d
2021-05-29,BL,20,16,0,16,2022-05-03_11-02-08,fp7d
2021-05-29,BS,54,46,0,46,2022-05-03_11-02-08,fp7d
2021-05-29,FR,24,24,0,24,2022-05-03_11-02-08,fp7d
2021-05-29,GE,38,56,18,38,2022-05-03_11-02-08,fp7d
2021-05-29,GL,6,6,0,6,2022-05-03_11-02-08,fp7d
2021-05-29,GR,16,16,0,16,2022-05-03_11-02-08,fp7d
2021-05-29,JU,6,6,0,6,2022-05-03_11-02-08,fp7d
2021-05-29,LU,54,52,2,50,2022-05-03_11-02-08,fp7d
2021-05-29,NE,10,10,0,10,2022-05-03_11-02-08,fp7d
2021-05-29,NW,6,5,0,5,2022-05-03_11-02-08,fp7d
2021-05-29,OW,0,0,0,0,2022-05-03_11-02-08,fp7d
2021-05-29,SG,54,55,1,54,2022-05-03_11-02-08,fp7d
2021-05-29,SH,8,6,0,6,2022-05-03_11-02-08,fp7d
2021-05-29,SO,17,17,0,17,2022-05-03_11-02-08,fp7d
2021-05-29,SZ,12,12,0,12,2022-05-03_11-02-08,fp7d
2021-05-29,TG,21,24,7,17,2022-05-03_11-02-08,fp7d
2021-05-29,TI,53,68,15,53,2022-05-03_11-02-08,fp7d
2021-05-29,UR,6,6,0,6,2022-05-03_11-02-08,fp7d
2021-05-29,VD,85,86,1,85,2022-05-03_11-02-08,fp7d
2021-05-29,VS,20,22,2,20,2022-05-03_11-02-08,fp7d
2021-05-29,ZG,8,8,0,8,2022-05-03_11-02-08,fp7d
2021-05-29,ZH,190,195,15,180,2022-05-03_11-02-08,fp7d
2021-05-30,AG,52,50,0,50,2022-05-03_11-02-08,fp7d
2021-05-30,AI,0,0,0,0,2022-05-03_11-02-08,fp7d
2021-05-30,AR,6,6,0,6,2022-05-03_11-02-08,fp7d
2021-05-30,BE,91,81,2,79,2022-05-03_11-02-08,fp7d
2021-05-30,BL,20,16,0,16,2022-05-03_11-02-08,fp7d
2021-05-30,BS,54,46,0,46,2022-05-03_11-02-08,fp7d
2021-05-30,FR,24,24,0,24,2022-05-03_11-02-08,fp7d
2021-05-30,GE,38,56,18,38,2022-05-03_11-02-08,fp7d
2021-05-30,GL,6,6,0,6,2022-05-03_11-02-08,fp7d
2021-05-30,GR,16,16,0,16,2022-05-03_11-02-08,fp7d
2021-05-30,JU,6,6,0,6,2022-05-03_11-02-08,fp7d
2021-05-30,LU,54,50,0,50,2022-05-03_11-02-08,fp7d
2021-05-30,NE,10,10,0,10,2022-05-03_11-02-08,fp7d
2021-05-30,NW,6,5,0,5,2022-05-03_11-02-08,fp7d
2021-05-30,OW,0,0,0,0,2022-05-03_11-02-08,fp7d
2021-05-30,SG,54,55,1,54,2022-05-03_11-02-08,fp7d
2021-05-30,SH,8,6,0,6,2022-05-03_11-02-08,fp7d
2021-05-30,SO,17,17,0,17,2022-05-03_11-02-08,fp7d
2021-05-30,SZ,12,12,0,12,2022-05-03_11-02-08,fp7d
2021-05-30,TG,21,24,7,17,2022-05-03_11-02-08,fp7d
2021-05-30,TI,53,68,15,53,2022-05-03_11-02-08,fp7d
2021-05-30,UR,6,6,0,6,2022-05-03_11-02-08,fp7d
2021-05-30,VD,85,86,1,85,2022-05-03_11-02-08,fp7d
2021-05-30,VS,20,22,2,20,2022-05-03_11-02-08,fp7d
2021-05-30,ZG,8,8,0,8,2022-05-03_11-02-08,fp7d
2021-05-30,ZH,190,197,17,180,2022-05-03_11-02-08,fp7d
2021-05-31,AG,52,50,0,50,2022-05-03_11-02-08,fp7d
2021-05-31,AI,0,0,0,0,2022-05-03_11-02-08,fp7d
2021-05-31,AR,6,6,0,6,2022-05-03_11-02-08,fp7d
2021-05-31,BE,91,81,2,79,2022-05-03_11-02-08,fp7d
2021-05-31,BL,20,16,0,16,2022-05-03_11-02-08,fp7d
2021-05-31,BS,54,50,0,50,2022-05-03_11-02-08,fp7d
2021-05-31,FR,24,24,0,24,2022-05-03_11-02-08,fp7d
2021-05-31,GE,38,56,18,38,2022-05-03_11-02-08,fp7d
2021-05-31,GL,6,6,0,6,2022-05-03_11-02-08,fp7d
2021-05-31,GR,16,16,0,16,2022-05-03_11-02-08,fp7d
2021-05-31,JU,6,6,0,6,2022-05-03_11-02-08,fp7d
2021-05-31,LU,54,50,0,50,2022-05-03_11-02-08,fp7d
2021-05-31,NE,10,10,0,10,2022-05-03_11-02-08,fp7d
2021-05-31,NW,6,4,0,4,2022-05-03_11-02-08,fp7d
2021-05-31,OW,0,0,0,0,2022-05-03_11-02-08,fp7d
2021-05-31,SG,54,55,1,54,2022-05-03_11-02-08,fp7d
2021-05-31,SH,8,6,0,6,2022-05-03_11-02-08,fp7d
2021-05-31,SO,17,17,0,17,2022-05-03_11-02-08,fp7d
2021-05-31,SZ,12,12,0,12,2022-05-03_11-02-08,fp7d
2021-05-31,TG,21,24,7,17,2022-05-03_11-02-08,fp7d
2021-05-31,TI,53,68,15,53,2022-05-03_11-02-08,fp7d
2021-05-31,UR,6,6,0,6,2022-05-03_11-02-08,fp7d
2021-05-31,VD,85,86,1,85,2022-05-03_11-02-08,fp7d
2021-05-31,VS,20,22,2,20,2022-05-03_11-02-08,fp7d
2021-05-31,ZG,8,8,0,8,2022-05-03_11-02-08,fp7d
2021-05-31,ZH,190,196,17,179,2022-05-03_11-02-08,fp7d
2021-06-01,AG,52,50,0,50,2022-05-03_11-02-08,fp7d
2021-06-01,AI,0,0,0,0,2022-05-03_11-02-08,fp7d
2021-06-01,AR,6,6,0,6,2022-05-03_11-02-08,fp7d
2021-06-01,BE,92,81,2,79,2022-05-03_11-02-08,fp7d
2021-06-01,BL,20,16,0,16,2022-05-03_11-02-08,fp7d
2021-06-01,BS,54,50,0,50,2022-05-03_11-02-08,fp7d
2021-06-01,FR,24,24,0,24,2022-05-03_11-02-08,fp7d
2021-06-01,GE,38,56,18,38,2022-05-03_11-02-08,fp7d
2021-06-01,GL,6,6,0,6,2022-05-03_11-02-08,fp7d
2021-06-01,GR,16,16,0,16,2022-05-03_11-02-08,fp7d
2021-06-01,JU,6,6,0,6,2022-05-03_11-02-08,fp7d
2021-06-01,LU,54,50,0,50,2022-05-03_11-02-08,fp7d
2021-06-01,NE,10,10,0,10,2022-05-03_11-02-08,fp7d
2021-06-01,NW,6,4,0,4,2022-05-03_11-02-08,fp7d
2021-06-01,OW,0,0,0,0,2022-05-03_11-02-08,fp7d
2021-06-01,SG,54,55,1,54,2022-05-03_11-02-08,fp7d
2021-06-01,SH,8,7,0,7,2022-05-03_11-02-08,fp7d
2021-06-01,SO,17,17,0,17,2022-05-03_11-02-08,fp7d
2021-06-01,SZ,12,12,0,12,2022-05-03_11-02-08,fp7d
2021-06-01,TG,21,25,7,18,2022-05-03_11-02-08,fp7d
2021-06-01,TI,53,68,15,53,2022-05-03_11-02-08,fp7d
2021-06-01,UR,6,6,0,6,2022-05-03_11-02-08,fp7d
2021-06-01,VD,85,86,1,85,2022-05-03_11-02-08,fp7d
2021-06-01,VS,20,22,2,20,2022-05-03_11-02-08,fp7d
2021-06-01,ZG,8,8,0,8,2022-05-03_11-02-08,fp7d
2021-06-01,ZH,190,197,16,181,2022-05-03_11-02-08,fp7d
2021-06-02,AG,52,50,0,50,2022-05-03_11-02-08,fp7d
2021-06-02,AI,0,0,0,0,2022-05-03_11-02-08,fp7d
2021-06-02,AR,6,6,0,6,2022-05-03_11-02-08,fp7d
2021-06-02,BE,104,91,2,89,2022-05-03_11-02-08,fp7d
2021-06-02,BL,20,16,0,16,2022-05-03_11-02-08,fp7d
2021-06-02,BS,54,50,0,50,2022-05-03_11-02-08,fp7d
2021-06-02,FR,24,24,0,24,2022-05-03_11-02-08,fp7d
2021-06-02,GE,38,56,18,38,2022-05-03_11-02-08,fp7d
2021-06-02,GL,6,6,0,6,2022-05-03_11-02-08,fp7d
2021-06-02,GR,16,16,0,16,2022-05-03_11-02-08,fp7d
2021-06-02,JU,6,6,0,6,2022-05-03_11-02-08,fp7d
2021-06-02,LU,54,50,0,50,2022-05-03_11-02-08,fp7d
2021-06-02,NE,10,10,0,10,2022-05-03_11-02-08,fp7d
2021-06-02,NW,6,4,0,4,2022-05-03_11-02-08,fp7d
2021-06-02,OW,0,0,0,0,2022-05-03_11-02-08,fp7d
2021-06-02,SG,54,55,1,54,2022-05-03_11-02-08,fp7d
2021-06-02,SH,8,7,0,7,2022-05-03_11-02-08,fp7d
2021-06-02,SO,17,17,0,17,2022-05-03_11-02-08,fp7d
2021-06-02,SZ,12,12,0,12,2022-05-03_11-02-08,fp7d
2021-06-02,TG,21,25,7,18,2022-05-03_11-02-08,fp7d
2021-06-02,TI,53,68,15,53,2022-05-03_11-02-08,fp7d
2021-06-02,UR,6,6,0,6,2022-05-03_11-02-08,fp7d
2021-06-02,VD,85,86,1,85,2022-05-03_11-02-08,fp7d
2021-06-02,VS,20,22,2,20,2022-05-03_11-02-08,fp7d
2021-06-02,ZG,8,8,0,8,2022-05-03_11-02-08,fp7d
2021-06-02,ZH,190,193,16,177,2022-05-03_11-02-08,fp7d
2021-06-03,AG,52,50,0,50,2022-05-03_11-02-08,fp7d
2021-06-03,AI,0,0,0,0,2022-05-03_11-02-08,fp7d
2021-06-03,AR,6,6,0,6,2022-05-03_11-02-08,fp7d
2021-06-03,BE,104,91,2,89,2022-05-03_11-02-08,fp7d
2021-06-03,BL,20,16,0,16,2022-05-03_11-02-08,fp7d
2021-06-03,BS,54,50,0,50,2022-05-03_11-02-08,fp7d
2021-06-03,FR,24,24,0,24,2022-05-03_11-02-08,fp7d
2021-06-03,GE,38,56,18,38,2022-05-03_11-02-08,fp7d
2021-06-03,GL,6,6,0,6,2022-05-03_11-02-08,fp7d
2021-06-03,GR,16,16,0,16,2022-05-03_11-02-08,fp7d
2021-06-03,JU,6,6,0,6,2022-05-03_11-02-08,fp7d
2021-06-03,LU,54,48,0,48,2022-05-03_11-02-08,fp7d
2021-06-03,NE,10,10,0,10,2022-05-03_11-02-08,fp7d
2021-06-03,NW,6,6,0,6,2022-05-03_11-02-08,fp7d
2021-06-03,OW,0,0,0,0,2022-05-03_11-02-08,fp7d
2021-06-03,SG,54,55,1,54,2022-05-03_11-02-08,fp7d
2021-06-03,SH,8,7,0,7,2022-05-03_11-02-08,fp7d
2021-06-03,SO,17,17,0,17,2022-05-03_11-02-08,fp7d
2021-06-03,SZ,12,12,0,12,2022-05-03_11-02-08,fp7d
2021-06-03,TG,21,25,7,18,2022-05-03_11-02-08,fp7d
2021-06-03,TI,53,68,15,53,2022-05-03_11-02-08,fp7d
2021-06-03,UR,6,6,0,6,2022-05-03_11-02-08,fp7d
2021-06-03,VD,85,86,1,85,2022-05-03_11-02-08,fp7d
2021-06-03,VS,14,14,0,14,2022-05-03_11-02-08,fp7d
2021-06-03,ZG,8,8,0,8,2022-05-03_11-02-08,fp7d
2021-06-03,ZH,190,195,16,179,2022-05-03_11-02-08,fp7d
2021-06-04,AG,52,50,0,50,2022-05-03_11-02-08,fp7d
2021-06-04,AI,0,0,0,0,2022-05-03_11-02-08,fp7d
2021-06-04,AR,6,6,0,6,2022-05-03_11-02-08,fp7d
2021-06-04,BE,104,91,2,89,2022-05-03_11-02-08,fp7d
2021-06-04,BL,20,16,0,16,2022-05-03_11-02-08,fp7d
2021-06-04,BS,54,50,0,50,2022-05-03_11-02-08,fp7d
2021-06-04,FR,24,24,0,24,2022-05-03_11-02-08,fp7d
2021-06-04,GE,38,56,18,38,2022-05-03_11-02-08,fp7d
2021-06-04,GL,6,6,0,6,2022-05-03_11-02-08,fp7d
2021-06-04,GR,16,16,0,16,2022-05-03_11-02-08,fp7d
2021-06-04,JU,6,6,0,6,2022-05-03_11-02-08,fp7d
2021-06-04,LU,54,48,0,48,2022-05-03_11-02-08,fp7d
2021-06-04,NE,10,10,0,10,2022-05-03_11-02-08,fp7d
2021-06-04,NW,6,6,0,6,2022-05-03_11-02-08,fp7d
2021-06-04,OW,0,0,0,0,2022-05-03_11-02-08,fp7d
2021-06-04,SG,54,55,1,54,2022-05-03_11-02-08,fp7d
2021-06-04,SH,8,7,0,7,2022-05-03_11-02-08,fp7d
2021-06-04,SO,17,17,0,17,2022-05-03_11-02-08,fp7d
2021-06-04,SZ,12,12,0,12,2022-05-03_11-02-08,fp7d
2021-06-04,TG,21,25,7,18,2022-05-03_11-02-08,fp7d
2021-06-04,TI,53,68,15,53,2022-05-03_11-02-08,fp7d
2021-06-04,UR,6,6,0,6,2022-05-03_11-02-08,fp7d
2021-06-04,VD,85,86,1,85,2022-05-03_11-02-08,fp7d
2021-06-04,VS,20,22,2,20,2022-05-03_11-02-08,fp7d
2021-06-04,ZG,8,8,0,8,2022-05-03_11-02-08,fp7d
2021-06-04,ZH,190,195,16,179,2022-05-03_11-02-08,fp7d
2021-06-05,AG,52,50,0,50,2022-05-03_11-02-08,fp7d
2021-06-05,AI,0,0,0,0,2022-05-03_11-02-08,fp7d
2021-06-05,AR,6,6,0,6,2022-05-03_11-02-08,fp7d
2021-06-05,BE,104,89,2,87,2022-05-03_11-02-08,fp7d
2021-06-05,BL,20,16,0,16,2022-05-03_11-02-08,fp7d
2021-06-05,BS,54,46,0,46,2022-05-03_11-02-08,fp7d
2021-06-05,FR,24,24,0,24,2022-05-03_11-02-08,fp7d
2021-06-05,GE,38,56,18,38,2022-05-03_11-02-08,fp7d
2021-06-05,GL,6,6,0,6,2022-05-03_11-02-08,fp7d
2021-06-05,GR,16,16,0,16,2022-05-03_11-02-08,fp7d
2021-06-05,JU,6,6,0,6,2022-05-03_11-02-08,fp7d
2021-06-05,LU,54,50,0,50,2022-05-03_11-02-08,fp7d
2021-06-05,NE,10,10,0,10,2022-05-03_11-02-08,fp7d
2021-06-05,NW,6,6,0,6,2022-05-03_11-02-08,fp7d
2021-06-05,OW,0,0,0,0,2022-05-03_11-02-08,fp7d
2021-06-05,SG,54,55,1,54,2022-05-03_11-02-08,fp7d
2021-06-05,SH,8,7,0,7,2022-05-03_11-02-08,fp7d
2021-06-05,SO,17,17,0,17,2022-05-03_11-02-08,fp7d
2021-06-05,SZ,12,12,0,12,2022-05-03_11-02-08,fp7d
2021-06-05,TG,21,25,7,18,2022-05-03_11-02-08,fp7d
2021-06-05,TI,53,68,15,53,2022-05-03_11-02-08,fp7d
2021-06-05,UR,6,6,0,6,2022-05-03_11-02-08,fp7d
2021-06-05,VD,85,86,1,85,2022-05-03_11-02-08,fp7d
2021-06-05,VS,20,22,2,20,2022-05-03_11-02-08,fp7d
2021-06-05,ZG,8,8,0,8,2022-05-03_11-02-08,fp7d
2021-06-05,ZH,190,195,16,179,2022-05-03_11-02-08,fp7d
2021-06-06,AG,52,50,0,50,2022-05-03_11-02-08,fp7d
2021-06-06,AI,0,0,0,0,2022-05-03_11-02-08,fp7d
2021-06-06,AR,6,6,0,6,2022-05-03_11-02-08,fp7d
2021-06-06,BE,104,89,2,87,2022-05-03_11-02-08,fp7d
2021-06-06,BL,20,16,0,16,2022-05-03_11-02-08,fp7d
2021-06-06,BS,54,46,0,46,2022-05-03_11-02-08,fp7d
2021-06-06,FR,24,24,0,24,2022-05-03_11-02-08,fp7d
2021-06-06,GE,38,56,18,38,2022-05-03_11-02-08,fp7d
2021-06-06,GL,6,6,0,6,2022-05-03_11-02-08,fp7d
2021-06-06,GR,16,16,0,16,2022-05-03_11-02-08,fp7d
2021-06-06,JU,6,6,0,6,2022-05-03_11-02-08,fp7d
2021-06-06,LU,54,50,0,50,2022-05-03_11-02-08,fp7d
2021-06-06,NE,10,10,0,10,2022-05-03_11-02-08,fp7d
2021-06-06,NW,6,6,0,6,2022-05-03_11-02-08,fp7d
2021-06-06,OW,0,0,0,0,2022-05-03_11-02-08,fp7d
2021-06-06,SG,54,55,1,54,2022-05-03_11-02-08,fp7d
2021-06-06,SH,8,7,0,7,2022-05-03_11-02-08,fp7d
2021-06-06,SO,17,17,0,17,2022-05-03_11-02-08,fp7d
2021-06-06,SZ,12,12,0,12,2022-05-03_11-02-08,fp7d
2021-06-06,TG,21,25,7,18,2022-05-03_11-02-08,fp7d
2021-06-06,TI,53,68,15,53,2022-05-03_11-02-08,fp7d
2021-06-06,UR,6,6,0,6,2022-05-03_11-02-08,fp7d
2021-06-06,VD,85,86,1,85,2022-05-03_11-02-08,fp7d
2021-06-06,VS,20,22,2,20,2022-05-03_11-02-08,fp7d
2021-06-06,ZG,8,8,0,8,2022-05-03_11-02-08,fp7d
2021-06-06,ZH,190,194,16,178,2022-05-03_11-02-08,fp7d
2021-06-07,AG,52,50,0,50,2022-05-03_11-02-08,fp7d
2021-06-07,AI,0,0,0,0,2022-05-03_11-02-08,fp7d
2021-06-07,AR,6,6,0,6,2022-05-03_11-02-08,fp7d
2021-06-07,BE,104,91,2,89,2022-05-03_11-02-08,fp7d
2021-06-07,BL,20,16,0,16,2022-05-03_11-02-08,fp7d
2021-06-07,BS,54,46,0,46,2022-05-03_11-02-08,fp7d
2021-06-07,FR,24,24,0,24,2022-05-03_11-02-08,fp7d
2021-06-07,GE,38,50,12,38,2022-05-03_11-02-08,fp7d
2021-06-07,GL,6,6,0,6,2022-05-03_11-02-08,fp7d
2021-06-07,GR,16,16,0,16,2022-05-03_11-02-08,fp7d
2021-06-07,JU,6,6,0,6,2022-05-03_11-02-08,fp7d
2021-06-07,LU,54,52,2,50,2022-05-03_11-02-08,fp7d
2021-06-07,NE,10,10,0,10,2022-05-03_11-02-08,fp7d
2021-06-07,NW,6,5,0,5,2022-05-03_11-02-08,fp7d
2021-06-07,OW,0,0,0,0,2022-05-03_11-02-08,fp7d
2021-06-07,SG,54,55,1,54,2022-05-03_11-02-08,fp7d
2021-06-07,SH,8,7,0,7,2022-05-03_11-02-08,fp7d
2021-06-07,SO,17,17,0,17,2022-05-03_11-02-08,fp7d
2021-06-07,SZ,12,12,0,12,2022-05-03_11-02-08,fp7d
2021-06-07,TG,21,25,7,18,2022-05-03_11-02-08,fp7d
2021-06-07,TI,53,68,15,53,2022-05-03_11-02-08,fp7d
2021-06-07,UR,6,6,0,6,2022-05-03_11-02-08,fp7d
2021-06-07,VD,85,86,1,85,2022-05-03_11-02-08,fp7d
2021-06-07,VS,20,22,2,20,2022-05-03_11-02-08,fp7d
2021-06-07,ZG,8,8,0,8,2022-05-03_11-02-08,fp7d
2021-06-07,ZH,190,196,17,179,2022-05-03_11-02-08,fp7d
2021-06-08,AG,52,50,0,50,2022-05-03_11-02-08,fp7d
2021-06-08,AI,0,0,0,0,2022-05-03_11-02-08,fp7d
2021-06-08,AR,6,6,0,6,2022-05-03_11-02-08,fp7d
2021-06-08,BE,104,91,2,89,2022-05-03_11-02-08,fp7d
2021-06-08,BL,20,16,0,16,2022-05-03_11-02-08,fp7d
2021-06-08,BS,54,50,0,50,2022-05-03_11-02-08,fp7d
2021-06-08,FR,24,24,0,24,2022-05-03_11-02-08,fp7d
2021-06-08,GE,38,50,12,38,2022-05-03_11-02-08,fp7d
2021-06-08,GL,6,6,0,6,2022-05-03_11-02-08,fp7d
2021-06-08,GR,16,16,0,16,2022-05-03_11-02-08,fp7d
2021-06-08,JU,6,6,0,6,2022-05-03_11-02-08,fp7d
2021-06-08,LU,54,52,2,50,2022-05-03_11-02-08,fp7d
2021-06-08,NE,10,10,0,10,2022-05-03_11-02-08,fp7d
2021-06-08,NW,6,6,0,6,2022-05-03_11-02-08,fp7d
2021-06-08,OW,0,0,0,0,2022-05-03_11-02-08,fp7d
2021-06-08,SG,54,55,1,54,2022-05-03_11-02-08,fp7d
2021-06-08,SH,8,7,0,7,2022-05-03_11-02-08,fp7d
2021-06-08,SO,17,17,0,17,2022-05-03_11-02-08,fp7d
2021-06-08,SZ,12,12,0,12,2022-05-03_11-02-08,fp7d
2021-06-08,TG,21,25,7,18,2022-05-03_11-02-08,fp7d
2021-06-08,TI,53,68,15,53,2022-05-03_11-02-08,fp7d
2021-06-08,UR,6,6,0,6,2022-05-03_11-02-08,fp7d
2021-06-08,VD,85,86,1,85,2022-05-03_11-02-08,fp7d
2021-06-08,VS,20,22,2,20,2022-05-03_11-02-08,fp7d
2021-06-08,ZG,8,8,0,8,2022-05-03_11-02-08,fp7d
2021-06-08,ZH,190,196,16,180,2022-05-03_11-02-08,fp7d
2021-06-09,AG,52,50,0,50,2022-05-03_11-02-08,fp7d
2021-06-09,AI,0,0,0,0,2022-05-03_11-02-08,fp7d
2021-06-09,AR,6,6,0,6,2022-05-03_11-02-08,fp7d
2021-06-09,BE,104,91,2,89,2022-05-03_11-02-08,fp7d
2021-06-09,BL,20,16,0,16,2022-05-03_11-02-08,fp7d
2021-06-09,BS,54,50,0,50,2022-05-03_11-02-08,fp7d
2021-06-09,FR,24,24,0,24,2022-05-03_11-02-08,fp7d
2021-06-09,GE,38,50,12,38,2022-05-03_11-02-08,fp7d
2021-06-09,GL,6,6,0,6,2022-05-03_11-02-08,fp7d
2021-06-09,GR,16,16,0,16,2022-05-03_11-02-08,fp7d
2021-06-09,JU,6,6,0,6,2022-05-03_11-02-08,fp7d
2021-06-09,LU,54,52,2,50,2022-05-03_11-02-08,fp7d
2021-06-09,NE,10,10,0,10,2022-05-03_11-02-08,fp7d
2021-06-09,NW,6,6,0,6,2022-05-03_11-02-08,fp7d
2021-06-09,OW,0,0,0,0,2022-05-03_11-02-08,fp7d
2021-06-09,SG,54,55,1,54,2022-05-03_11-02-08,fp7d
2021-06-09,SH,8,7,0,7,2022-05-03_11-02-08,fp7d
2021-06-09,SO,17,17,0,17,2022-05-03_11-02-08,fp7d
2021-06-09,SZ,12,12,0,12,2022-05-03_11-02-08,fp7d
2021-06-09,TG,21,24,7,17,2022-05-03_11-02-08,fp7d
2021-06-09,TI,53,68,15,53,2022-05-03_11-02-08,fp7d
2021-06-09,UR,6,6,0,6,2022-05-03_11-02-08,fp7d
2021-06-09,VD,85,86,1,85,2022-05-03_11-02-08,fp7d
2021-06-09,VS,20,22,2,20,2022-05-03_11-02-08,fp7d
2021-06-09,ZG,8,8,0,8,2022-05-03_11-02-08,fp7d
2021-06-09,ZH,190,197,17,180,2022-05-03_11-02-08,fp7d
2021-06-10,AG,52,50,0,50,2022-05-03_11-02-08,fp7d
2021-06-10,AI,0,0,0,0,2022-05-03_11-02-08,fp7d
2021-06-10,AR,6,6,0,6,2022-05-03_11-02-08,fp7d
2021-06-10,BE,104,91,2,89,2022-05-03_11-02-08,fp7d
2021-06-10,BL,20,16,0,16,2022-05-03_11-02-08,fp7d
2021-06-10,BS,54,50,0,50,2022-05-03_11-02-08,fp7d
2021-06-10,FR,24,24,0,24,2022-05-03_11-02-08,fp7d
2021-06-10,GE,38,50,12,38,2022-05-03_11-02-08,fp7d
2021-06-10,GL,6,6,0,6,2022-05-03_11-02-08,fp7d
2021-06-10,GR,16,16,0,16,2022-05-03_11-02-08,fp7d
2021-06-10,JU,6,6,0,6,2022-05-03_11-02-08,fp7d
2021-06-10,LU,54,52,2,50,2022-05-03_11-02-08,fp7d
2021-06-10,NE,10,10,0,10,2022-05-03_11-02-08,fp7d
2021-06-10,NW,6,6,0,6,2022-05-03_11-02-08,fp7d
2021-06-10,OW,0,0,0,0,2022-05-03_11-02-08,fp7d
2021-06-10,SG,54,55,1,54,2022-05-03_11-02-08,fp7d
2021-06-10,SH,8,7,0,7,2022-05-03_11-02-08,fp7d
2021-06-10,SO,17,17,0,17,2022-05-03_11-02-08,fp7d
2021-06-10,SZ,12,12,0,12,2022-05-03_11-02-08,fp7d
2021-06-10,TG,21,24,7,17,2022-05-03_11-02-08,fp7d
2021-06-10,TI,53,68,15,53,2022-05-03_11-02-08,fp7d
2021-06-10,UR,6,6,0,6,2022-05-03_11-02-08,fp7d
2021-06-10,VD,85,86,1,85,2022-05-03_11-02-08,fp7d
2021-06-10,VS,20,22,2,20,2022-05-03_11-02-08,fp7d
2021-06-10,ZG,8,8,0,8,2022-05-03_11-02-08,fp7d
2021-06-10,ZH,190,198,17,181,2022-05-03_11-02-08,fp7d
2021-06-11,AG,52,50,0,50,2022-05-03_11-02-08,fp7d
2021-06-11,AI,0,0,0,0,2022-05-03_11-02-08,fp7d
2021-06-11,AR,6,6,0,6,2022-05-03_11-02-08,fp7d
2021-06-11,BE,104,91,2,89,2022-05-03_11-02-08,fp7d
2021-06-11,BL,20,16,0,16,2022-05-03_11-02-08,fp7d
2021-06-11,BS,54,50,0,50,2022-05-03_11-02-08,fp7d
2021-06-11,FR,24,24,0,24,2022-05-03_11-02-08,fp7d
2021-06-11,GE,38,50,12,38,2022-05-03_11-02-08,fp7d
2021-06-11,GL,6,6,0,6,2022-05-03_11-02-08,fp7d
2021-06-11,GR,16,16,0,16,2022-05-03_11-02-08,fp7d
2021-06-11,JU,6,6,0,6,2022-05-03_11-02-08,fp7d
2021-06-11,LU,54,52,2,50,2022-05-03_11-02-08,fp7d
2021-06-11,NE,10,10,0,10,2022-05-03_11-02-08,fp7d
2021-06-11,NW,6,6,0,6,2022-05-03_11-02-08,fp7d
2021-06-11,OW,0,0,0,0,2022-05-03_11-02-08,fp7d
2021-06-11,SG,54,55,1,54,2022-05-03_11-02-08,fp7d
2021-06-11,SH,8,7,0,7,2022-05-03_11-02-08,fp7d
2021-06-11,SO,17,17,0,17,2022-05-03_11-02-08,fp7d
2021-06-11,SZ,12,12,0,12,2022-05-03_11-02-08,fp7d
2021-06-11,TG,21,24,7,17,2022-05-03_11-02-08,fp7d
2021-06-11,TI,53,68,15,53,2022-05-03_11-02-08,fp7d
2021-06-11,UR,6,6,0,6,2022-05-03_11-02-08,fp7d
2021-06-11,VD,85,86,1,85,2022-05-03_11-02-08,fp7d
2021-06-11,VS,20,22,2,20,2022-05-03_11-02-08,fp7d
2021-06-11,ZG,8,8,0,8,2022-05-03_11-02-08,fp7d
2021-06-11,ZH,190,195,16,179,2022-05-03_11-02-08,fp7d
2021-06-12,AG,52,50,0,50,2022-05-03_11-02-08,fp7d
2021-06-12,AI,0,0,0,0,2022-05-03_11-02-08,fp7d
2021-06-12,AR,6,6,0,6,2022-05-03_11-02-08,fp7d
2021-06-12,BE,104,91,2,89,2022-05-03_11-02-08,fp7d
2021-06-12,BL,20,16,0,16,2022-05-03_11-02-08,fp7d
2021-06-12,BS,54,46,0,46,2022-05-03_11-02-08,fp7d
2021-06-12,FR,24,24,0,24,2022-05-03_11-02-08,fp7d
2021-06-12,GE,38,50,12,38,2022-05-03_11-02-08,fp7d
2021-06-12,GL,6,6,0,6,2022-05-03_11-02-08,fp7d
2021-06-12,GR,16,16,0,16,2022-05-03_11-02-08,fp7d
2021-06-12,JU,6,6,0,6,2022-05-03_11-02-08,fp7d
2021-06-12,LU,54,52,2,50,2022-05-03_11-02-08,fp7d
2021-06-12,NE,10,10,0,10,2022-05-03_11-02-08,fp7d
2021-06-12,NW,6,6,0,6,2022-05-03_11-02-08,fp7d
2021-06-12,OW,0,0,0,0,2022-05-03_11-02-08,fp7d
2021-06-12,SG,54,55,1,54,2022-05-03_11-02-08,fp7d
2021-06-12,SH,8,7,0,7,2022-05-03_11-02-08,fp7d
2021-06-12,SO,17,17,0,17,2022-05-03_11-02-08,fp7d
2021-06-12,SZ,12,12,0,12,2022-05-03_11-02-08,fp7d
2021-06-12,TG,21,24,7,17,2022-05-03_11-02-08,fp7d
2021-06-12,TI,53,68,15,53,2022-05-03_11-02-08,fp7d
2021-06-12,UR,6,6,0,6,2022-05-03_11-02-08,fp7d
2021-06-12,VD,85,86,1,85,2022-05-03_11-02-08,fp7d
2021-06-12,VS,20,22,2,20,2022-05-03_11-02-08,fp7d
2021-06-12,ZG,8,8,0,8,2022-05-03_11-02-08,fp7d
2021-06-12,ZH,190,194,17,177,2022-05-03_11-02-08,fp7d
2021-06-13,AG,52,50,0,50,2022-05-03_11-02-08,fp7d
2021-06-13,AI,0,0,0,0,2022-05-03_11-02-08,fp7d
2021-06-13,AR,6,6,0,6,2022-05-03_11-02-08,fp7d
2021-06-13,BE,104,91,2,89,2022-05-03_11-02-08,fp7d
2021-06-13,BL,20,16,0,16,2022-05-03_11-02-08,fp7d
2021-06-13,BS,54,46,0,46,2022-05-03_11-02-08,fp7d
2021-06-13,FR,24,24,0,24,2022-05-03_11-02-08,fp7d
2021-06-13,GE,38,50,12,38,2022-05-03_11-02-08,fp7d
2021-06-13,GL,6,6,0,6,2022-05-03_11-02-08,fp7d
2021-06-13,GR,16,16,0,16,2022-05-03_11-02-08,fp7d
2021-06-13,JU,6,6,0,6,2022-05-03_11-02-08,fp7d
2021-06-13,LU,54,52,2,50,2022-05-03_11-02-08,fp7d
2021-06-13,NE,10,10,0,10,2022-05-03_11-02-08,fp7d
2021-06-13,NW,6,6,0,6,2022-05-03_11-02-08,fp7d
2021-06-13,OW,0,0,0,0,2022-05-03_11-02-08,fp7d
2021-06-13,SG,54,55,1,54,2022-05-03_11-02-08,fp7d
2021-06-13,SH,8,7,0,7,2022-05-03_11-02-08,fp7d
2021-06-13,SO,17,17,0,17,2022-05-03_11-02-08,fp7d
2021-06-13,SZ,12,12,0,12,2022-05-03_11-02-08,fp7d
2021-06-13,TG,21,24,7,17,2022-05-03_11-02-08,fp7d
2021-06-13,TI,53,68,15,53,2022-05-03_11-02-08,fp7d
2021-06-13,UR,6,6,0,6,2022-05-03_11-02-08,fp7d
2021-06-13,VD,85,86,1,85,2022-05-03_11-02-08,fp7d
2021-06-13,VS,20,22,2,20,2022-05-03_11-02-08,fp7d
2021-06-13,ZG,8,8,0,8,2022-05-03_11-02-08,fp7d
2021-06-13,ZH,190,192,17,175,2022-05-03_11-02-08,fp7d
2021-06-14,AG,52,50,0,50,2022-05-03_11-02-08,fp7d
2021-06-14,AI,0,0,0,0,2022-05-03_11-02-08,fp7d
2021-06-14,AR,6,6,0,6,2022-05-03_11-02-08,fp7d
2021-06-14,BE,104,92,2,90,2022-05-03_11-02-08,fp7d
2021-06-14,BL,20,16,0,16,2022-05-03_11-02-08,fp7d
2021-06-14,BS,54,50,0,50,2022-05-03_11-02-08,fp7d
2021-06-14,FR,24,24,0,24,2022-05-03_11-02-08,fp7d
2021-06-14,GE,38,56,18,38,2022-05-03_11-02-08,fp7d
2021-06-14,GL,6,6,0,6,2022-05-03_11-02-08,fp7d
2021-06-14,GR,16,16,0,16,2022-05-03_11-02-08,fp7d
2021-06-14,JU,6,6,0,6,2022-05-03_11-02-08,fp7d
2021-06-14,LU,54,50,0,50,2022-05-03_11-02-08,fp7d
2021-06-14,NE,10,10,0,10,2022-05-03_11-02-08,fp7d
2021-06-14,NW,6,6,0,6,2022-05-03_11-02-08,fp7d
2021-06-14,OW,0,0,0,0,2022-05-03_11-02-08,fp7d
2021-06-14,SG,54,55,1,54,2022-05-03_11-02-08,fp7d
2021-06-14,SH,8,8,0,8,2022-05-03_11-02-08,fp7d
2021-06-14,SO,17,17,0,17,2022-05-03_11-02-08,fp7d
2021-06-14,SZ,12,12,0,12,2022-05-03_11-02-08,fp7d
2021-06-14,TG,21,24,7,17,2022-05-03_11-02-08,fp7d
2021-06-14,TI,53,68,15,53,2022-05-03_11-02-08,fp7d
2021-06-14,UR,6,6,0,6,2022-05-03_11-02-08,fp7d
2021-06-14,VD,85,86,1,85,2022-05-03_11-02-08,fp7d
2021-06-14,VS,20,22,2,20,2022-05-03_11-02-08,fp7d
2021-06-14,ZG,8,8,0,8,2022-05-03_11-02-08,fp7d
2021-06-14,ZH,190,192,17,175,2022-05-03_11-02-08,fp7d
2021-06-15,AG,52,50,0,50,2022-05-03_11-02-08,fp7d
2021-06-15,AI,0,0,0,0,2022-05-03_11-02-08,fp7d
2021-06-15,AR,6,6,0,6,2022-05-03_11-02-08,fp7d
2021-06-15,BE,103,92,2,90,2022-05-03_11-02-08,fp7d
2021-06-15,BL,20,16,0,16,2022-05-03_11-02-08,fp7d
2021-06-15,BS,54,50,0,50,2022-05-03_11-02-08,fp7d
2021-06-15,FR,24,24,0,24,2022-05-03_11-02-08,fp7d
2021-06-15,GE,38,56,18,38,2022-05-03_11-02-08,fp7d
2021-06-15,GL,6,6,0,6,2022-05-03_11-02-08,fp7d
2021-06-15,GR,16,16,0,16,2022-05-03_11-02-08,fp7d
2021-06-15,JU,6,6,0,6,2022-05-03_11-02-08,fp7d
2021-06-15,LU,54,50,0,50,2022-05-03_11-02-08,fp7d
2021-06-15,NE,10,10,0,10,2022-05-03_11-02-08,fp7d
2021-06-15,NW,6,6,0,6,2022-05-03_11-02-08,fp7d
2021-06-15,OW,0,0,0,0,2022-05-03_11-02-08,fp7d
2021-06-15,SG,54,55,1,54,2022-05-03_11-02-08,fp7d
2021-06-15,SH,8,8,0,8,2022-05-03_11-02-08,fp7d
2021-06-15,SO,17,17,0,17,2022-05-03_11-02-08,fp7d
2021-06-15,SZ,12,12,0,12,2022-05-03_11-02-08,fp7d
2021-06-15,TG,21,24,7,17,2022-05-03_11-02-08,fp7d
2021-06-15,TI,53,68,15,53,2022-05-03_11-02-08,fp7d
2021-06-15,UR,6,6,0,6,2022-05-03_11-02-08,fp7d
2021-06-15,VD,85,86,1,85,2022-05-03_11-02-08,fp7d
2021-06-15,VS,20,22,2,20,2022-05-03_11-02-08,fp7d
2021-06-15,ZG,8,8,0,8,2022-05-03_11-02-08,fp7d
2021-06-15,ZH,190,190,15,175,2022-05-03_11-02-08,fp7d
2021-06-16,AG,52,50,0,50,2022-05-03_11-02-08,fp7d
2021-06-16,AI,0,0,0,0,2022-05-03_11-02-08,fp7d
2021-06-16,AR,6,6,0,6,2022-05-03_11-02-08,fp7d
2021-06-16,BE,103,91,2,89,2022-05-03_11-02-08,fp7d
2021-06-16,BL,20,16,0,16,2022-05-03_11-02-08,fp7d
2021-06-16,BS,54,50,0,50,2022-05-03_11-02-08,fp7d
2021-06-16,FR,24,24,0,24,2022-05-03_11-02-08,fp7d
2021-06-16,GE,38,56,18,38,2022-05-03_11-02-08,fp7d
2021-06-16,GL,6,6,0,6,2022-05-03_11-02-08,fp7d
2021-06-16,GR,16,16,0,16,2022-05-03_11-02-08,fp7d
2021-06-16,JU,6,6,0,6,2022-05-03_11-02-08,fp7d
2021-06-16,LU,54,52,2,50,2022-05-03_11-02-08,fp7d
2021-06-16,NE,10,10,0,10,2022-05-03_11-02-08,fp7d
2021-06-16,NW,6,6,0,6,2022-05-03_11-02-08,fp7d
2021-06-16,OW,0,0,0,0,2022-05-03_11-02-08,fp7d
2021-06-16,SG,54,55,1,54,2022-05-03_11-02-08,fp7d
2021-06-16,SH,8,8,0,8,2022-05-03_11-02-08,fp7d
2021-06-16,SO,17,17,0,17,2022-05-03_11-02-08,fp7d
2021-06-16,SZ,12,11,0,11,2022-05-03_11-02-08,fp7d
2021-06-16,TG,21,24,7,17,2022-05-03_11-02-08,fp7d
2021-06-16,TI,53,68,15,53,2022-05-03_11-02-08,fp7d
2021-06-16,UR,6,6,0,6,2022-05-03_11-02-08,fp7d
2021-06-16,VD,78,79,1,78,2022-05-03_11-02-08,fp7d
2021-06-16,VS,20,22,2,20,2022-05-03_11-02-08,fp7d
2021-06-16,ZG,8,8,0,8,2022-05-03_11-02-08,fp7d
2021-06-16,ZH,190,192,15,177,2022-05-03_11-02-08,fp7d
2021-06-17,AG,52,50,0,50,2022-05-03_11-02-08,fp7d
2021-06-17,AI,0,0,0,0,2022-05-03_11-02-08,fp7d
2021-06-17,AR,6,6,0,6,2022-05-03_11-02-08,fp7d
2021-06-17,BE,103,91,2,89,2022-05-03_11-02-08,fp7d
2021-06-17,BL,20,16,0,16,2022-05-03_11-02-08,fp7d
2021-06-17,BS,54,50,0,50,2022-05-03_11-02-08,fp7d
2021-06-17,FR,24,24,0,24,2022-05-03_11-02-08,fp7d
2021-06-17,GE,38,56,18,38,2022-05-03_11-02-08,fp7d
2021-06-17,GL,6,6,0,6,2022-05-03_11-02-08,fp7d
2021-06-17,GR,16,16,0,16,2022-05-03_11-02-08,fp7d
2021-06-17,JU,6,6,0,6,2022-05-03_11-02-08,fp7d
2021-06-17,LU,54,52,2,50,2022-05-03_11-02-08,fp7d
2021-06-17,NE,10,10,0,10,2022-05-03_11-02-08,fp7d
2021-06-17,NW,6,6,0,6,2022-05-03_11-02-08,fp7d
2021-06-17,OW,0,0,0,0,2022-05-03_11-02-08,fp7d
2021-06-17,SG,54,55,1,54,2022-05-03_11-02-08,fp7d
2021-06-17,SH,8,8,0,8,2022-05-03_11-02-08,fp7d
2021-06-17,SO,17,17,0,17,2022-05-03_11-02-08,fp7d
2021-06-17,SZ,12,11,0,11,2022-05-03_11-02-08,fp7d
2021-06-17,TG,21,24,7,17,2022-05-03_11-02-08,fp7d
2021-06-17,TI,53,68,15,53,2022-05-03_11-02-08,fp7d
2021-06-17,UR,6,6,0,6,2022-05-03_11-02-08,fp7d
2021-06-17,VD,85,86,1,85,2022-05-03_11-02-08,fp7d
2021-06-17,VS,20,22,2,20,2022-05-03_11-02-08,fp7d
2021-06-17,ZG,8,8,0,8,2022-05-03_11-02-08,fp7d
2021-06-17,ZH,190,192,15,177,2022-05-03_11-02-08,fp7d
2021-06-18,AG,52,50,0,50,2022-05-03_11-02-08,fp7d
2021-06-18,AI,0,0,0,0,2022-05-03_11-02-08,fp7d
2021-06-18,AR,6,6,0,6,2022-05-03_11-02-08,fp7d
2021-06-18,BE,103,91,2,89,2022-05-03_11-02-08,fp7d
2021-06-18,BL,20,16,0,16,2022-05-03_11-02-08,fp7d
2021-06-18,BS,54,50,0,50,2022-05-03_11-02-08,fp7d
2021-06-18,FR,24,24,0,24,2022-05-03_11-02-08,fp7d
2021-06-18,GE,38,56,18,38,2022-05-03_11-02-08,fp7d
2021-06-18,GL,6,6,0,6,2022-05-03_11-02-08,fp7d
2021-06-18,GR,16,16,0,16,2022-05-03_11-02-08,fp7d
2021-06-18,JU,6,6,0,6,2022-05-03_11-02-08,fp7d
2021-06-18,LU,54,52,2,50,2022-05-03_11-02-08,fp7d
2021-06-18,NE,10,10,0,10,2022-05-03_11-02-08,fp7d
2021-06-18,NW,6,6,0,6,2022-05-03_11-02-08,fp7d
2021-06-18,OW,0,0,0,0,2022-05-03_11-02-08,fp7d
2021-06-18,SG,54,55,1,54,2022-05-03_11-02-08,fp7d
2021-06-18,SH,8,8,0,8,2022-05-03_11-02-08,fp7d
2021-06-18,SO,17,17,0,17,2022-05-03_11-02-08,fp7d
2021-06-18,SZ,12,11,0,11,2022-05-03_11-02-08,fp7d
2021-06-18,TG,21,25,8,17,2022-05-03_11-02-08,fp7d
2021-06-18,TI,53,68,15,53,2022-05-03_11-02-08,fp7d
2021-06-18,UR,6,6,0,6,2022-05-03_11-02-08,fp7d
2021-06-18,VD,85,86,1,85,2022-05-03_11-02-08,fp7d
2021-06-18,VS,20,22,2,20,2022-05-03_11-02-08,fp7d
2021-06-18,ZG,8,8,0,8,2022-05-03_11-02-08,fp7d
2021-06-18,ZH,190,195,15,180,2022-05-03_11-02-08,fp7d
2021-06-19,AG,52,50,0,50,2022-05-03_11-02-08,fp7d
2021-06-19,AI,0,0,0,0,2022-05-03_11-02-08,fp7d
2021-06-19,AR,6,6,0,6,2022-05-03_11-02-08,fp7d
2021-06-19,BE,103,89,2,87,2022-05-03_11-02-08,fp7d
2021-06-19,BL,20,16,0,16,2022-05-03_11-02-08,fp7d
2021-06-19,BS,54,50,0,50,2022-05-03_11-02-08,fp7d
2021-06-19,FR,24,24,0,24,2022-05-03_11-02-08,fp7d
2021-06-19,GE,38,56,18,38,2022-05-03_11-02-08,fp7d
2021-06-19,GL,6,6,0,6,2022-05-03_11-02-08,fp7d
2021-06-19,GR,16,16,0,16,2022-05-03_11-02-08,fp7d
2021-06-19,JU,6,6,0,6,2022-05-03_11-02-08,fp7d
2021-06-19,LU,54,50,0,50,2022-05-03_11-02-08,fp7d
2021-06-19,NE,10,10,0,10,2022-05-03_11-02-08,fp7d
2021-06-19,NW,6,6,0,6,2022-05-03_11-02-08,fp7d
2021-06-19,OW,0,0,0,0,2022-05-03_11-02-08,fp7d
2021-06-19,SG,54,55,1,54,2022-05-03_11-02-08,fp7d
2021-06-19,SH,8,8,0,8,2022-05-03_11-02-08,fp7d
2021-06-19,SO,17,17,0,17,2022-05-03_11-02-08,fp7d
2021-06-19,SZ,12,11,0,11,2022-05-03_11-02-08,fp7d
2021-06-19,TG,21,25,8,17,2022-05-03_11-02-08,fp7d
2021-06-19,TI,53,68,15,53,2022-05-03_11-02-08,fp7d
2021-06-19,UR,6,6,0,6,2022-05-03_11-02-08,fp7d
2021-06-19,VD,85,86,1,85,2022-05-03_11-02-08,fp7d
2021-06-19,VS,20,22,2,20,2022-05-03_11-02-08,fp7d
2021-06-19,ZG,8,8,0,8,2022-05-03_11-02-08,fp7d
2021-06-19,ZH,190,194,15,179,2022-05-03_11-02-08,fp7d
2021-06-20,AG,52,50,0,50,2022-05-03_11-02-08,fp7d
2021-06-20,AI,0,0,0,0,2022-05-03_11-02-08,fp7d
2021-06-20,AR,6,6,0,6,2022-05-03_11-02-08,fp7d
2021-06-20,BE,103,88,2,86,2022-05-03_11-02-08,fp7d
2021-06-20,BL,20,16,0,16,2022-05-03_11-02-08,fp7d
2021-06-20,BS,54,50,0,50,2022-05-03_11-02-08,fp7d
2021-06-20,FR,24,24,0,24,2022-05-03_11-02-08,fp7d
2021-06-20,GE,38,56,18,38,2022-05-03_11-02-08,fp7d
2021-06-20,GL,6,6,0,6,2022-05-03_11-02-08,fp7d
2021-06-20,GR,16,16,0,16,2022-05-03_11-02-08,fp7d
2021-06-20,JU,6,6,0,6,2022-05-03_11-02-08,fp7d
2021-06-20,LU,54,50,0,50,2022-05-03_11-02-08,fp7d
2021-06-20,NE,10,10,0,10,2022-05-03_11-02-08,fp7d
2021-06-20,NW,6,6,0,6,2022-05-03_11-02-08,fp7d
2021-06-20,OW,0,0,0,0,2022-05-03_11-02-08,fp7d
2021-06-20,SG,54,55,1,54,2022-05-03_11-02-08,fp7d
2021-06-20,SH,8,8,0,8,2022-05-03_11-02-08,fp7d
2021-06-20,SO,17,17,0,17,2022-05-03_11-02-08,fp7d
2021-06-20,SZ,12,11,0,11,2022-05-03_11-02-08,fp7d
2021-06-20,TG,21,25,8,17,2022-05-03_11-02-08,fp7d
2021-06-20,TI,53,68,15,53,2022-05-03_11-02-08,fp7d
2021-06-20,UR,6,6,0,6,2022-05-03_11-02-08,fp7d
2021-06-20,VD,85,86,1,85,2022-05-03_11-02-08,fp7d
2021-06-20,VS,20,22,2,20,2022-05-03_11-02-08,fp7d
2021-06-20,ZG,8,8,0,8,2022-05-03_11-02-08,fp7d
2021-06-20,ZH,190,195,16,179,2022-05-03_11-02-08,fp7d
2021-06-21,AG,52,50,0,50,2022-05-03_11-02-08,fp7d
2021-06-21,AI,0,0,0,0,2022-05-03_11-02-08,fp7d
2021-06-21,AR,6,6,0,6,2022-05-03_11-02-08,fp7d
2021-06-21,BE,103,88,2,86,2022-05-03_11-02-08,fp7d
2021-06-21,BL,20,16,0,16,2022-05-03_11-02-08,fp7d
2021-06-21,BS,54,50,0,50,2022-05-03_11-02-08,fp7d
2021-06-21,FR,24,24,0,24,2022-05-03_11-02-08,fp7d
2021-06-21,GE,38,56,18,38,2022-05-03_11-02-08,fp7d
2021-06-21,GL,6,6,0,6,2022-05-03_11-02-08,fp7d
2021-06-21,GR,16,16,0,16,2022-05-03_11-02-08,fp7d
2021-06-21,JU,6,6,0,6,2022-05-03_11-02-08,fp7d
2021-06-21,LU,54,50,0,50,2022-05-03_11-02-08,fp7d
2021-06-21,NE,10,10,0,10,2022-05-03_11-02-08,fp7d
2021-06-21,NW,6,6,0,6,2022-05-03_11-02-08,fp7d
2021-06-21,OW,0,0,0,0,2022-05-03_11-02-08,fp7d
2021-06-21,SG,54,55,1,54,2022-05-03_11-02-08,fp7d
2021-06-21,SH,8,8,0,8,2022-05-03_11-02-08,fp7d
2021-06-21,SO,17,17,0,17,2022-05-03_11-02-08,fp7d
2021-06-21,SZ,12,11,0,11,2022-05-03_11-02-08,fp7d
2021-06-21,TG,21,25,8,17,2022-05-03_11-02-08,fp7d
2021-06-21,TI,53,68,15,53,2022-05-03_11-02-08,fp7d
2021-06-21,UR,6,6,0,6,2022-05-03_11-02-08,fp7d
2021-06-21,VD,85,86,1,85,2022-05-03_11-02-08,fp7d
2021-06-21,VS,20,22,2,20,2022-05-03_11-02-08,fp7d
2021-06-21,ZG,8,8,0,8,2022-05-03_11-02-08,fp7d
2021-06-21,ZH,190,193,15,178,2022-05-03_11-02-08,fp7d
2021-06-22,AG,52,50,0,50,2022-05-03_11-02-08,fp7d
2021-06-22,AI,0,0,0,0,2022-05-03_11-02-08,fp7d
2021-06-22,AR,6,6,0,6,2022-05-03_11-02-08,fp7d
2021-06-22,BE,103,90,2,88,2022-05-03_11-02-08,fp7d
2021-06-22,BL,20,16,0,16,2022-05-03_11-02-08,fp7d
2021-06-22,BS,54,50,0,50,2022-05-03_11-02-08,fp7d
2021-06-22,FR,24,24,0,24,2022-05-03_11-02-08,fp7d
2021-06-22,GE,38,56,18,38,2022-05-03_11-02-08,fp7d
2021-06-22,GL,6,6,0,6,2022-05-03_11-02-08,fp7d
2021-06-22,GR,16,16,0,16,2022-05-03_11-02-08,fp7d
2021-06-22,JU,6,6,0,6,2022-05-03_11-02-08,fp7d
2021-06-22,LU,54,52,2,50,2022-05-03_11-02-08,fp7d
2021-06-22,NE,10,10,0,10,2022-05-03_11-02-08,fp7d
2021-06-22,NW,6,6,0,6,2022-05-03_11-02-08,fp7d
2021-06-22,OW,0,0,0,0,2022-05-03_11-02-08,fp7d
2021-06-22,SG,54,55,1,54,2022-05-03_11-02-08,fp7d
2021-06-22,SH,8,8,0,8,2022-05-03_11-02-08,fp7d
2021-06-22,SO,17,17,0,17,2022-05-03_11-02-08,fp7d
2021-06-22,SZ,12,11,0,11,2022-05-03_11-02-08,fp7d
2021-06-22,TG,21,25,8,17,2022-05-03_11-02-08,fp7d
2021-06-22,TI,53,68,15,53,2022-05-03_11-02-08,fp7d
2021-06-22,UR,6,6,0,6,2022-05-03_11-02-08,fp7d
2021-06-22,VD,85,86,1,85,2022-05-03_11-02-08,fp7d
2021-06-22,VS,20,22,2,20,2022-05-03_11-02-08,fp7d
2021-06-22,ZG,8,8,0,8,2022-05-03_11-02-08,fp7d
2021-06-22,ZH,190,194,15,179,2022-05-03_11-02-08,fp7d
2021-06-23,AG,52,50,0,50,2022-05-03_11-02-08,fp7d
2021-06-23,AI,0,0,0,0,2022-05-03_11-02-08,fp7d
2021-06-23,AR,6,6,0,6,2022-05-03_11-02-08,fp7d
2021-06-23,BE,103,91,2,89,2022-05-03_11-02-08,fp7d
2021-06-23,BL,20,16,0,16,2022-05-03_11-02-08,fp7d
2021-06-23,BS,54,50,0,50,2022-05-03_11-02-08,fp7d
2021-06-23,FR,24,24,0,24,2022-05-03_11-02-08,fp7d
2021-06-23,GE,38,56,18,38,2022-05-03_11-02-08,fp7d
2021-06-23,GL,6,6,0,6,2022-05-03_11-02-08,fp7d
2021-06-23,GR,16,16,0,16,2022-05-03_11-02-08,fp7d
2021-06-23,JU,6,6,0,6,2022-05-03_11-02-08,fp7d
2021-06-23,LU,54,52,2,50,2022-05-03_11-02-08,fp7d
2021-06-23,NE,10,10,0,10,2022-05-03_11-02-08,fp7d
2021-06-23,NW,6,6,0,6,2022-05-03_11-02-08,fp7d
2021-06-23,OW,0,0,0,0,2022-05-03_11-02-08,fp7d
2021-06-23,SG,54,55,1,54,2022-05-03_11-02-08,fp7d
2021-06-23,SH,8,8,0,8,2022-05-03_11-02-08,fp7d
2021-06-23,SO,17,17,0,17,2022-05-03_11-02-08,fp7d
2021-06-23,SZ,12,11,0,11,2022-05-03_11-02-08,fp7d
2021-06-23,TG,21,25,8,17,2022-05-03_11-02-08,fp7d
2021-06-23,TI,53,68,15,53,2022-05-03_11-02-08,fp7d
2021-06-23,UR,6,6,0,6,2022-05-03_11-02-08,fp7d
2021-06-23,VD,85,86,1,85,2022-05-03_11-02-08,fp7d
2021-06-23,VS,20,22,2,20,2022-05-03_11-02-08,fp7d
2021-06-23,ZG,8,8,0,8,2022-05-03_11-02-08,fp7d
2021-06-23,ZH,190,194,14,180,2022-05-03_11-02-08,fp7d
2021-06-24,AG,52,50,0,50,2022-05-03_11-02-08,fp7d
2021-06-24,AI,0,0,0,0,2022-05-03_11-02-08,fp7d
2021-06-24,AR,6,6,0,6,2022-05-03_11-02-08,fp7d
2021-06-24,BE,103,91,2,89,2022-05-03_11-02-08,fp7d
2021-06-24,BL,20,16,0,16,2022-05-03_11-02-08,fp7d
2021-06-24,BS,54,50,0,50,2022-05-03_11-02-08,fp7d
2021-06-24,FR,24,24,0,24,2022-05-03_11-02-08,fp7d
2021-06-24,GE,38,56,18,38,2022-05-03_11-02-08,fp7d
2021-06-24,GL,6,6,0,6,2022-05-03_11-02-08,fp7d
2021-06-24,GR,16,16,0,16,2022-05-03_11-02-08,fp7d
2021-06-24,JU,6,6,0,6,2022-05-03_11-02-08,fp7d
2021-06-24,LU,54,52,2,50,2022-05-03_11-02-08,fp7d
2021-06-24,NE,10,10,0,10,2022-05-03_11-02-08,fp7d
2021-06-24,NW,6,5,0,5,2022-05-03_11-02-08,fp7d
2021-06-24,OW,0,0,0,0,2022-05-03_11-02-08,fp7d
2021-06-24,SG,54,55,1,54,2022-05-03_11-02-08,fp7d
2021-06-24,SH,8,8,0,8,2022-05-03_11-02-08,fp7d
2021-06-24,SO,17,17,0,17,2022-05-03_11-02-08,fp7d
2021-06-24,SZ,12,11,0,11,2022-05-03_11-02-08,fp7d
2021-06-24,TG,21,25,8,17,2022-05-03_11-02-08,fp7d
2021-06-24,TI,53,68,15,53,2022-05-03_11-02-08,fp7d
2021-06-24,UR,6,6,0,6,2022-05-03_11-02-08,fp7d
2021-06-24,VD,85,86,1,85,2022-05-03_11-02-08,fp7d
2021-06-24,VS,14,14,0,14,2022-05-03_11-02-08,fp7d
2021-06-24,ZG,8,8,0,8,2022-05-03_11-02-08,fp7d
2021-06-24,ZH,190,195,15,180,2022-05-03_11-02-08,fp7d
2021-06-25,AG,52,50,0,50,2022-05-03_11-02-08,fp7d
2021-06-25,AI,0,0,0,0,2022-05-03_11-02-08,fp7d
2021-06-25,AR,6,6,0,6,2022-05-03_11-02-08,fp7d
2021-06-25,BE,103,91,2,89,2022-05-03_11-02-08,fp7d
2021-06-25,BL,20,16,0,16,2022-05-03_11-02-08,fp7d
2021-06-25,BS,54,50,0,50,2022-05-03_11-02-08,fp7d
2021-06-25,FR,24,24,0,24,2022-05-03_11-02-08,fp7d
2021-06-25,GE,38,51,13,38,2022-05-03_11-02-08,fp7d
2021-06-25,GL,6,6,0,6,2022-05-03_11-02-08,fp7d
2021-06-25,GR,16,16,0,16,2022-05-03_11-02-08,fp7d
2021-06-25,JU,6,6,0,6,2022-05-03_11-02-08,fp7d
2021-06-25,LU,54,52,2,50,2022-05-03_11-02-08,fp7d
2021-06-25,NE,10,10,0,10,2022-05-03_11-02-08,fp7d
2021-06-25,NW,6,5,0,5,2022-05-03_11-02-08,fp7d
2021-06-25,OW,0,0,0,0,2022-05-03_11-02-08,fp7d
2021-06-25,SG,54,55,1,54,2022-05-03_11-02-08,fp7d
2021-06-25,SH,8,8,0,8,2022-05-03_11-02-08,fp7d
2021-06-25,SO,17,17,0,17,2022-05-03_11-02-08,fp7d
2021-06-25,SZ,12,11,0,11,2022-05-03_11-02-08,fp7d
2021-06-25,TG,21,25,8,17,2022-05-03_11-02-08,fp7d
2021-06-25,TI,53,68,15,53,2022-05-03_11-02-08,fp7d
2021-06-25,UR,6,6,0,6,2022-05-03_11-02-08,fp7d
2021-06-25,VD,85,86,1,85,2022-05-03_11-02-08,fp7d
2021-06-25,VS,14,14,0,14,2022-05-03_11-02-08,fp7d
2021-06-25,ZG,8,8,0,8,2022-05-03_11-02-08,fp7d
2021-06-25,ZH,190,195,15,180,2022-05-03_11-02-08,fp7d
2021-06-26,AG,52,50,0,50,2022-05-03_11-02-08,fp7d
2021-06-26,AI,0,0,0,0,2022-05-03_11-02-08,fp7d
2021-06-26,AR,6,6,0,6,2022-05-03_11-02-08,fp7d
2021-06-26,BE,103,89,2,87,2022-05-03_11-02-08,fp7d
2021-06-26,BL,20,16,0,16,2022-05-03_11-02-08,fp7d
2021-06-26,BS,54,46,0,46,2022-05-03_11-02-08,fp7d
2021-06-26,FR,24,24,0,24,2022-05-03_11-02-08,fp7d
2021-06-26,GE,38,51,13,38,2022-05-03_11-02-08,fp7d
2021-06-26,GL,6,6,0,6,2022-05-03_11-02-08,fp7d
2021-06-26,GR,16,16,0,16,2022-05-03_11-02-08,fp7d
2021-06-26,JU,6,6,0,6,2022-05-03_11-02-08,fp7d
2021-06-26,LU,54,50,0,50,2022-05-03_11-02-08,fp7d
2021-06-26,NE,10,10,0,10,2022-05-03_11-02-08,fp7d
2021-06-26,NW,6,5,0,5,2022-05-03_11-02-08,fp7d
2021-06-26,OW,0,0,0,0,2022-05-03_11-02-08,fp7d
2021-06-26,SG,54,55,1,54,2022-05-03_11-02-08,fp7d
2021-06-26,SH,8,8,0,8,2022-05-03_11-02-08,fp7d
2021-06-26,SO,17,17,0,17,2022-05-03_11-02-08,fp7d
2021-06-26,SZ,12,11,0,11,2022-05-03_11-02-08,fp7d
2021-06-26,TG,21,25,8,17,2022-05-03_11-02-08,fp7d
2021-06-26,TI,53,68,15,53,2022-05-03_11-02-08,fp7d
2021-06-26,UR,6,6,0,6,2022-05-03_11-02-08,fp7d
2021-06-26,VD,85,86,1,85,2022-05-03_11-02-08,fp7d
2021-06-26,VS,14,14,0,14,2022-05-03_11-02-08,fp7d
2021-06-26,ZG,8,8,0,8,2022-05-03_11-02-08,fp7d
2021-06-26,ZH,190,195,15,180,2022-05-03_11-02-08,fp7d
2021-06-27,AG,52,50,0,50,2022-05-03_11-02-08,fp7d
2021-06-27,AI,0,0,0,0,2022-05-03_11-02-08,fp7d
2021-06-27,AR,6,6,0,6,2022-05-03_11-02-08,fp7d
2021-06-27,BE,103,89,2,87,2022-05-03_11-02-08,fp7d
2021-06-27,BL,20,16,0,16,2022-05-03_11-02-08,fp7d
2021-06-27,BS,54,46,0,46,2022-05-03_11-02-08,fp7d
2021-06-27,FR,24,24,0,24,2022-05-03_11-02-08,fp7d
2021-06-27,GE,38,51,13,38,2022-05-03_11-02-08,fp7d
2021-06-27,GL,6,6,0,6,2022-05-03_11-02-08,fp7d
2021-06-27,GR,16,16,0,16,2022-05-03_11-02-08,fp7d
2021-06-27,JU,6,6,0,6,2022-05-03_11-02-08,fp7d
2021-06-27,LU,54,50,0,50,2022-05-03_11-02-08,fp7d
2021-06-27,NE,10,10,0,10,2022-05-03_11-02-08,fp7d
2021-06-27,NW,6,5,0,5,2022-05-03_11-02-08,fp7d
2021-06-27,OW,0,0,0,0,2022-05-03_11-02-08,fp7d
2021-06-27,SG,54,55,1,54,2022-05-03_11-02-08,fp7d
2021-06-27,SH,8,8,0,8,2022-05-03_11-02-08,fp7d
2021-06-27,SO,17,17,0,17,2022-05-03_11-02-08,fp7d
2021-06-27,SZ,12,11,0,11,2022-05-03_11-02-08,fp7d
2021-06-27,TG,21,25,8,17,2022-05-03_11-02-08,fp7d
2021-06-27,TI,53,68,15,53,2022-05-03_11-02-08,fp7d
2021-06-27,UR,6,6,0,6,2022-05-03_11-02-08,fp7d
2021-06-27,VD,85,86,1,85,2022-05-03_11-02-08,fp7d
2021-06-27,VS,14,14,0,14,2022-05-03_11-02-08,fp7d
2021-06-27,ZG,8,8,0,8,2022-05-03_11-02-08,fp7d
2021-06-27,ZH,190,195,15,180,2022-05-03_11-02-08,fp7d
2021-06-28,AG,52,50,0,50,2022-05-03_11-02-08,fp7d
2021-06-28,AI,0,0,0,0,2022-05-03_11-02-08,fp7d
2021-06-28,AR,6,6,0,6,2022-05-03_11-02-08,fp7d
2021-06-28,BE,103,89,2,87,2022-05-03_11-02-08,fp7d
2021-06-28,BL,20,16,0,16,2022-05-03_11-02-08,fp7d
2021-06-28,BS,54,50,0,50,2022-05-03_11-02-08,fp7d
2021-06-28,FR,24,24,0,24,2022-05-03_11-02-08,fp7d
2021-06-28,GE,38,51,13,38,2022-05-03_11-02-08,fp7d
2021-06-28,GL,6,6,0,6,2022-05-03_11-02-08,fp7d
2021-06-28,GR,16,16,0,16,2022-05-03_11-02-08,fp7d
2021-06-28,JU,6,6,0,6,2022-05-03_11-02-08,fp7d
2021-06-28,LU,54,50,0,50,2022-05-03_11-02-08,fp7d
2021-06-28,NE,10,10,0,10,2022-05-03_11-02-08,fp7d
2021-06-28,NW,6,5,0,5,2022-05-03_11-02-08,fp7d
2021-06-28,OW,0,0,0,0,2022-05-03_11-02-08,fp7d
2021-06-28,SG,54,55,1,54,2022-05-03_11-02-08,fp7d
2021-06-28,SH,8,8,0,8,2022-05-03_11-02-08,fp7d
2021-06-28,SO,17,17,0,17,2022-05-03_11-02-08,fp7d
2021-06-28,SZ,12,11,0,11,2022-05-03_11-02-08,fp7d
2021-06-28,TG,21,25,8,17,2022-05-03_11-02-08,fp7d
2021-06-28,TI,53,68,15,53,2022-05-03_11-02-08,fp7d
2021-06-28,UR,6,6,0,6,2022-05-03_11-02-08,fp7d
2021-06-28,VD,85,86,1,85,2022-05-03_11-02-08,fp7d
2021-06-28,VS,14,14,0,14,2022-05-03_11-02-08,fp7d
2021-06-28,ZG,8,8,0,8,2022-05-03_11-02-08,fp7d
2021-06-28,ZH,190,193,13,180,2022-05-03_11-02-08,fp7d
2021-06-29,AG,52,50,0,50,2022-05-03_11-02-08,fp7d
2021-06-29,AI,0,0,0,0,2022-05-03_11-02-08,fp7d
2021-06-29,AR,6,6,0,6,2022-05-03_11-02-08,fp7d
2021-06-29,BE,103,89,2,87,2022-05-03_11-02-08,fp7d
2021-06-29,BL,20,16,0,16,2022-05-03_11-02-08,fp7d
2021-06-29,BS,54,50,0,50,2022-05-03_11-02-08,fp7d
2021-06-29,FR,24,24,0,24,2022-05-03_11-02-08,fp7d
2021-06-29,GE,38,51,13,38,2022-05-03_11-02-08,fp7d
2021-06-29,GL,6,6,0,6,2022-05-03_11-02-08,fp7d
2021-06-29,GR,16,16,0,16,2022-05-03_11-02-08,fp7d
2021-06-29,JU,6,6,0,6,2022-05-03_11-02-08,fp7d
2021-06-29,LU,54,50,0,50,2022-05-03_11-02-08,fp7d
2021-06-29,NE,10,10,0,10,2022-05-03_11-02-08,fp7d
2021-06-29,NW,6,5,0,5,2022-05-03_11-02-08,fp7d
2021-06-29,OW,0,0,0,0,2022-05-03_11-02-08,fp7d
2021-06-29,SG,54,55,1,54,2022-05-03_11-02-08,fp7d
2021-06-29,SH,8,8,0,8,2022-05-03_11-02-08,fp7d
2021-06-29,SO,17,17,0,17,2022-05-03_11-02-08,fp7d
2021-06-29,SZ,12,11,0,11,2022-05-03_11-02-08,fp7d
2021-06-29,TG,21,27,8,19,2022-05-03_11-02-08,fp7d
2021-06-29,TI,53,68,15,53,2022-05-03_11-02-08,fp7d
2021-06-29,UR,6,6,0,6,2022-05-03_11-02-08,fp7d
2021-06-29,VD,85,86,1,85,2022-05-03_11-02-08,fp7d
2021-06-29,VS,14,14,0,14,2022-05-03_11-02-08,fp7d
2021-06-29,ZG,8,8,0,8,2022-05-03_11-02-08,fp7d
2021-06-29,ZH,190,191,13,178,2022-05-03_11-02-08,fp7d
2021-06-30,AG,52,50,0,50,2022-05-03_11-02-08,fp7d
2021-06-30,AI,0,0,0,0,2022-05-03_11-02-08,fp7d
2021-06-30,AR,6,6,0,6,2022-05-03_11-02-08,fp7d
2021-06-30,BE,91,79,2,77,2022-05-03_11-02-08,fp7d
2021-06-30,BL,20,16,0,16,2022-05-03_11-02-08,fp7d
2021-06-30,BS,54,50,0,50,2022-05-03_11-02-08,fp7d
2021-06-30,FR,24,24,0,24,2022-05-03_11-02-08,fp7d
2021-06-30,GE,38,51,13,38,2022-05-03_11-02-08,fp7d
2021-06-30,GL,6,6,0,6,2022-05-03_11-02-08,fp7d
2021-06-30,GR,16,16,0,16,2022-05-03_11-02-08,fp7d
2021-06-30,JU,6,6,0,6,2022-05-03_11-02-08,fp7d
2021-06-30,LU,54,52,2,50,2022-05-03_11-02-08,fp7d
2021-06-30,NE,10,10,0,10,2022-05-03_11-02-08,fp7d
2021-06-30,NW,6,5,0,5,2022-05-03_11-02-08,fp7d
2021-06-30,OW,0,0,0,0,2022-05-03_11-02-08,fp7d
2021-06-30,SG,54,55,1,54,2022-05-03_11-02-08,fp7d
2021-06-30,SH,8,8,0,8,2022-05-03_11-02-08,fp7d
2021-06-30,SO,17,17,0,17,2022-05-03_11-02-08,fp7d
2021-06-30,SZ,12,11,0,11,2022-05-03_11-02-08,fp7d
2021-06-30,TG,21,27,8,19,2022-05-03_11-02-08,fp7d
2021-06-30,TI,53,68,15,53,2022-05-03_11-02-08,fp7d
2021-06-30,UR,6,6,0,6,2022-05-03_11-02-08,fp7d
2021-06-30,VD,85,86,1,85,2022-05-03_11-02-08,fp7d
2021-06-30,VS,14,14,0,14,2022-05-03_11-02-08,fp7d
2021-06-30,ZG,8,8,0,8,2022-05-03_11-02-08,fp7d
2021-06-30,ZH,190,193,12,181,2022-05-03_11-02-08,fp7d
2021-07-01,AG,52,50,0,50,2022-05-03_11-02-08,fp7d
2021-07-01,AI,0,0,0,0,2022-05-03_11-02-08,fp7d
2021-07-01,AR,6,6,0,6,2022-05-03_11-02-08,fp7d
2021-07-01,BE,92,81,2,79,2022-05-03_11-02-08,fp7d
2021-07-01,BL,20,16,0,16,2022-05-03_11-02-08,fp7d
2021-07-01,BS,54,50,0,50,2022-05-03_11-02-08,fp7d
2021-07-01,FR,24,24,0,24,2022-05-03_11-02-08,fp7d
2021-07-01,GE,38,51,13,38,2022-05-03_11-02-08,fp7d
2021-07-01,GL,6,6,0,6,2022-05-03_11-02-08,fp7d
2021-07-01,GR,16,16,0,16,2022-05-03_11-02-08,fp7d
2021-07-01,JU,6,6,0,6,2022-05-03_11-02-08,fp7d
2021-07-01,LU,54,52,2,50,2022-05-03_11-02-08,fp7d
2021-07-01,NE,10,10,0,10,2022-05-03_11-02-08,fp7d
2021-07-01,NW,6,5,0,5,2022-05-03_11-02-08,fp7d
2021-07-01,OW,0,0,0,0,2022-05-03_11-02-08,fp7d
2021-07-01,SG,54,55,1,54,2022-05-03_11-02-08,fp7d
2021-07-01,SH,8,8,0,8,2022-05-03_11-02-08,fp7d
2021-07-01,SO,17,17,0,17,2022-05-03_11-02-08,fp7d
2021-07-01,SZ,12,11,0,11,2022-05-03_11-02-08,fp7d
2021-07-01,TG,21,27,8,19,2022-05-03_11-02-08,fp7d
2021-07-01,TI,53,68,15,53,2022-05-03_11-02-08,fp7d
2021-07-01,UR,6,6,0,6,2022-05-03_11-02-08,fp7d
2021-07-01,VD,85,86,1,85,2022-05-03_11-02-08,fp7d
2021-07-01,VS,14,14,0,14,2022-05-03_11-02-08,fp7d
2021-07-01,ZG,8,8,0,8,2022-05-03_11-02-08,fp7d
2021-07-01,ZH,190,193,12,181,2022-05-03_11-02-08,fp7d
2021-07-02,AG,52,50,0,50,2022-05-03_11-02-08,fp7d
2021-07-02,AI,0,0,0,0,2022-05-03_11-02-08,fp7d
2021-07-02,AR,6,6,0,6,2022-05-03_11-02-08,fp7d
2021-07-02,BE,92,81,2,79,2022-05-03_11-02-08,fp7d
2021-07-02,BL,20,16,0,16,2022-05-03_11-02-08,fp7d
2021-07-02,BS,54,50,0,50,2022-05-03_11-02-08,fp7d
2021-07-02,FR,24,24,0,24,2022-05-03_11-02-08,fp7d
2021-07-02,GE,38,51,13,38,2022-05-03_11-02-08,fp7d
2021-07-02,GL,6,6,0,6,2022-05-03_11-02-08,fp7d
2021-07-02,GR,16,16,0,16,2022-05-03_11-02-08,fp7d
2021-07-02,JU,6,6,0,6,2022-05-03_11-02-08,fp7d
2021-07-02,LU,54,52,2,50,2022-05-03_11-02-08,fp7d
2021-07-02,NE,10,10,0,10,2022-05-03_11-02-08,fp7d
2021-07-02,NW,6,5,0,5,2022-05-03_11-02-08,fp7d
2021-07-02,OW,0,0,0,0,2022-05-03_11-02-08,fp7d
2021-07-02,SG,54,55,1,54,2022-05-03_11-02-08,fp7d
2021-07-02,SH,8,8,0,8,2022-05-03_11-02-08,fp7d
2021-07-02,SO,17,17,0,17,2022-05-03_11-02-08,fp7d
2021-07-02,SZ,12,11,0,11,2022-05-03_11-02-08,fp7d
2021-07-02,TG,21,27,8,19,2022-05-03_11-02-08,fp7d
2021-07-02,TI,53,68,15,53,2022-05-03_11-02-08,fp7d
2021-07-02,UR,6,6,0,6,2022-05-03_11-02-08,fp7d
2021-07-02,VD,85,86,1,85,2022-05-03_11-02-08,fp7d
2021-07-02,VS,14,14,0,14,2022-05-03_11-02-08,fp7d
2021-07-02,ZG,8,8,0,8,2022-05-03_11-02-08,fp7d
2021-07-02,ZH,190,193,12,181,2022-05-03_11-02-08,fp7d
2021-07-03,AG,52,50,0,50,2022-05-03_11-02-08,fp7d
2021-07-03,AI,0,0,0,0,2022-05-03_11-02-08,fp7d
2021-07-03,AR,6,6,0,6,2022-05-03_11-02-08,fp7d
2021-07-03,BE,92,79,2,77,2022-05-03_11-02-08,fp7d
2021-07-03,BL,20,16,0,16,2022-05-03_11-02-08,fp7d
2021-07-03,BS,54,50,0,50,2022-05-03_11-02-08,fp7d
2021-07-03,FR,24,24,0,24,2022-05-03_11-02-08,fp7d
2021-07-03,GE,38,51,13,38,2022-05-03_11-02-08,fp7d
2021-07-03,GL,6,6,0,6,2022-05-03_11-02-08,fp7d
2021-07-03,GR,16,16,0,16,2022-05-03_11-02-08,fp7d
2021-07-03,JU,6,6,0,6,2022-05-03_11-02-08,fp7d
2021-07-03,LU,54,52,2,50,2022-05-03_11-02-08,fp7d
2021-07-03,NE,10,10,0,10,2022-05-03_11-02-08,fp7d
2021-07-03,NW,6,5,0,5,2022-05-03_11-02-08,fp7d
2021-07-03,OW,0,0,0,0,2022-05-03_11-02-08,fp7d
2021-07-03,SG,54,55,1,54,2022-05-03_11-02-08,fp7d
2021-07-03,SH,8,8,0,8,2022-05-03_11-02-08,fp7d
2021-07-03,SO,17,17,0,17,2022-05-03_11-02-08,fp7d
2021-07-03,SZ,12,11,0,11,2022-05-03_11-02-08,fp7d
2021-07-03,TG,21,27,8,19,2022-05-03_11-02-08,fp7d
2021-07-03,TI,53,68,15,53,2022-05-03_11-02-08,fp7d
2021-07-03,UR,6,6,0,6,2022-05-03_11-02-08,fp7d
2021-07-03,VD,85,86,1,85,2022-05-03_11-02-08,fp7d
2021-07-03,VS,14,14,0,14,2022-05-03_11-02-08,fp7d
2021-07-03,ZG,8,8,0,8,2022-05-03_11-02-08,fp7d
2021-07-03,ZH,190,195,14,181,2022-05-03_11-02-08,fp7d
2021-07-04,AG,52,50,0,50,2022-05-03_11-02-08,fp7d
2021-07-04,AI,0,0,0,0,2022-05-03_11-02-08,fp7d
2021-07-04,AR,6,6,0,6,2022-05-03_11-02-08,fp7d
2021-07-04,BE,92,80,2,78,2022-05-03_11-02-08,fp7d
2021-07-04,BL,20,16,0,16,2022-05-03_11-02-08,fp7d
2021-07-04,BS,54,50,0,50,2022-05-03_11-02-08,fp7d
2021-07-04,FR,24,24,0,24,2022-05-03_11-02-08,fp7d
2021-07-04,GE,38,51,13,38,2022-05-03_11-02-08,fp7d
2021-07-04,GL,6,6,0,6,2022-05-03_11-02-08,fp7d
2021-07-04,GR,16,16,0,16,2022-05-03_11-02-08,fp7d
2021-07-04,JU,6,6,0,6,2022-05-03_11-02-08,fp7d
2021-07-04,LU,54,52,2,50,2022-05-03_11-02-08,fp7d
2021-07-04,NE,10,10,0,10,2022-05-03_11-02-08,fp7d
2021-07-04,NW,6,5,0,5,2022-05-03_11-02-08,fp7d
2021-07-04,OW,0,0,0,0,2022-05-03_11-02-08,fp7d
2021-07-04,SG,54,55,1,54,2022-05-03_11-02-08,fp7d
2021-07-04,SH,8,8,0,8,2022-05-03_11-02-08,fp7d
2021-07-04,SO,17,17,0,17,2022-05-03_11-02-08,fp7d
2021-07-04,SZ,12,11,0,11,2022-05-03_11-02-08,fp7d
2021-07-04,TG,21,27,8,19,2022-05-03_11-02-08,fp7d
2021-07-04,TI,53,68,15,53,2022-05-03_11-02-08,fp7d
2021-07-04,UR,6,6,0,6,2022-05-03_11-02-08,fp7d
2021-07-04,VD,85,86,1,85,2022-05-03_11-02-08,fp7d
2021-07-04,VS,14,14,0,14,2022-05-03_11-02-08,fp7d
2021-07-04,ZG,8,8,0,8,2022-05-03_11-02-08,fp7d
2021-07-04,ZH,190,195,14,181,2022-05-03_11-02-08,fp7d
2021-07-05,AG,52,50,0,50,2022-05-03_11-02-08,fp7d
2021-07-05,AI,0,0,0,0,2022-05-03_11-02-08,fp7d
2021-07-05,AR,6,6,0,6,2022-05-03_11-02-08,fp7d
2021-07-05,BE,92,82,2,80,2022-05-03_11-02-08,fp7d
2021-07-05,BL,20,16,0,16,2022-05-03_11-02-08,fp7d
2021-07-05,BS,54,50,0,50,2022-05-03_11-02-08,fp7d
2021-07-05,FR,24,24,0,24,2022-05-03_11-02-08,fp7d
2021-07-05,GE,38,45,7,38,2022-05-03_11-02-08,fp7d
2021-07-05,GL,6,6,0,6,2022-05-03_11-02-08,fp7d
2021-07-05,GR,16,16,0,16,2022-05-03_11-02-08,fp7d
2021-07-05,JU,6,6,0,6,2022-05-03_11-02-08,fp7d
2021-07-05,LU,54,50,0,50,2022-05-03_11-02-08,fp7d
2021-07-05,NE,10,10,0,10,2022-05-03_11-02-08,fp7d
2021-07-05,NW,6,5,0,5,2022-05-03_11-02-08,fp7d
2021-07-05,OW,0,0,0,0,2022-05-03_11-02-08,fp7d
2021-07-05,SG,54,55,1,54,2022-05-03_11-02-08,fp7d
2021-07-05,SH,8,8,0,8,2022-05-03_11-02-08,fp7d
2021-07-05,SO,17,17,0,17,2022-05-03_11-02-08,fp7d
2021-07-05,SZ,12,11,0,11,2022-05-03_11-02-08,fp7d
2021-07-05,TG,21,27,8,19,2022-05-03_11-02-08,fp7d
2021-07-05,TI,53,68,15,53,2022-05-03_11-02-08,fp7d
2021-07-05,UR,6,6,0,6,2022-05-03_11-02-08,fp7d
2021-07-05,VD,85,86,1,85,2022-05-03_11-02-08,fp7d
2021-07-05,VS,14,14,0,14,2022-05-03_11-02-08,fp7d
2021-07-05,ZG,8,8,0,8,2022-05-03_11-02-08,fp7d
2021-07-05,ZH,190,193,12,181,2022-05-03_11-02-08,fp7d
2021-07-06,AG,52,50,0,50,2022-05-03_11-02-08,fp7d
2021-07-06,AI,0,0,0,0,2022-05-03_11-02-08,fp7d
2021-07-06,AR,6,6,0,6,2022-05-03_11-02-08,fp7d
2021-07-06,BE,92,82,2,80,2022-05-03_11-02-08,fp7d
2021-07-06,BL,20,16,0,16,2022-05-03_11-02-08,fp7d
2021-07-06,BS,54,50,0,50,2022-05-03_11-02-08,fp7d
2021-07-06,FR,24,24,0,24,2022-05-03_11-02-08,fp7d
2021-07-06,GE,38,45,7,38,2022-05-03_11-02-08,fp7d
2021-07-06,GL,6,6,0,6,2022-05-03_11-02-08,fp7d
2021-07-06,GR,16,16,0,16,2022-05-03_11-02-08,fp7d
2021-07-06,JU,6,6,0,6,2022-05-03_11-02-08,fp7d
2021-07-06,LU,54,50,0,50,2022-05-03_11-02-08,fp7d
2021-07-06,NE,10,10,0,10,2022-05-03_11-02-08,fp7d
2021-07-06,NW,6,5,0,5,2022-05-03_11-02-08,fp7d
2021-07-06,OW,0,0,0,0,2022-05-03_11-02-08,fp7d
2021-07-06,SG,54,55,1,54,2022-05-03_11-02-08,fp7d
2021-07-06,SH,8,8,0,8,2022-05-03_11-02-08,fp7d
2021-07-06,SO,17,17,0,17,2022-05-03_11-02-08,fp7d
2021-07-06,SZ,12,11,0,11,2022-05-03_11-02-08,fp7d
2021-07-06,TG,21,27,8,19,2022-05-03_11-02-08,fp7d
2021-07-06,TI,53,68,15,53,2022-05-03_11-02-08,fp7d
2021-07-06,UR,6,6,0,6,2022-05-03_11-02-08,fp7d
2021-07-06,VD,85,86,1,85,2022-05-03_11-02-08,fp7d
2021-07-06,VS,14,14,0,14,2022-05-03_11-02-08,fp7d
2021-07-06,ZG,8,8,0,8,2022-05-03_11-02-08,fp7d
2021-07-06,ZH,190,195,14,181,2022-05-03_11-02-08,fp7d
2021-07-07,AG,52,50,0,50,2022-05-03_11-02-08,fp7d
2021-07-07,AI,0,0,0,0,2022-05-03_11-02-08,fp7d
2021-07-07,AR,6,6,0,6,2022-05-03_11-02-08,fp7d
2021-07-07,BE,92,81,2,79,2022-05-03_11-02-08,fp7d
2021-07-07,BL,20,16,0,16,2022-05-03_11-02-08,fp7d
2021-07-07,BS,54,50,0,50,2022-05-03_11-02-08,fp7d
2021-07-07,FR,24,24,0,24,2022-05-03_11-02-08,fp7d
2021-07-07,GE,38,45,7,38,2022-05-03_11-02-08,fp7d
2021-07-07,GL,6,6,0,6,2022-05-03_11-02-08,fp7d
2021-07-07,GR,16,16,0,16,2022-05-03_11-02-08,fp7d
2021-07-07,JU,6,6,0,6,2022-05-03_11-02-08,fp7d
2021-07-07,LU,54,50,0,50,2022-05-03_11-02-08,fp7d
2021-07-07,NE,10,10,0,10,2022-05-03_11-02-08,fp7d
2021-07-07,NW,6,5,0,5,2022-05-03_11-02-08,fp7d
2021-07-07,OW,0,0,0,0,2022-05-03_11-02-08,fp7d
2021-07-07,SG,54,55,1,54,2022-05-03_11-02-08,fp7d
2021-07-07,SH,8,8,0,8,2022-05-03_11-02-08,fp7d
2021-07-07,SO,17,17,0,17,2022-05-03_11-02-08,fp7d
2021-07-07,SZ,12,11,0,11,2022-05-03_11-02-08,fp7d
2021-07-07,TG,21,27,8,19,2022-05-03_11-02-08,fp7d
2021-07-07,TI,53,68,15,53,2022-05-03_11-02-08,fp7d
2021-07-07,UR,6,6,0,6,2022-05-03_11-02-08,fp7d
2021-07-07,VD,85,86,1,85,2022-05-03_11-02-08,fp7d
2021-07-07,VS,14,14,0,14,2022-05-03_11-02-08,fp7d
2021-07-07,ZG,8,8,0,8,2022-05-03_11-02-08,fp7d
2021-07-07,ZH,190,196,15,181,2022-05-03_11-02-08,fp7d
2021-07-08,AG,52,50,0,50,2022-05-03_11-02-08,fp7d
2021-07-08,AI,0,0,0,0,2022-05-03_11-02-08,fp7d
2021-07-08,AR,6,6,0,6,2022-05-03_11-02-08,fp7d
2021-07-08,BE,92,82,2,80,2022-05-03_11-02-08,fp7d
2021-07-08,BL,20,16,0,16,2022-05-03_11-02-08,fp7d
2021-07-08,BS,54,50,0,50,2022-05-03_11-02-08,fp7d
2021-07-08,FR,24,24,0,24,2022-05-03_11-02-08,fp7d
2021-07-08,GE,38,45,7,38,2022-05-03_11-02-08,fp7d
2021-07-08,GL,6,6,0,6,2022-05-03_11-02-08,fp7d
2021-07-08,GR,16,16,0,16,2022-05-03_11-02-08,fp7d
2021-07-08,JU,6,6,0,6,2022-05-03_11-02-08,fp7d
2021-07-08,LU,54,50,0,50,2022-05-03_11-02-08,fp7d
2021-07-08,NE,10,10,0,10,2022-05-03_11-02-08,fp7d
2021-07-08,NW,6,5,0,5,2022-05-03_11-02-08,fp7d
2021-07-08,OW,0,0,0,0,2022-05-03_11-02-08,fp7d
2021-07-08,SG,54,55,1,54,2022-05-03_11-02-08,fp7d
2021-07-08,SH,8,8,0,8,2022-05-03_11-02-08,fp7d
2021-07-08,SO,17,17,0,17,2022-05-03_11-02-08,fp7d
2021-07-08,SZ,12,11,0,11,2022-05-03_11-02-08,fp7d
2021-07-08,TG,21,29,8,21,2022-05-03_11-02-08,fp7d
2021-07-08,TI,53,68,15,53,2022-05-03_11-02-08,fp7d
2021-07-08,UR,6,6,0,6,2022-05-03_11-02-08,fp7d
2021-07-08,VD,85,86,1,85,2022-05-03_11-02-08,fp7d
2021-07-08,VS,14,14,0,14,2022-05-03_11-02-08,fp7d
2021-07-08,ZG,8,8,0,8,2022-05-03_11-02-08,fp7d
2021-07-08,ZH,190,197,16,181,2022-05-03_11-02-08,fp7d
2021-07-09,AG,52,50,0,50,2022-05-03_11-02-08,fp7d
2021-07-09,AI,0,0,0,0,2022-05-03_11-02-08,fp7d
2021-07-09,AR,6,6,0,6,2022-05-03_11-02-08,fp7d
2021-07-09,BE,92,81,2,79,2022-05-03_11-02-08,fp7d
2021-07-09,BL,20,16,0,16,2022-05-03_11-02-08,fp7d
2021-07-09,BS,54,50,0,50,2022-05-03_11-02-08,fp7d
2021-07-09,FR,24,24,0,24,2022-05-03_11-02-08,fp7d
2021-07-09,GE,38,45,7,38,2022-05-03_11-02-08,fp7d
2021-07-09,GL,6,6,0,6,2022-05-03_11-02-08,fp7d
2021-07-09,GR,16,16,0,16,2022-05-03_11-02-08,fp7d
2021-07-09,JU,6,6,0,6,2022-05-03_11-02-08,fp7d
2021-07-09,LU,54,50,0,50,2022-05-03_11-02-08,fp7d
2021-07-09,NE,10,10,0,10,2022-05-03_11-02-08,fp7d
2021-07-09,NW,6,5,0,5,2022-05-03_11-02-08,fp7d
2021-07-09,OW,0,0,0,0,2022-05-03_11-02-08,fp7d
2021-07-09,SG,54,55,1,54,2022-05-03_11-02-08,fp7d
2021-07-09,SH,8,8,0,8,2022-05-03_11-02-08,fp7d
2021-07-09,SO,17,17,0,17,2022-05-03_11-02-08,fp7d
2021-07-09,SZ,12,11,0,11,2022-05-03_11-02-08,fp7d
2021-07-09,TG,21,29,8,21,2022-05-03_11-02-08,fp7d
2021-07-09,TI,53,68,15,53,2022-05-03_11-02-08,fp7d
2021-07-09,UR,6,6,0,6,2022-05-03_11-02-08,fp7d
2021-07-09,VD,85,86,1,85,2022-05-03_11-02-08,fp7d
2021-07-09,VS,14,14,0,14,2022-05-03_11-02-08,fp7d
2021-07-09,ZG,8,8,0,8,2022-05-03_11-02-08,fp7d
2021-07-09,ZH,190,197,16,181,2022-05-03_11-02-08,fp7d
2021-07-10,AG,52,50,0,50,2022-05-03_11-02-08,fp7d
2021-07-10,AI,0,0,0,0,2022-05-03_11-02-08,fp7d
2021-07-10,AR,6,6,0,6,2022-05-03_11-02-08,fp7d
2021-07-10,BE,92,79,2,77,2022-05-03_11-02-08,fp7d
2021-07-10,BL,20,16,0,16,2022-05-03_11-02-08,fp7d
2021-07-10,BS,54,50,0,50,2022-05-03_11-02-08,fp7d
2021-07-10,FR,24,24,0,24,2022-05-03_11-02-08,fp7d
2021-07-10,GE,38,45,7,38,2022-05-03_11-02-08,fp7d
2021-07-10,GL,6,6,0,6,2022-05-03_11-02-08,fp7d
2021-07-10,GR,16,16,0,16,2022-05-03_11-02-08,fp7d
2021-07-10,JU,6,6,0,6,2022-05-03_11-02-08,fp7d
2021-07-10,LU,54,52,2,50,2022-05-03_11-02-08,fp7d
2021-07-10,NE,10,10,0,10,2022-05-03_11-02-08,fp7d
2021-07-10,NW,6,5,0,5,2022-05-03_11-02-08,fp7d
2021-07-10,OW,0,0,0,0,2022-05-03_11-02-08,fp7d
2021-07-10,SG,54,55,1,54,2022-05-03_11-02-08,fp7d
2021-07-10,SH,8,8,0,8,2022-05-03_11-02-08,fp7d
2021-07-10,SO,17,17,0,17,2022-05-03_11-02-08,fp7d
2021-07-10,SZ,12,11,0,11,2022-05-03_11-02-08,fp7d
2021-07-10,TG,21,29,8,21,2022-05-03_11-02-08,fp7d
2021-07-10,TI,53,68,15,53,2022-05-03_11-02-08,fp7d
2021-07-10,UR,6,6,0,6,2022-05-03_11-02-08,fp7d
2021-07-10,VD,85,86,1,85,2022-05-03_11-02-08,fp7d
2021-07-10,VS,14,14,0,14,2022-05-03_11-02-08,fp7d
2021-07-10,ZG,8,8,0,8,2022-05-03_11-02-08,fp7d
2021-07-10,ZH,190,194,13,181,2022-05-03_11-02-08,fp7d
2021-07-11,AG,52,50,0,50,2022-05-03_11-02-08,fp7d
2021-07-11,AI,0,0,0,0,2022-05-03_11-02-08,fp7d
2021-07-11,AR,6,6,0,6,2022-05-03_11-02-08,fp7d
2021-07-11,BE,92,79,2,77,2022-05-03_11-02-08,fp7d
2021-07-11,BL,20,16,0,16,2022-05-03_11-02-08,fp7d
2021-07-11,BS,54,50,0,50,2022-05-03_11-02-08,fp7d
2021-07-11,FR,24,24,0,24,2022-05-03_11-02-08,fp7d
2021-07-11,GE,38,45,7,38,2022-05-03_11-02-08,fp7d
2021-07-11,GL,6,6,0,6,2022-05-03_11-02-08,fp7d
2021-07-11,GR,16,16,0,16,2022-05-03_11-02-08,fp7d
2021-07-11,JU,6,6,0,6,2022-05-03_11-02-08,fp7d
2021-07-11,LU,54,50,0,50,2022-05-03_11-02-08,fp7d
2021-07-11,NE,10,10,0,10,2022-05-03_11-02-08,fp7d
2021-07-11,NW,6,5,0,5,2022-05-03_11-02-08,fp7d
2021-07-11,OW,0,0,0,0,2022-05-03_11-02-08,fp7d
2021-07-11,SG,54,55,1,54,2022-05-03_11-02-08,fp7d
2021-07-11,SH,8,8,0,8,2022-05-03_11-02-08,fp7d
2021-07-11,SO,17,17,0,17,2022-05-03_11-02-08,fp7d
2021-07-11,SZ,12,11,0,11,2022-05-03_11-02-08,fp7d
2021-07-11,TG,21,29,8,21,2022-05-03_11-02-08,fp7d
2021-07-11,TI,53,68,15,53,2022-05-03_11-02-08,fp7d
2021-07-11,UR,6,6,0,6,2022-05-03_11-02-08,fp7d
2021-07-11,VD,85,86,1,85,2022-05-03_11-02-08,fp7d
2021-07-11,VS,14,14,0,14,2022-05-03_11-02-08,fp7d
2021-07-11,ZG,8,8,0,8,2022-05-03_11-02-08,fp7d
2021-07-11,ZH,190,194,13,181,2022-05-03_11-02-08,fp7d
2021-07-12,AG,52,50,0,50,2022-05-03_11-02-08,fp7d
2021-07-12,AI,0,0,0,0,2022-05-03_11-02-08,fp7d
2021-07-12,AR,6,6,0,6,2022-05-03_11-02-08,fp7d
2021-07-12,BE,92,81,2,79,2022-05-03_11-02-08,fp7d
2021-07-12,BL,20,16,0,16,2022-05-03_11-02-08,fp7d
2021-07-12,BS,54,50,0,50,2022-05-03_11-02-08,fp7d
2021-07-12,FR,24,24,0,24,2022-05-03_11-02-08,fp7d
2021-07-12,GE,38,45,7,38,2022-05-03_11-02-08,fp7d
2021-07-12,GL,6,6,0,6,2022-05-03_11-02-08,fp7d
2021-07-12,GR,16,16,0,16,2022-05-03_11-02-08,fp7d
2021-07-12,JU,6,6,0,6,2022-05-03_11-02-08,fp7d
2021-07-12,LU,54,50,0,50,2022-05-03_11-02-08,fp7d
2021-07-12,NE,10,10,0,10,2022-05-03_11-02-08,fp7d
2021-07-12,NW,6,5,0,5,2022-05-03_11-02-08,fp7d
2021-07-12,OW,0,0,0,0,2022-05-03_11-02-08,fp7d
2021-07-12,SG,54,55,1,54,2022-05-03_11-02-08,fp7d
2021-07-12,SH,8,8,0,8,2022-05-03_11-02-08,fp7d
2021-07-12,SO,17,17,0,17,2022-05-03_11-02-08,fp7d
2021-07-12,SZ,12,11,0,11,2022-05-03_11-02-08,fp7d
2021-07-12,TG,21,29,8,21,2022-05-03_11-02-08,fp7d
2021-07-12,TI,53,68,15,53,2022-05-03_11-02-08,fp7d
2021-07-12,UR,6,6,0,6,2022-05-03_11-02-08,fp7d
2021-07-12,VD,85,86,1,85,2022-05-03_11-02-08,fp7d
2021-07-12,VS,14,14,0,14,2022-05-03_11-02-08,fp7d
2021-07-12,ZG,8,8,0,8,2022-05-03_11-02-08,fp7d
2021-07-12,ZH,190,202,19,183,2022-05-03_11-02-08,fp7d
2021-07-13,AG,52,50,0,50,2022-05-03_11-02-08,fp7d
2021-07-13,AI,0,0,0,0,2022-05-03_11-02-08,fp7d
2021-07-13,AR,6,6,0,6,2022-05-03_11-02-08,fp7d
2021-07-13,BE,92,81,2,79,2022-05-03_11-02-08,fp7d
2021-07-13,BL,20,16,0,16,2022-05-03_11-02-08,fp7d
2021-07-13,BS,54,50,0,50,2022-05-03_11-02-08,fp7d
2021-07-13,FR,24,24,0,24,2022-05-03_11-02-08,fp7d
2021-07-13,GE,38,45,7,38,2022-05-03_11-02-08,fp7d
2021-07-13,GL,6,6,0,6,2022-05-03_11-02-08,fp7d
2021-07-13,GR,16,16,0,16,2022-05-03_11-02-08,fp7d
2021-07-13,JU,6,6,0,6,2022-05-03_11-02-08,fp7d
2021-07-13,LU,54,52,2,50,2022-05-03_11-02-08,fp7d
2021-07-13,NE,10,10,0,10,2022-05-03_11-02-08,fp7d
2021-07-13,NW,6,5,0,5,2022-05-03_11-02-08,fp7d
2021-07-13,OW,0,0,0,0,2022-05-03_11-02-08,fp7d
2021-07-13,SG,54,55,1,54,2022-05-03_11-02-08,fp7d
2021-07-13,SH,8,8,0,8,2022-05-03_11-02-08,fp7d
2021-07-13,SO,17,17,0,17,2022-05-03_11-02-08,fp7d
2021-07-13,SZ,12,11,0,11,2022-05-03_11-02-08,fp7d
2021-07-13,TG,21,29,8,21,2022-05-03_11-02-08,fp7d
2021-07-13,TI,53,68,15,53,2022-05-03_11-02-08,fp7d
2021-07-13,UR,6,6,0,6,2022-05-03_11-02-08,fp7d
2021-07-13,VD,85,86,1,85,2022-05-03_11-02-08,fp7d
2021-07-13,VS,14,14,0,14,2022-05-03_11-02-08,fp7d
2021-07-13,ZG,8,8,0,8,2022-05-03_11-02-08,fp7d
2021-07-13,ZH,190,200,17,183,2022-05-03_11-02-08,fp7d
2021-07-14,AG,52,50,0,50,2022-05-03_11-02-08,fp7d
2021-07-14,AI,0,0,0,0,2022-05-03_11-02-08,fp7d
2021-07-14,AR,6,6,0,6,2022-05-03_11-02-08,fp7d
2021-07-14,BE,92,81,2,79,2022-05-03_11-02-08,fp7d
2021-07-14,BL,20,16,0,16,2022-05-03_11-02-08,fp7d
2021-07-14,BS,54,50,0,50,2022-05-03_11-02-08,fp7d
2021-07-14,FR,24,24,0,24,2022-05-03_11-02-08,fp7d
2021-07-14,GE,38,45,7,38,2022-05-03_11-02-08,fp7d
2021-07-14,GL,6,6,0,6,2022-05-03_11-02-08,fp7d
2021-07-14,GR,16,16,0,16,2022-05-03_11-02-08,fp7d
2021-07-14,JU,6,6,0,6,2022-05-03_11-02-08,fp7d
2021-07-14,LU,54,50,2,48,2022-05-03_11-02-08,fp7d
2021-07-14,NE,10,10,0,10,2022-05-03_11-02-08,fp7d
2021-07-14,NW,6,5,0,5,2022-05-03_11-02-08,fp7d
2021-07-14,OW,0,0,0,0,2022-05-03_11-02-08,fp7d
2021-07-14,SG,54,55,1,54,2022-05-03_11-02-08,fp7d
2021-07-14,SH,8,8,0,8,2022-05-03_11-02-08,fp7d
2021-07-14,SO,17,17,0,17,2022-05-03_11-02-08,fp7d
2021-07-14,SZ,12,11,0,11,2022-05-03_11-02-08,fp7d
2021-07-14,TG,21,29,8,21,2022-05-03_11-02-08,fp7d
2021-07-14,TI,53,68,15,53,2022-05-03_11-02-08,fp7d
2021-07-14,UR,6,6,0,6,2022-05-03_11-02-08,fp7d
2021-07-14,VD,85,86,1,85,2022-05-03_11-02-08,fp7d
2021-07-14,VS,14,14,0,14,2022-05-03_11-02-08,fp7d
2021-07-14,ZG,8,8,0,8,2022-05-03_11-02-08,fp7d
2021-07-14,ZH,190,201,20,181,2022-05-03_11-02-08,fp7d
2021-07-15,AG,52,50,0,50,2022-05-03_11-02-08,fp7d
2021-07-15,AI,0,0,0,0,2022-05-03_11-02-08,fp7d
2021-07-15,AR,6,6,0,6,2022-05-03_11-02-08,fp7d
2021-07-15,BE,92,81,2,79,2022-05-03_11-02-08,fp7d
2021-07-15,BL,20,16,0,16,2022-05-03_11-02-08,fp7d
2021-07-15,BS,54,50,0,50,2022-05-03_11-02-08,fp7d
2021-07-15,FR,24,24,0,24,2022-05-03_11-02-08,fp7d
2021-07-15,GE,38,45,7,38,2022-05-03_11-02-08,fp7d
2021-07-15,GL,6,6,0,6,2022-05-03_11-02-08,fp7d
2021-07-15,GR,16,16,0,16,2022-05-03_11-02-08,fp7d
2021-07-15,JU,6,6,0,6,2022-05-03_11-02-08,fp7d
2021-07-15,LU,54,50,2,48,2022-05-03_11-02-08,fp7d
2021-07-15,NE,10,10,0,10,2022-05-03_11-02-08,fp7d
2021-07-15,NW,6,5,0,5,2022-05-03_11-02-08,fp7d
2021-07-15,OW,0,0,0,0,2022-05-03_11-02-08,fp7d
2021-07-15,SG,54,55,1,54,2022-05-03_11-02-08,fp7d
2021-07-15,SH,8,8,0,8,2022-05-03_11-02-08,fp7d
2021-07-15,SO,17,17,0,17,2022-05-03_11-02-08,fp7d
2021-07-15,SZ,12,11,0,11,2022-05-03_11-02-08,fp7d
2021-07-15,TG,21,29,8,21,2022-05-03_11-02-08,fp7d
2021-07-15,TI,53,68,15,53,2022-05-03_11-02-08,fp7d
2021-07-15,UR,6,6,0,6,2022-05-03_11-02-08,fp7d
2021-07-15,VD,85,86,1,85,2022-05-03_11-02-08,fp7d
2021-07-15,VS,14,14,0,14,2022-05-03_11-02-08,fp7d
2021-07-15,ZG,8,8,0,8,2022-05-03_11-02-08,fp7d
2021-07-15,ZH,190,198,19,179,2022-05-03_11-02-08,fp7d
2021-07-16,AG,52,50,0,50,2022-05-03_11-02-08,fp7d
2021-07-16,AI,0,0,0,0,2022-05-03_11-02-08,fp7d
2021-07-16,AR,6,6,0,6,2022-05-03_11-02-08,fp7d
2021-07-16,BE,91,78,2,76,2022-05-03_11-02-08,fp7d
2021-07-16,BL,20,16,0,16,2022-05-03_11-02-08,fp7d
2021-07-16,BS,54,50,0,50,2022-05-03_11-02-08,fp7d
2021-07-16,FR,24,24,0,24,2022-05-03_11-02-08,fp7d
2021-07-16,GE,38,45,7,38,2022-05-03_11-02-08,fp7d
2021-07-16,GL,6,6,0,6,2022-05-03_11-02-08,fp7d
2021-07-16,GR,16,16,0,16,2022-05-03_11-02-08,fp7d
2021-07-16,JU,6,6,0,6,2022-05-03_11-02-08,fp7d
2021-07-16,LU,54,50,2,48,2022-05-03_11-02-08,fp7d
2021-07-16,NE,10,10,0,10,2022-05-03_11-02-08,fp7d
2021-07-16,NW,6,5,0,5,2022-05-03_11-02-08,fp7d
2021-07-16,OW,0,0,0,0,2022-05-03_11-02-08,fp7d
2021-07-16,SG,54,55,1,54,2022-05-03_11-02-08,fp7d
2021-07-16,SH,8,8,0,8,2022-05-03_11-02-08,fp7d
2021-07-16,SO,17,17,0,17,2022-05-03_11-02-08,fp7d
2021-07-16,SZ,12,12,0,12,2022-05-03_11-02-08,fp7d
2021-07-16,TG,21,29,8,21,2022-05-03_11-02-08,fp7d
2021-07-16,TI,53,68,15,53,2022-05-03_11-02-08,fp7d
2021-07-16,UR,6,6,0,6,2022-05-03_11-02-08,fp7d
2021-07-16,VD,85,86,1,85,2022-05-03_11-02-08,fp7d
2021-07-16,VS,14,14,0,14,2022-05-03_11-02-08,fp7d
2021-07-16,ZG,8,8,0,8,2022-05-03_11-02-08,fp7d
2021-07-16,ZH,190,197,18,179,2022-05-03_11-02-08,fp7d
2021-07-17,AG,52,50,0,50,2022-05-03_11-02-08,fp7d
2021-07-17,AI,0,0,0,0,2022-05-03_11-02-08,fp7d
2021-07-17,AR,6,6,0,6,2022-05-03_11-02-08,fp7d
2021-07-17,BE,91,80,2,78,2022-05-03_11-02-08,fp7d
2021-07-17,BL,20,16,0,16,2022-05-03_11-02-08,fp7d
2021-07-17,BS,54,50,0,50,2022-05-03_11-02-08,fp7d
2021-07-17,FR,24,24,0,24,2022-05-03_11-02-08,fp7d
2021-07-17,GE,38,45,7,38,2022-05-03_11-02-08,fp7d
2021-07-17,GL,6,6,0,6,2022-05-03_11-02-08,fp7d
2021-07-17,GR,16,16,0,16,2022-05-03_11-02-08,fp7d
2021-07-17,JU,6,6,0,6,2022-05-03_11-02-08,fp7d
2021-07-17,LU,54,50,2,48,2022-05-03_11-02-08,fp7d
2021-07-17,NE,10,10,0,10,2022-05-03_11-02-08,fp7d
2021-07-17,NW,6,5,0,5,2022-05-03_11-02-08,fp7d
2021-07-17,OW,0,0,0,0,2022-05-03_11-02-08,fp7d
2021-07-17,SG,54,55,1,54,2022-05-03_11-02-08,fp7d
2021-07-17,SH,8,8,0,8,2022-05-03_11-02-08,fp7d
2021-07-17,SO,17,17,0,17,2022-05-03_11-02-08,fp7d
2021-07-17,SZ,12,12,0,12,2022-05-03_11-02-08,fp7d
2021-07-17,TG,21,29,8,21,2022-05-03_11-02-08,fp7d
2021-07-17,TI,53,68,15,53,2022-05-03_11-02-08,fp7d
2021-07-17,UR,6,6,0,6,2022-05-03_11-02-08,fp7d
2021-07-17,VD,85,86,1,85,2022-05-03_11-02-08,fp7d
2021-07-17,VS,14,14,0,14,2022-05-03_11-02-08,fp7d
2021-07-17,ZG,8,8,0,8,2022-05-03_11-02-08,fp7d
2021-07-17,ZH,190,199,20,179,2022-05-03_11-02-08,fp7d
2021-07-18,AG,52,50,0,50,2022-05-03_11-02-08,fp7d
2021-07-18,AI,0,0,0,0,2022-05-03_11-02-08,fp7d
2021-07-18,AR,6,6,0,6,2022-05-03_11-02-08,fp7d
2021-07-18,BE,91,78,2,76,2022-05-03_11-02-08,fp7d
2021-07-18,BL,20,16,0,16,2022-05-03_11-02-08,fp7d
2021-07-18,BS,54,50,0,50,2022-05-03_11-02-08,fp7d
2021-07-18,FR,24,24,0,24,2022-05-03_11-02-08,fp7d
2021-07-18,GE,38,45,7,38,2022-05-03_11-02-08,fp7d
2021-07-18,GL,6,6,0,6,2022-05-03_11-02-08,fp7d
2021-07-18,GR,16,16,0,16,2022-05-03_11-02-08,fp7d
2021-07-18,JU,6,6,0,6,2022-05-03_11-02-08,fp7d
2021-07-18,LU,54,50,2,48,2022-05-03_11-02-08,fp7d
2021-07-18,NE,10,10,0,10,2022-05-03_11-02-08,fp7d
2021-07-18,NW,6,5,0,5,2022-05-03_11-02-08,fp7d
2021-07-18,OW,0,0,0,0,2022-05-03_11-02-08,fp7d
2021-07-18,SG,54,55,1,54,2022-05-03_11-02-08,fp7d
2021-07-18,SH,8,8,0,8,2022-05-03_11-02-08,fp7d
2021-07-18,SO,17,17,0,17,2022-05-03_11-02-08,fp7d
2021-07-18,SZ,12,12,0,12,2022-05-03_11-02-08,fp7d
2021-07-18,TG,21,29,8,21,2022-05-03_11-02-08,fp7d
2021-07-18,TI,53,68,15,53,2022-05-03_11-02-08,fp7d
2021-07-18,UR,6,6,0,6,2022-05-03_11-02-08,fp7d
2021-07-18,VD,85,86,1,85,2022-05-03_11-02-08,fp7d
2021-07-18,VS,14,14,0,14,2022-05-03_11-02-08,fp7d
2021-07-18,ZG,8,8,0,8,2022-05-03_11-02-08,fp7d
2021-07-18,ZH,190,198,19,179,2022-05-03_11-02-08,fp7d
2021-07-19,AG,52,50,0,50,2022-05-03_11-02-08,fp7d
2021-07-19,AI,0,0,0,0,2022-05-03_11-02-08,fp7d
2021-07-19,AR,6,6,0,6,2022-05-03_11-02-08,fp7d
2021-07-19,BE,91,76,2,74,2022-05-03_11-02-08,fp7d
2021-07-19,BL,20,16,0,16,2022-05-03_11-02-08,fp7d
2021-07-19,BS,54,50,0,50,2022-05-03_11-02-08,fp7d
2021-07-19,FR,24,24,0,24,2022-05-03_11-02-08,fp7d
2021-07-19,GE,38,45,7,38,2022-05-03_11-02-08,fp7d
2021-07-19,GL,6,6,0,6,2022-05-03_11-02-08,fp7d
2021-07-19,GR,16,16,0,16,2022-05-03_11-02-08,fp7d
2021-07-19,JU,6,6,0,6,2022-05-03_11-02-08,fp7d
2021-07-19,LU,54,50,2,48,2022-05-03_11-02-08,fp7d
2021-07-19,NE,10,10,0,10,2022-05-03_11-02-08,fp7d
2021-07-19,NW,6,5,0,5,2022-05-03_11-02-08,fp7d
2021-07-19,OW,0,0,0,0,2022-05-03_11-02-08,fp7d
2021-07-19,SG,54,55,1,54,2022-05-03_11-02-08,fp7d
2021-07-19,SH,8,8,0,8,2022-05-03_11-02-08,fp7d
2021-07-19,SO,17,17,0,17,2022-05-03_11-02-08,fp7d
2021-07-19,SZ,12,12,0,12,2022-05-03_11-02-08,fp7d
2021-07-19,TG,21,29,8,21,2022-05-03_11-02-08,fp7d
2021-07-19,TI,53,68,15,53,2022-05-03_11-02-08,fp7d
2021-07-19,UR,6,6,0,6,2022-05-03_11-02-08,fp7d
2021-07-19,VD,85,86,1,85,2022-05-03_11-02-08,fp7d
2021-07-19,VS,15,15,0,15,2022-05-03_11-02-08,fp7d
2021-07-19,ZG,8,8,0,8,2022-05-03_11-02-08,fp7d
2021-07-19,ZH,190,198,19,179,2022-05-03_11-02-08,fp7d
2021-07-20,AG,52,48,0,48,2022-05-03_11-02-08,fp7d
2021-07-20,AI,0,0,0,0,2022-05-03_11-02-08,fp7d
2021-07-20,AR,6,6,0,6,2022-05-03_11-02-08,fp7d
2021-07-20,BE,91,80,2,78,2022-05-03_11-02-08,fp7d
2021-07-20,BL,20,16,0,16,2022-05-03_11-02-08,fp7d
2021-07-20,BS,54,50,0,50,2022-05-03_11-02-08,fp7d
2021-07-20,FR,24,24,0,24,2022-05-03_11-02-08,fp7d
2021-07-20,GE,38,45,7,38,2022-05-03_11-02-08,fp7d
2021-07-20,GL,6,6,0,6,2022-05-03_11-02-08,fp7d
2021-07-20,GR,16,16,0,16,2022-05-03_11-02-08,fp7d
2021-07-20,JU,6,6,0,6,2022-05-03_11-02-08,fp7d
2021-07-20,LU,54,50,2,48,2022-05-03_11-02-08,fp7d
2021-07-20,NE,10,10,0,10,2022-05-03_11-02-08,fp7d
2021-07-20,NW,6,5,0,5,2022-05-03_11-02-08,fp7d
2021-07-20,OW,0,0,0,0,2022-05-03_11-02-08,fp7d
2021-07-20,SG,54,55,1,54,2022-05-03_11-02-08,fp7d
2021-07-20,SH,8,8,0,8,2022-05-03_11-02-08,fp7d
2021-07-20,SO,17,17,0,17,2022-05-03_11-02-08,fp7d
2021-07-20,SZ,12,12,0,12,2022-05-03_11-02-08,fp7d
2021-07-20,TG,21,29,8,21,2022-05-03_11-02-08,fp7d
2021-07-20,TI,53,68,15,53,2022-05-03_11-02-08,fp7d
2021-07-20,UR,6,6,0,6,2022-05-03_11-02-08,fp7d
2021-07-20,VD,85,86,1,85,2022-05-03_11-02-08,fp7d
2021-07-20,VS,15,15,0,15,2022-05-03_11-02-08,fp7d
2021-07-20,ZG,8,8,0,8,2022-05-03_11-02-08,fp7d
2021-07-20,ZH,190,198,19,179,2022-05-03_11-02-08,fp7d
2021-07-21,AG,52,48,0,48,2022-05-03_11-02-08,fp7d
2021-07-21,AI,0,0,0,0,2022-05-03_11-02-08,fp7d
2021-07-21,AR,6,6,0,6,2022-05-03_11-02-08,fp7d
2021-07-21,BE,91,78,2,76,2022-05-03_11-02-08,fp7d
2021-07-21,BL,20,16,0,16,2022-05-03_11-02-08,fp7d
2021-07-21,BS,54,50,0,50,2022-05-03_11-02-08,fp7d
2021-07-21,FR,24,24,0,24,2022-05-03_11-02-08,fp7d
2021-07-21,GE,38,45,7,38,2022-05-03_11-02-08,fp7d
2021-07-21,GL,6,6,0,6,2022-05-03_11-02-08,fp7d
2021-07-21,GR,16,16,0,16,2022-05-03_11-02-08,fp7d
2021-07-21,JU,6,6,0,6,2022-05-03_11-02-08,fp7d
2021-07-21,LU,54,50,2,48,2022-05-03_11-02-08,fp7d
2021-07-21,NE,10,10,0,10,2022-05-03_11-02-08,fp7d
2021-07-21,NW,6,5,0,5,2022-05-03_11-02-08,fp7d
2021-07-21,OW,0,0,0,0,2022-05-03_11-02-08,fp7d
2021-07-21,SG,54,55,1,54,2022-05-03_11-02-08,fp7d
2021-07-21,SH,8,8,0,8,2022-05-03_11-02-08,fp7d
2021-07-21,SO,17,17,0,17,2022-05-03_11-02-08,fp7d
2021-07-21,SZ,12,12,0,12,2022-05-03_11-02-08,fp7d
2021-07-21,TG,21,29,8,21,2022-05-03_11-02-08,fp7d
2021-07-21,TI,53,68,15,53,2022-05-03_11-02-08,fp7d
2021-07-21,UR,6,6,0,6,2022-05-03_11-02-08,fp7d
2021-07-21,VD,85,86,1,85,2022-05-03_11-02-08,fp7d
2021-07-21,VS,15,15,0,15,2022-05-03_11-02-08,fp7d
2021-07-21,ZG,8,8,0,8,2022-05-03_11-02-08,fp7d
2021-07-21,ZH,190,198,19,179,2022-05-03_11-02-08,fp7d
2021-07-22,AG,52,48,0,48,2022-05-03_11-02-08,fp7d
2021-07-22,AI,0,0,0,0,2022-05-03_11-02-08,fp7d
2021-07-22,AR,6,6,0,6,2022-05-03_11-02-08,fp7d
2021-07-22,BE,91,78,2,76,2022-05-03_11-02-08,fp7d
2021-07-22,BL,20,16,0,16,2022-05-03_11-02-08,fp7d
2021-07-22,BS,54,50,0,50,2022-05-03_11-02-08,fp7d
2021-07-22,FR,24,24,0,24,2022-05-03_11-02-08,fp7d
2021-07-22,GE,38,45,7,38,2022-05-03_11-02-08,fp7d
2021-07-22,GL,6,6,0,6,2022-05-03_11-02-08,fp7d
2021-07-22,GR,16,16,0,16,2022-05-03_11-02-08,fp7d
2021-07-22,JU,6,6,0,6,2022-05-03_11-02-08,fp7d
2021-07-22,LU,54,50,2,48,2022-05-03_11-02-08,fp7d
2021-07-22,NE,10,10,0,10,2022-05-03_11-02-08,fp7d
2021-07-22,NW,6,5,0,5,2022-05-03_11-02-08,fp7d
2021-07-22,OW,0,0,0,0,2022-05-03_11-02-08,fp7d
2021-07-22,SG,54,55,1,54,2022-05-03_11-02-08,fp7d
2021-07-22,SH,8,8,0,8,2022-05-03_11-02-08,fp7d
2021-07-22,SO,17,17,0,17,2022-05-03_11-02-08,fp7d
2021-07-22,SZ,12,12,0,12,2022-05-03_11-02-08,fp7d
2021-07-22,TG,21,29,8,21,2022-05-03_11-02-08,fp7d
2021-07-22,TI,53,68,15,53,2022-05-03_11-02-08,fp7d
2021-07-22,UR,6,6,0,6,2022-05-03_11-02-08,fp7d
2021-07-22,VD,85,86,1,85,2022-05-03_11-02-08,fp7d
2021-07-22,VS,15,15,0,15,2022-05-03_11-02-08,fp7d
2021-07-22,ZG,8,8,0,8,2022-05-03_11-02-08,fp7d
2021-07-22,ZH,190,200,21,179,2022-05-03_11-02-08,fp7d
2021-07-23,AG,52,48,0,48,2022-05-03_11-02-08,fp7d
2021-07-23,AI,0,0,0,0,2022-05-03_11-02-08,fp7d
2021-07-23,AR,6,6,0,6,2022-05-03_11-02-08,fp7d
2021-07-23,BE,91,78,2,76,2022-05-03_11-02-08,fp7d
2021-07-23,BL,20,16,0,16,2022-05-03_11-02-08,fp7d
2021-07-23,BS,54,50,0,50,2022-05-03_11-02-08,fp7d
2021-07-23,FR,24,24,0,24,2022-05-03_11-02-08,fp7d
2021-07-23,GE,38,45,7,38,2022-05-03_11-02-08,fp7d
2021-07-23,GL,6,6,0,6,2022-05-03_11-02-08,fp7d
2021-07-23,GR,16,16,0,16,2022-05-03_11-02-08,fp7d
2021-07-23,JU,6,6,0,6,2022-05-03_11-02-08,fp7d
2021-07-23,LU,54,50,2,48,2022-05-03_11-02-08,fp7d
2021-07-23,NE,10,10,0,10,2022-05-03_11-02-08,fp7d
2021-07-23,NW,6,5,0,5,2022-05-03_11-02-08,fp7d
2021-07-23,OW,0,0,0,0,2022-05-03_11-02-08,fp7d
2021-07-23,SG,54,55,1,54,2022-05-03_11-02-08,fp7d
2021-07-23,SH,8,8,0,8,2022-05-03_11-02-08,fp7d
2021-07-23,SO,17,17,0,17,2022-05-03_11-02-08,fp7d
2021-07-23,SZ,12,12,0,12,2022-05-03_11-02-08,fp7d
2021-07-23,TG,21,29,8,21,2022-05-03_11-02-08,fp7d
2021-07-23,TI,53,68,15,53,2022-05-03_11-02-08,fp7d
2021-07-23,UR,6,6,0,6,2022-05-03_11-02-08,fp7d
2021-07-23,VD,85,86,1,85,2022-05-03_11-02-08,fp7d
2021-07-23,VS,21,21,0,21,2022-05-03_11-02-08,fp7d
2021-07-23,ZG,8,8,0,8,2022-05-03_11-02-08,fp7d
2021-07-23,ZH,190,198,19,179,2022-05-03_11-02-08,fp7d
2021-07-24,AG,52,48,0,48,2022-05-03_11-02-08,fp7d
2021-07-24,AI,0,0,0,0,2022-05-03_11-02-08,fp7d
2021-07-24,AR,6,6,0,6,2022-05-03_11-02-08,fp7d
2021-07-24,BE,91,78,2,76,2022-05-03_11-02-08,fp7d
2021-07-24,BL,20,16,0,16,2022-05-03_11-02-08,fp7d
2021-07-24,BS,54,50,0,50,2022-05-03_11-02-08,fp7d
2021-07-24,FR,24,24,0,24,2022-05-03_11-02-08,fp7d
2021-07-24,GE,38,45,7,38,2022-05-03_11-02-08,fp7d
2021-07-24,GL,6,6,0,6,2022-05-03_11-02-08,fp7d
2021-07-24,GR,16,16,0,16,2022-05-03_11-02-08,fp7d
2021-07-24,JU,6,6,0,6,2022-05-03_11-02-08,fp7d
2021-07-24,LU,54,48,0,48,2022-05-03_11-02-08,fp7d
2021-07-24,NE,10,10,0,10,2022-05-03_11-02-08,fp7d
2021-07-24,NW,6,5,0,5,2022-05-03_11-02-08,fp7d
2021-07-24,OW,0,0,0,0,2022-05-03_11-02-08,fp7d
2021-07-24,SG,54,55,1,54,2022-05-03_11-02-08,fp7d
2021-07-24,SH,8,8,0,8,2022-05-03_11-02-08,fp7d
2021-07-24,SO,17,17,0,17,2022-05-03_11-02-08,fp7d
2021-07-24,SZ,12,12,0,12,2022-05-03_11-02-08,fp7d
2021-07-24,TG,21,29,8,21,2022-05-03_11-02-08,fp7d
2021-07-24,TI,53,68,15,53,2022-05-03_11-02-08,fp7d
2021-07-24,UR,6,6,0,6,2022-05-03_11-02-08,fp7d
2021-07-24,VD,85,86,1,85,2022-05-03_11-02-08,fp7d
2021-07-24,VS,21,21,0,21,2022-05-03_11-02-08,fp7d
2021-07-24,ZG,8,8,0,8,2022-05-03_11-02-08,fp7d
2021-07-24,ZH,190,198,19,179,2022-05-03_11-02-08,fp7d
2021-07-25,AG,52,48,0,48,2022-05-03_11-02-08,fp7d
2021-07-25,AI,0,0,0,0,2022-05-03_11-02-08,fp7d
2021-07-25,AR,6,6,0,6,2022-05-03_11-02-08,fp7d
2021-07-25,BE,91,78,2,76,2022-05-03_11-02-08,fp7d
2021-07-25,BL,20,16,0,16,2022-05-03_11-02-08,fp7d
2021-07-25,BS,54,50,0,50,2022-05-03_11-02-08,fp7d
2021-07-25,FR,24,24,0,24,2022-05-03_11-02-08,fp7d
2021-07-25,GE,38,45,7,38,2022-05-03_11-02-08,fp7d
2021-07-25,GL,6,6,0,6,2022-05-03_11-02-08,fp7d
2021-07-25,GR,16,16,0,16,2022-05-03_11-02-08,fp7d
2021-07-25,JU,6,6,0,6,2022-05-03_11-02-08,fp7d
2021-07-25,LU,54,48,0,48,2022-05-03_11-02-08,fp7d
2021-07-25,NE,10,10,0,10,2022-05-03_11-02-08,fp7d
2021-07-25,NW,6,5,0,5,2022-05-03_11-02-08,fp7d
2021-07-25,OW,0,0,0,0,2022-05-03_11-02-08,fp7d
2021-07-25,SG,54,55,1,54,2022-05-03_11-02-08,fp7d
2021-07-25,SH,8,8,0,8,2022-05-03_11-02-08,fp7d
2021-07-25,SO,17,17,0,17,2022-05-03_11-02-08,fp7d
2021-07-25,SZ,12,12,0,12,2022-05-03_11-02-08,fp7d
2021-07-25,TG,21,29,8,21,2022-05-03_11-02-08,fp7d
2021-07-25,TI,53,68,15,53,2022-05-03_11-02-08,fp7d
2021-07-25,UR,6,6,0,6,2022-05-03_11-02-08,fp7d
2021-07-25,VD,85,86,1,85,2022-05-03_11-02-08,fp7d
2021-07-25,VS,21,21,0,21,2022-05-03_11-02-08,fp7d
2021-07-25,ZG,8,8,0,8,2022-05-03_11-02-08,fp7d
2021-07-25,ZH,190,198,19,179,2022-05-03_11-02-08,fp7d
2021-07-26,AG,52,50,0,50,2022-05-03_11-02-08,fp7d
2021-07-26,AI,0,0,0,0,2022-05-03_11-02-08,fp7d
2021-07-26,AR,6,6,0,6,2022-05-03_11-02-08,fp7d
2021-07-26,BE,91,77,2,75,2022-05-03_11-02-08,fp7d
2021-07-26,BL,20,16,0,16,2022-05-03_11-02-08,fp7d
2021-07-26,BS,54,50,0,50,2022-05-03_11-02-08,fp7d
2021-07-26,FR,24,24,0,24,2022-05-03_11-02-08,fp7d
2021-07-26,GE,38,45,7,38,2022-05-03_11-02-08,fp7d
2021-07-26,GL,6,6,0,6,2022-05-03_11-02-08,fp7d
2021-07-26,GR,16,16,0,16,2022-05-03_11-02-08,fp7d
2021-07-26,JU,6,6,0,6,2022-05-03_11-02-08,fp7d
2021-07-26,LU,54,48,0,48,2022-05-03_11-02-08,fp7d
2021-07-26,NE,10,10,0,10,2022-05-03_11-02-08,fp7d
2021-07-26,NW,6,5,0,5,2022-05-03_11-02-08,fp7d
2021-07-26,OW,0,0,0,0,2022-05-03_11-02-08,fp7d
2021-07-26,SG,54,55,1,54,2022-05-03_11-02-08,fp7d
2021-07-26,SH,8,8,0,8,2022-05-03_11-02-08,fp7d
2021-07-26,SO,17,17,0,17,2022-05-03_11-02-08,fp7d
2021-07-26,SZ,12,12,0,12,2022-05-03_11-02-08,fp7d
2021-07-26,TG,21,29,8,21,2022-05-03_11-02-08,fp7d
2021-07-26,TI,53,68,15,53,2022-05-03_11-02-08,fp7d
2021-07-26,UR,6,6,0,6,2022-05-03_11-02-08,fp7d
2021-07-26,VD,85,86,1,85,2022-05-03_11-02-08,fp7d
2021-07-26,VS,21,21,0,21,2022-05-03_11-02-08,fp7d
2021-07-26,ZG,8,8,0,8,2022-05-03_11-02-08,fp7d
2021-07-26,ZH,190,199,20,179,2022-05-03_11-02-08,fp7d
2021-07-27,AG,52,48,0,48,2022-05-03_11-02-08,fp7d
2021-07-27,AI,0,0,0,0,2022-05-03_11-02-08,fp7d
2021-07-27,AR,6,6,0,6,2022-05-03_11-02-08,fp7d
2021-07-27,BE,91,77,2,75,2022-05-03_11-02-08,fp7d
2021-07-27,BL,20,16,0,16,2022-05-03_11-02-08,fp7d
2021-07-27,BS,54,50,0,50,2022-05-03_11-02-08,fp7d
2021-07-27,FR,24,24,0,24,2022-05-03_11-02-08,fp7d
2021-07-27,GE,38,45,7,38,2022-05-03_11-02-08,fp7d
2021-07-27,GL,6,6,0,6,2022-05-03_11-02-08,fp7d
2021-07-27,GR,16,18,2,16,2022-05-03_11-02-08,fp7d
2021-07-27,JU,6,6,0,6,2022-05-03_11-02-08,fp7d
2021-07-27,LU,54,48,0,48,2022-05-03_11-02-08,fp7d
2021-07-27,NE,10,10,0,10,2022-05-03_11-02-08,fp7d
2021-07-27,NW,6,5,0,5,2022-05-03_11-02-08,fp7d
2021-07-27,OW,0,0,0,0,2022-05-03_11-02-08,fp7d
2021-07-27,SG,54,55,1,54,2022-05-03_11-02-08,fp7d
2021-07-27,SH,8,8,0,8,2022-05-03_11-02-08,fp7d
2021-07-27,SO,17,17,0,17,2022-05-03_11-02-08,fp7d
2021-07-27,SZ,12,12,0,12,2022-05-03_11-02-08,fp7d
2021-07-27,TG,21,29,8,21,2022-05-03_11-02-08,fp7d
2021-07-27,TI,53,68,15,53,2022-05-03_11-02-08,fp7d
2021-07-27,UR,6,6,0,6,2022-05-03_11-02-08,fp7d
2021-07-27,VD,85,86,1,85,2022-05-03_11-02-08,fp7d
2021-07-27,VS,21,21,0,21,2022-05-03_11-02-08,fp7d
2021-07-27,ZG,8,8,0,8,2022-05-03_11-02-08,fp7d
2021-07-27,ZH,190,199,20,179,2022-05-03_11-02-08,fp7d
2021-07-28,AG,52,48,0,48,2022-05-03_11-02-08,fp7d
2021-07-28,AI,0,0,0,0,2022-05-03_11-02-08,fp7d
2021-07-28,AR,6,6,0,6,2022-05-03_11-02-08,fp7d
2021-07-28,BE,91,77,2,75,2022-05-03_11-02-08,fp7d
2021-07-28,BL,20,16,0,16,2022-05-03_11-02-08,fp7d
2021-07-28,BS,54,50,0,50,2022-05-03_11-02-08,fp7d
2021-07-28,FR,24,24,0,24,2022-05-03_11-02-08,fp7d
2021-07-28,GE,38,45,7,38,2022-05-03_11-02-08,fp7d
2021-07-28,GL,6,6,0,6,2022-05-03_11-02-08,fp7d
2021-07-28,GR,16,16,0,16,2022-05-03_11-02-08,fp7d
2021-07-28,JU,6,6,0,6,2022-05-03_11-02-08,fp7d
2021-07-28,LU,54,48,0,48,2022-05-03_11-02-08,fp7d
2021-07-28,NE,10,10,0,10,2022-05-03_11-02-08,fp7d
2021-07-28,NW,6,5,0,5,2022-05-03_11-02-08,fp7d
2021-07-28,OW,0,0,0,0,2022-05-03_11-02-08,fp7d
2021-07-28,SG,54,55,1,54,2022-05-03_11-02-08,fp7d
2021-07-28,SH,8,8,0,8,2022-05-03_11-02-08,fp7d
2021-07-28,SO,17,17,0,17,2022-05-03_11-02-08,fp7d
2021-07-28,SZ,12,12,0,12,2022-05-03_11-02-08,fp7d
2021-07-28,TG,21,29,8,21,2022-05-03_11-02-08,fp7d
2021-07-28,TI,53,68,15,53,2022-05-03_11-02-08,fp7d
2021-07-28,UR,6,6,0,6,2022-05-03_11-02-08,fp7d
2021-07-28,VD,85,86,1,85,2022-05-03_11-02-08,fp7d
2021-07-28,VS,21,21,0,21,2022-05-03_11-02-08,fp7d
2021-07-28,ZG,8,8,0,8,2022-05-03_11-02-08,fp7d
2021-07-28,ZH,190,199,20,179,2022-05-03_11-02-08,fp7d
2021-07-29,AG,52,48,0,48,2022-05-03_11-02-08,fp7d
2021-07-29,AI,0,0,0,0,2022-05-03_11-02-08,fp7d
2021-07-29,AR,6,6,0,6,2022-05-03_11-02-08,fp7d
2021-07-29,BE,91,78,2,76,2022-05-03_11-02-08,fp7d
2021-07-29,BL,20,16,0,16,2022-05-03_11-02-08,fp7d
2021-07-29,BS,54,50,0,50,2022-05-03_11-02-08,fp7d
2021-07-29,FR,24,24,0,24,2022-05-03_11-02-08,fp7d
2021-07-29,GE,38,45,7,38,2022-05-03_11-02-08,fp7d
2021-07-29,GL,6,6,0,6,2022-05-03_11-02-08,fp7d
2021-07-29,GR,16,16,0,16,2022-05-03_11-02-08,fp7d
2021-07-29,JU,6,6,0,6,2022-05-03_11-02-08,fp7d
2021-07-29,LU,54,48,0,48,2022-05-03_11-02-08,fp7d
2021-07-29,NE,10,10,0,10,2022-05-03_11-02-08,fp7d
2021-07-29,NW,6,5,0,5,2022-05-03_11-02-08,fp7d
2021-07-29,OW,0,0,0,0,2022-05-03_11-02-08,fp7d
2021-07-29,SG,54,55,1,54,2022-05-03_11-02-08,fp7d
2021-07-29,SH,8,8,0,8,2022-05-03_11-02-08,fp7d
2021-07-29,SO,17,17,0,17,2022-05-03_11-02-08,fp7d
2021-07-29,SZ,12,12,0,12,2022-05-03_11-02-08,fp7d
2021-07-29,TG,21,29,8,21,2022-05-03_11-02-08,fp7d
2021-07-29,TI,53,68,15,53,2022-05-03_11-02-08,fp7d
2021-07-29,UR,6,6,0,6,2022-05-03_11-02-08,fp7d
2021-07-29,VD,85,86,1,85,2022-05-03_11-02-08,fp7d
2021-07-29,VS,21,21,0,21,2022-05-03_11-02-08,fp7d
2021-07-29,ZG,8,8,0,8,2022-05-03_11-02-08,fp7d
2021-07-29,ZH,190,199,20,179,2022-05-03_11-02-08,fp7d
2021-07-30,AG,52,48,0,48,2022-05-03_11-02-08,fp7d
2021-07-30,AI,0,0,0,0,2022-05-03_11-02-08,fp7d
2021-07-30,AR,6,6,0,6,2022-05-03_11-02-08,fp7d
2021-07-30,BE,91,80,2,78,2022-05-03_11-02-08,fp7d
2021-07-30,BL,20,16,0,16,2022-05-03_11-02-08,fp7d
2021-07-30,BS,54,50,0,50,2022-05-03_11-02-08,fp7d
2021-07-30,FR,24,24,0,24,2022-05-03_11-02-08,fp7d
2021-07-30,GE,38,45,7,38,2022-05-03_11-02-08,fp7d
2021-07-30,GL,6,6,0,6,2022-05-03_11-02-08,fp7d
2021-07-30,GR,16,16,0,16,2022-05-03_11-02-08,fp7d
2021-07-30,JU,6,6,0,6,2022-05-03_11-02-08,fp7d
2021-07-30,LU,54,50,2,48,2022-05-03_11-02-08,fp7d
2021-07-30,NE,10,10,0,10,2022-05-03_11-02-08,fp7d
2021-07-30,NW,6,5,0,5,2022-05-03_11-02-08,fp7d
2021-07-30,OW,0,0,0,0,2022-05-03_11-02-08,fp7d
2021-07-30,SG,54,55,1,54,2022-05-03_11-02-08,fp7d
2021-07-30,SH,8,8,0,8,2022-05-03_11-02-08,fp7d
2021-07-30,SO,17,17,0,17,2022-05-03_11-02-08,fp7d
2021-07-30,SZ,12,12,0,12,2022-05-03_11-02-08,fp7d
2021-07-30,TG,21,29,8,21,2022-05-03_11-02-08,fp7d
2021-07-30,TI,53,68,15,53,2022-05-03_11-02-08,fp7d
2021-07-30,UR,6,6,0,6,2022-05-03_11-02-08,fp7d
2021-07-30,VD,85,86,1,85,2022-05-03_11-02-08,fp7d
2021-07-30,VS,21,21,0,21,2022-05-03_11-02-08,fp7d
2021-07-30,ZG,8,8,0,8,2022-05-03_11-02-08,fp7d
2021-07-30,ZH,190,199,20,179,2022-05-03_11-02-08,fp7d
2021-07-31,AG,52,48,0,48,2022-05-03_11-02-08,fp7d
2021-07-31,AI,0,0,0,0,2022-05-03_11-02-08,fp7d
2021-07-31,AR,6,6,0,6,2022-05-03_11-02-08,fp7d
2021-07-31,BE,91,80,2,78,2022-05-03_11-02-08,fp7d
2021-07-31,BL,20,16,0,16,2022-05-03_11-02-08,fp7d
2021-07-31,BS,54,50,0,50,2022-05-03_11-02-08,fp7d
2021-07-31,FR,24,24,0,24,2022-05-03_11-02-08,fp7d
2021-07-31,GE,38,45,7,38,2022-05-03_11-02-08,fp7d
2021-07-31,GL,6,6,0,6,2022-05-03_11-02-08,fp7d
2021-07-31,GR,16,16,0,16,2022-05-03_11-02-08,fp7d
2021-07-31,JU,6,6,0,6,2022-05-03_11-02-08,fp7d
2021-07-31,LU,54,50,2,48,2022-05-03_11-02-08,fp7d
2021-07-31,NE,10,10,0,10,2022-05-03_11-02-08,fp7d
2021-07-31,NW,6,5,0,5,2022-05-03_11-02-08,fp7d
2021-07-31,OW,0,0,0,0,2022-05-03_11-02-08,fp7d
2021-07-31,SG,54,55,1,54,2022-05-03_11-02-08,fp7d
2021-07-31,SH,8,8,0,8,2022-05-03_11-02-08,fp7d
2021-07-31,SO,17,17,0,17,2022-05-03_11-02-08,fp7d
2021-07-31,SZ,12,12,0,12,2022-05-03_11-02-08,fp7d
2021-07-31,TG,21,29,8,21,2022-05-03_11-02-08,fp7d
2021-07-31,TI,53,68,15,53,2022-05-03_11-02-08,fp7d
2021-07-31,UR,6,6,0,6,2022-05-03_11-02-08,fp7d
2021-07-31,VD,85,86,1,85,2022-05-03_11-02-08,fp7d
2021-07-31,VS,21,21,0,21,2022-05-03_11-02-08,fp7d
2021-07-31,ZG,8,8,0,8,2022-05-03_11-02-08,fp7d
2021-07-31,ZH,190,197,18,179,2022-05-03_11-02-08,fp7d
2021-08-01,AG,52,48,0,48,2022-05-03_11-02-08,fp7d
2021-08-01,AI,0,0,0,0,2022-05-03_11-02-08,fp7d
2021-08-01,AR,6,6,0,6,2022-05-03_11-02-08,fp7d
2021-08-01,BE,91,80,2,78,2022-05-03_11-02-08,fp7d
2021-08-01,BL,20,16,0,16,2022-05-03_11-02-08,fp7d
2021-08-01,BS,54,50,0,50,2022-05-03_11-02-08,fp7d
2021-08-01,FR,24,24,0,24,2022-05-03_11-02-08,fp7d
2021-08-01,GE,38,45,7,38,2022-05-03_11-02-08,fp7d
2021-08-01,GL,6,6,0,6,2022-05-03_11-02-08,fp7d
2021-08-01,GR,16,16,0,16,2022-05-03_11-02-08,fp7d
2021-08-01,JU,6,6,0,6,2022-05-03_11-02-08,fp7d
2021-08-01,LU,54,48,0,48,2022-05-03_11-02-08,fp7d
2021-08-01,NE,10,10,0,10,2022-05-03_11-02-08,fp7d
2021-08-01,NW,6,5,0,5,2022-05-03_11-02-08,fp7d
2021-08-01,OW,0,0,0,0,2022-05-03_11-02-08,fp7d
2021-08-01,SG,54,55,1,54,2022-05-03_11-02-08,fp7d
2021-08-01,SH,8,8,0,8,2022-05-03_11-02-08,fp7d
2021-08-01,SO,17,17,0,17,2022-05-03_11-02-08,fp7d
2021-08-01,SZ,12,12,0,12,2022-05-03_11-02-08,fp7d
2021-08-01,TG,21,29,8,21,2022-05-03_11-02-08,fp7d
2021-08-01,TI,53,68,15,53,2022-05-03_11-02-08,fp7d
2021-08-01,UR,6,6,0,6,2022-05-03_11-02-08,fp7d
2021-08-01,VD,85,86,1,85,2022-05-03_11-02-08,fp7d
2021-08-01,VS,21,21,0,21,2022-05-03_11-02-08,fp7d
2021-08-01,ZG,8,8,0,8,2022-05-03_11-02-08,fp7d
2021-08-01,ZH,190,198,19,179,2022-05-03_11-02-08,fp7d
2021-08-02,AG,52,48,0,48,2022-05-03_11-02-08,fp7d
2021-08-02,AI,0,0,0,0,2022-05-03_11-02-08,fp7d
2021-08-02,AR,6,6,0,6,2022-05-03_11-02-08,fp7d
2021-08-02,BE,91,80,2,78,2022-05-03_11-02-08,fp7d
2021-08-02,BL,20,16,0,16,2022-05-03_11-02-08,fp7d
2021-08-02,BS,54,50,0,50,2022-05-03_11-02-08,fp7d
2021-08-02,FR,24,24,0,24,2022-05-03_11-02-08,fp7d
2021-08-02,GE,38,45,7,38,2022-05-03_11-02-08,fp7d
2021-08-02,GL,6,6,0,6,2022-05-03_11-02-08,fp7d
2021-08-02,GR,16,16,0,16,2022-05-03_11-02-08,fp7d
2021-08-02,JU,6,6,0,6,2022-05-03_11-02-08,fp7d
2021-08-02,LU,54,48,0,48,2022-05-03_11-02-08,fp7d
2021-08-02,NE,10,10,0,10,2022-05-03_11-02-08,fp7d
2021-08-02,NW,6,5,0,5,2022-05-03_11-02-08,fp7d
2021-08-02,OW,0,0,0,0,2022-05-03_11-02-08,fp7d
2021-08-02,SG,54,55,1,54,2022-05-03_11-02-08,fp7d
2021-08-02,SH,8,8,0,8,2022-05-03_11-02-08,fp7d
2021-08-02,SO,17,17,0,17,2022-05-03_11-02-08,fp7d
2021-08-02,SZ,12,12,0,12,2022-05-03_11-02-08,fp7d
2021-08-02,TG,21,29,8,21,2022-05-03_11-02-08,fp7d
2021-08-02,TI,53,68,15,53,2022-05-03_11-02-08,fp7d
2021-08-02,UR,6,6,0,6,2022-05-03_11-02-08,fp7d
2021-08-02,VD,85,86,1,85,2022-05-03_11-02-08,fp7d
2021-08-02,VS,21,21,0,21,2022-05-03_11-02-08,fp7d
2021-08-02,ZG,8,8,0,8,2022-05-03_11-02-08,fp7d
2021-08-02,ZH,190,195,19,176,2022-05-03_11-02-08,fp7d
2021-08-03,AG,52,48,0,48,2022-05-03_11-02-08,fp7d
2021-08-03,AI,0,0,0,0,2022-05-03_11-02-08,fp7d
2021-08-03,AR,6,6,0,6,2022-05-03_11-02-08,fp7d
2021-08-03,BE,91,80,2,78,2022-05-03_11-02-08,fp7d
2021-08-03,BL,20,16,0,16,2022-05-03_11-02-08,fp7d
2021-08-03,BS,54,50,0,50,2022-05-03_11-02-08,fp7d
2021-08-03,FR,24,24,0,24,2022-05-03_11-02-08,fp7d
2021-08-03,GE,38,45,7,38,2022-05-03_11-02-08,fp7d
2021-08-03,GL,6,6,0,6,2022-05-03_11-02-08,fp7d
2021-08-03,GR,16,16,0,16,2022-05-03_11-02-08,fp7d
2021-08-03,JU,6,6,0,6,2022-05-03_11-02-08,fp7d
2021-08-03,LU,54,48,0,48,2022-05-03_11-02-08,fp7d
2021-08-03,NE,10,10,0,10,2022-05-03_11-02-08,fp7d
2021-08-03,NW,6,5,0,5,2022-05-03_11-02-08,fp7d
2021-08-03,OW,0,0,0,0,2022-05-03_11-02-08,fp7d
2021-08-03,SG,54,55,1,54,2022-05-03_11-02-08,fp7d
2021-08-03,SH,8,6,0,6,2022-05-03_11-02-08,fp7d
2021-08-03,SO,17,17,0,17,2022-05-03_11-02-08,fp7d
2021-08-03,SZ,12,12,0,12,2022-05-03_11-02-08,fp7d
2021-08-03,TG,21,29,8,21,2022-05-03_11-02-08,fp7d
2021-08-03,TI,53,68,15,53,2022-05-03_11-02-08,fp7d
2021-08-03,UR,6,6,0,6,2022-05-03_11-02-08,fp7d
2021-08-03,VD,85,86,1,85,2022-05-03_11-02-08,fp7d
2021-08-03,VS,21,21,0,21,2022-05-03_11-02-08,fp7d
2021-08-03,ZG,8,8,0,8,2022-05-03_11-02-08,fp7d
2021-08-03,ZH,190,196,19,177,2022-05-03_11-02-08,fp7d
2021-08-04,AG,52,48,0,48,2022-05-03_11-02-08,fp7d
2021-08-04,AI,0,0,0,0,2022-05-03_11-02-08,fp7d
2021-08-04,AR,6,6,0,6,2022-05-03_11-02-08,fp7d
2021-08-04,BE,91,80,2,78,2022-05-03_11-02-08,fp7d
2021-08-04,BL,20,16,0,16,2022-05-03_11-02-08,fp7d
2021-08-04,BS,54,50,0,50,2022-05-03_11-02-08,fp7d
2021-08-04,FR,24,24,0,24,2022-05-03_11-02-08,fp7d
2021-08-04,GE,38,45,7,38,2022-05-03_11-02-08,fp7d
2021-08-04,GL,6,6,0,6,2022-05-03_11-02-08,fp7d
2021-08-04,GR,16,16,0,16,2022-05-03_11-02-08,fp7d
2021-08-04,JU,6,6,0,6,2022-05-03_11-02-08,fp7d
2021-08-04,LU,54,50,2,48,2022-05-03_11-02-08,fp7d
2021-08-04,NE,10,10,0,10,2022-05-03_11-02-08,fp7d
2021-08-04,NW,6,5,0,5,2022-05-03_11-02-08,fp7d
2021-08-04,OW,0,0,0,0,2022-05-03_11-02-08,fp7d
2021-08-04,SG,54,55,1,54,2022-05-03_11-02-08,fp7d
2021-08-04,SH,8,6,0,6,2022-05-03_11-02-08,fp7d
2021-08-04,SO,17,17,0,17,2022-05-03_11-02-08,fp7d
2021-08-04,SZ,12,12,0,12,2022-05-03_11-02-08,fp7d
2021-08-04,TG,21,29,8,21,2022-05-03_11-02-08,fp7d
2021-08-04,TI,53,68,15,53,2022-05-03_11-02-08,fp7d
2021-08-04,UR,6,6,0,6,2022-05-03_11-02-08,fp7d
2021-08-04,VD,85,86,1,85,2022-05-03_11-02-08,fp7d
2021-08-04,VS,21,21,0,21,2022-05-03_11-02-08,fp7d
2021-08-04,ZG,8,8,0,8,2022-05-03_11-02-08,fp7d
2021-08-04,ZH,190,196,19,177,2022-05-03_11-02-08,fp7d
2021-08-05,AG,52,48,0,48,2022-05-03_11-02-08,fp7d
2021-08-05,AI,0,0,0,0,2022-05-03_11-02-08,fp7d
2021-08-05,AR,6,6,0,6,2022-05-03_11-02-08,fp7d
2021-08-05,BE,91,80,2,78,2022-05-03_11-02-08,fp7d
2021-08-05,BL,20,16,0,16,2022-05-03_11-02-08,fp7d
2021-08-05,BS,54,50,0,50,2022-05-03_11-02-08,fp7d
2021-08-05,FR,24,24,0,24,2022-05-03_11-02-08,fp7d
2021-08-05,GE,38,45,7,38,2022-05-03_11-02-08,fp7d
2021-08-05,GL,6,6,0,6,2022-05-03_11-02-08,fp7d
2021-08-05,GR,16,16,0,16,2022-05-03_11-02-08,fp7d
2021-08-05,JU,6,6,0,6,2022-05-03_11-02-08,fp7d
2021-08-05,LU,54,50,2,48,2022-05-03_11-02-08,fp7d
2021-08-05,NE,10,10,0,10,2022-05-03_11-02-08,fp7d
2021-08-05,NW,6,5,0,5,2022-05-03_11-02-08,fp7d
2021-08-05,OW,0,0,0,0,2022-05-03_11-02-08,fp7d
2021-08-05,SG,54,55,1,54,2022-05-03_11-02-08,fp7d
2021-08-05,SH,8,6,0,6,2022-05-03_11-02-08,fp7d
2021-08-05,SO,17,17,0,17,2022-05-03_11-02-08,fp7d
2021-08-05,SZ,12,12,0,12,2022-05-03_11-02-08,fp7d
2021-08-05,TG,21,29,8,21,2022-05-03_11-02-08,fp7d
2021-08-05,TI,53,68,15,53,2022-05-03_11-02-08,fp7d
2021-08-05,UR,6,6,0,6,2022-05-03_11-02-08,fp7d
2021-08-05,VD,85,86,1,85,2022-05-03_11-02-08,fp7d
2021-08-05,VS,21,21,0,21,2022-05-03_11-02-08,fp7d
2021-08-05,ZG,8,8,0,8,2022-05-03_11-02-08,fp7d
2021-08-05,ZH,190,194,19,175,2022-05-03_11-02-08,fp7d
2021-08-06,AG,52,48,0,48,2022-05-03_11-02-08,fp7d
2021-08-06,AI,0,0,0,0,2022-05-03_11-02-08,fp7d
2021-08-06,AR,6,6,0,6,2022-05-03_11-02-08,fp7d
2021-08-06,BE,91,80,2,78,2022-05-03_11-02-08,fp7d
2021-08-06,BL,20,16,0,16,2022-05-03_11-02-08,fp7d
2021-08-06,BS,54,50,0,50,2022-05-03_11-02-08,fp7d
2021-08-06,FR,24,24,0,24,2022-05-03_11-02-08,fp7d
2021-08-06,GE,38,47,9,38,2022-05-03_11-02-08,fp7d
2021-08-06,GL,6,6,0,6,2022-05-03_11-02-08,fp7d
2021-08-06,GR,16,16,0,16,2022-05-03_11-02-08,fp7d
2021-08-06,JU,6,6,0,6,2022-05-03_11-02-08,fp7d
2021-08-06,LU,54,50,2,48,2022-05-03_11-02-08,fp7d
2021-08-06,NE,10,10,0,10,2022-05-03_11-02-08,fp7d
2021-08-06,NW,6,5,0,5,2022-05-03_11-02-08,fp7d
2021-08-06,OW,0,0,0,0,2022-05-03_11-02-08,fp7d
2021-08-06,SG,54,55,1,54,2022-05-03_11-02-08,fp7d
2021-08-06,SH,8,6,0,6,2022-05-03_11-02-08,fp7d
2021-08-06,SO,17,17,0,17,2022-05-03_11-02-08,fp7d
2021-08-06,SZ,12,12,0,12,2022-05-03_11-02-08,fp7d
2021-08-06,TG,21,29,8,21,2022-05-03_11-02-08,fp7d
2021-08-06,TI,53,68,15,53,2022-05-03_11-02-08,fp7d
2021-08-06,UR,6,6,0,6,2022-05-03_11-02-08,fp7d
2021-08-06,VD,85,86,1,85,2022-05-03_11-02-08,fp7d
2021-08-06,VS,21,21,0,21,2022-05-03_11-02-08,fp7d
2021-08-06,ZG,8,8,0,8,2022-05-03_11-02-08,fp7d
2021-08-06,ZH,190,190,19,171,2022-05-03_11-02-08,fp7d
2021-08-07,AG,52,48,0,48,2022-05-03_11-02-08,fp7d
2021-08-07,AI,0,0,0,0,2022-05-03_11-02-08,fp7d
2021-08-07,AR,6,6,0,6,2022-05-03_11-02-08,fp7d
2021-08-07,BE,91,80,2,78,2022-05-03_11-02-08,fp7d
2021-08-07,BL,20,16,0,16,2022-05-03_11-02-08,fp7d
2021-08-07,BS,54,50,0,50,2022-05-03_11-02-08,fp7d
2021-08-07,FR,24,24,0,24,2022-05-03_11-02-08,fp7d
2021-08-07,GE,38,47,9,38,2022-05-03_11-02-08,fp7d
2021-08-07,GL,6,6,0,6,2022-05-03_11-02-08,fp7d
2021-08-07,GR,16,16,0,16,2022-05-03_11-02-08,fp7d
2021-08-07,JU,6,6,0,6,2022-05-03_11-02-08,fp7d
2021-08-07,LU,54,50,2,48,2022-05-03_11-02-08,fp7d
2021-08-07,NE,10,10,0,10,2022-05-03_11-02-08,fp7d
2021-08-07,NW,6,5,0,5,2022-05-03_11-02-08,fp7d
2021-08-07,OW,0,0,0,0,2022-05-03_11-02-08,fp7d
2021-08-07,SG,54,55,1,54,2022-05-03_11-02-08,fp7d
2021-08-07,SH,8,6,0,6,2022-05-03_11-02-08,fp7d
2021-08-07,SO,17,17,0,17,2022-05-03_11-02-08,fp7d
2021-08-07,SZ,12,12,0,12,2022-05-03_11-02-08,fp7d
2021-08-07,TG,21,29,8,21,2022-05-03_11-02-08,fp7d
2021-08-07,TI,53,68,15,53,2022-05-03_11-02-08,fp7d
2021-08-07,UR,6,6,0,6,2022-05-03_11-02-08,fp7d
2021-08-07,VD,85,86,1,85,2022-05-03_11-02-08,fp7d
2021-08-07,VS,21,21,0,21,2022-05-03_11-02-08,fp7d
2021-08-07,ZG,8,8,0,8,2022-05-03_11-02-08,fp7d
2021-08-07,ZH,190,192,19,173,2022-05-03_11-02-08,fp7d
2021-08-08,AG,52,48,0,48,2022-05-03_11-02-08,fp7d
2021-08-08,AI,0,0,0,0,2022-05-03_11-02-08,fp7d
2021-08-08,AR,6,6,0,6,2022-05-03_11-02-08,fp7d
2021-08-08,BE,91,78,2,76,2022-05-03_11-02-08,fp7d
2021-08-08,BL,20,16,0,16,2022-05-03_11-02-08,fp7d
2021-08-08,BS,54,50,0,50,2022-05-03_11-02-08,fp7d
2021-08-08,FR,24,24,0,24,2022-05-03_11-02-08,fp7d
2021-08-08,GE,38,47,9,38,2022-05-03_11-02-08,fp7d
2021-08-08,GL,6,6,0,6,2022-05-03_11-02-08,fp7d
2021-08-08,GR,16,16,0,16,2022-05-03_11-02-08,fp7d
2021-08-08,JU,6,6,0,6,2022-05-03_11-02-08,fp7d
2021-08-08,LU,54,50,2,48,2022-05-03_11-02-08,fp7d
2021-08-08,NE,10,10,0,10,2022-05-03_11-02-08,fp7d
2021-08-08,NW,6,5,0,5,2022-05-03_11-02-08,fp7d
2021-08-08,OW,0,0,0,0,2022-05-03_11-02-08,fp7d
2021-08-08,SG,54,55,1,54,2022-05-03_11-02-08,fp7d
2021-08-08,SH,8,6,0,6,2022-05-03_11-02-08,fp7d
2021-08-08,SO,17,17,0,17,2022-05-03_11-02-08,fp7d
2021-08-08,SZ,12,12,0,12,2022-05-03_11-02-08,fp7d
2021-08-08,TG,21,29,8,21,2022-05-03_11-02-08,fp7d
2021-08-08,TI,53,68,15,53,2022-05-03_11-02-08,fp7d
2021-08-08,UR,6,6,0,6,2022-05-03_11-02-08,fp7d
2021-08-08,VD,85,86,1,85,2022-05-03_11-02-08,fp7d
2021-08-08,VS,21,21,0,21,2022-05-03_11-02-08,fp7d
2021-08-08,ZG,8,8,0,8,2022-05-03_11-02-08,fp7d
2021-08-08,ZH,190,194,19,175,2022-05-03_11-02-08,fp7d
2021-08-09,AG,52,48,0,48,2022-05-03_11-02-08,fp7d
2021-08-09,AI,0,0,0,0,2022-05-03_11-02-08,fp7d
2021-08-09,AR,6,6,0,6,2022-05-03_11-02-08,fp7d
2021-08-09,BE,91,80,2,78,2022-05-03_11-02-08,fp7d
2021-08-09,BL,20,16,0,16,2022-05-03_11-02-08,fp7d
2021-08-09,BS,54,50,0,50,2022-05-03_11-02-08,fp7d
2021-08-09,FR,24,24,0,24,2022-05-03_11-02-08,fp7d
2021-08-09,GE,38,51,13,38,2022-05-03_11-02-08,fp7d
2021-08-09,GL,6,6,0,6,2022-05-03_11-02-08,fp7d
2021-08-09,GR,16,16,0,16,2022-05-03_11-02-08,fp7d
2021-08-09,JU,6,6,0,6,2022-05-03_11-02-08,fp7d
2021-08-09,LU,54,50,2,48,2022-05-03_11-02-08,fp7d
2021-08-09,NE,10,10,0,10,2022-05-03_11-02-08,fp7d
2021-08-09,NW,6,5,0,5,2022-05-03_11-02-08,fp7d
2021-08-09,OW,0,0,0,0,2022-05-03_11-02-08,fp7d
2021-08-09,SG,54,55,1,54,2022-05-03_11-02-08,fp7d
2021-08-09,SH,8,8,0,8,2022-05-03_11-02-08,fp7d
2021-08-09,SO,17,17,0,17,2022-05-03_11-02-08,fp7d
2021-08-09,SZ,12,12,0,12,2022-05-03_11-02-08,fp7d
2021-08-09,TG,21,29,8,21,2022-05-03_11-02-08,fp7d
2021-08-09,TI,53,68,15,53,2022-05-03_11-02-08,fp7d
2021-08-09,UR,6,6,0,6,2022-05-03_11-02-08,fp7d
2021-08-09,VD,85,86,1,85,2022-05-03_11-02-08,fp7d
2021-08-09,VS,21,21,0,21,2022-05-03_11-02-08,fp7d
2021-08-09,ZG,8,8,0,8,2022-05-03_11-02-08,fp7d
2021-08-09,ZH,190,195,19,176,2022-05-03_11-02-08,fp7d
2021-08-10,AG,52,48,0,48,2022-05-03_11-02-08,fp7d
2021-08-10,AI,0,0,0,0,2022-05-03_11-02-08,fp7d
2021-08-10,AR,6,6,0,6,2022-05-03_11-02-08,fp7d
2021-08-10,BE,91,82,2,80,2022-05-03_11-02-08,fp7d
2021-08-10,BL,20,16,0,16,2022-05-03_11-02-08,fp7d
2021-08-10,BS,54,50,0,50,2022-05-03_11-02-08,fp7d
2021-08-10,FR,24,24,0,24,2022-05-03_11-02-08,fp7d
2021-08-10,GE,38,51,13,38,2022-05-03_11-02-08,fp7d
2021-08-10,GL,6,6,0,6,2022-05-03_11-02-08,fp7d
2021-08-10,GR,16,16,0,16,2022-05-03_11-02-08,fp7d
2021-08-10,JU,6,6,0,6,2022-05-03_11-02-08,fp7d
2021-08-10,LU,54,50,2,48,2022-05-03_11-02-08,fp7d
2021-08-10,NE,10,10,0,10,2022-05-03_11-02-08,fp7d
2021-08-10,NW,6,5,0,5,2022-05-03_11-02-08,fp7d
2021-08-10,OW,0,0,0,0,2022-05-03_11-02-08,fp7d
2021-08-10,SG,54,55,1,54,2022-05-03_11-02-08,fp7d
2021-08-10,SH,8,8,0,8,2022-05-03_11-02-08,fp7d
2021-08-10,SO,17,17,0,17,2022-05-03_11-02-08,fp7d
2021-08-10,SZ,12,12,0,12,2022-05-03_11-02-08,fp7d
2021-08-10,TG,21,29,8,21,2022-05-03_11-02-08,fp7d
2021-08-10,TI,53,68,15,53,2022-05-03_11-02-08,fp7d
2021-08-10,UR,6,6,0,6,2022-05-03_11-02-08,fp7d
2021-08-10,VD,85,86,1,85,2022-05-03_11-02-08,fp7d
2021-08-10,VS,21,21,0,21,2022-05-03_11-02-08,fp7d
2021-08-10,ZG,8,8,0,8,2022-05-03_11-02-08,fp7d
2021-08-10,ZH,190,193,19,174,2022-05-03_11-02-08,fp7d
2021-08-11,AG,52,50,0,50,2022-05-03_11-02-08,fp7d
2021-08-11,AI,0,0,0,0,2022-05-03_11-02-08,fp7d
2021-08-11,AR,6,6,0,6,2022-05-03_11-02-08,fp7d
2021-08-11,BE,91,82,2,80,2022-05-03_11-02-08,fp7d
2021-08-11,BL,20,16,0,16,2022-05-03_11-02-08,fp7d
2021-08-11,BS,54,50,0,50,2022-05-03_11-02-08,fp7d
2021-08-11,FR,24,24,0,24,2022-05-03_11-02-08,fp7d
2021-08-11,GE,38,51,13,38,2022-05-03_11-02-08,fp7d
2021-08-11,GL,6,6,0,6,2022-05-03_11-02-08,fp7d
2021-08-11,GR,16,16,0,16,2022-05-03_11-02-08,fp7d
2021-08-11,JU,6,6,0,6,2022-05-03_11-02-08,fp7d
2021-08-11,LU,54,50,2,48,2022-05-03_11-02-08,fp7d
2021-08-11,NE,10,10,0,10,2022-05-03_11-02-08,fp7d
2021-08-11,NW,6,5,0,5,2022-05-03_11-02-08,fp7d
2021-08-11,OW,0,0,0,0,2022-05-03_11-02-08,fp7d
2021-08-11,SG,54,55,1,54,2022-05-03_11-02-08,fp7d
2021-08-11,SH,8,8,0,8,2022-05-03_11-02-08,fp7d
2021-08-11,SO,17,17,0,17,2022-05-03_11-02-08,fp7d
2021-08-11,SZ,12,12,0,12,2022-05-03_11-02-08,fp7d
2021-08-11,TG,21,29,8,21,2022-05-03_11-02-08,fp7d
2021-08-11,TI,53,68,15,53,2022-05-03_11-02-08,fp7d
2021-08-11,UR,6,6,0,6,2022-05-03_11-02-08,fp7d
2021-08-11,VD,85,86,1,85,2022-05-03_11-02-08,fp7d
2021-08-11,VS,21,21,0,21,2022-05-03_11-02-08,fp7d
2021-08-11,ZG,8,8,0,8,2022-05-03_11-02-08,fp7d
2021-08-11,ZH,190,193,19,174,2022-05-03_11-02-08,fp7d
2021-08-12,AG,52,50,0,50,2022-05-03_11-02-08,fp7d
2021-08-12,AI,0,0,0,0,2022-05-03_11-02-08,fp7d
2021-08-12,AR,6,6,0,6,2022-05-03_11-02-08,fp7d
2021-08-12,BE,91,82,2,80,2022-05-03_11-02-08,fp7d
2021-08-12,BL,20,16,0,16,2022-05-03_11-02-08,fp7d
2021-08-12,BS,54,50,0,50,2022-05-03_11-02-08,fp7d
2021-08-12,FR,24,24,0,24,2022-05-03_11-02-08,fp7d
2021-08-12,GE,38,51,13,38,2022-05-03_11-02-08,fp7d
2021-08-12,GL,6,6,0,6,2022-05-03_11-02-08,fp7d
2021-08-12,GR,16,16,0,16,2022-05-03_11-02-08,fp7d
2021-08-12,JU,6,6,0,6,2022-05-03_11-02-08,fp7d
2021-08-12,LU,54,50,2,48,2022-05-03_11-02-08,fp7d
2021-08-12,NE,10,10,0,10,2022-05-03_11-02-08,fp7d
2021-08-12,NW,6,5,0,5,2022-05-03_11-02-08,fp7d
2021-08-12,OW,0,0,0,0,2022-05-03_11-02-08,fp7d
2021-08-12,SG,54,55,1,54,2022-05-03_11-02-08,fp7d
2021-08-12,SH,8,8,0,8,2022-05-03_11-02-08,fp7d
2021-08-12,SO,17,17,0,17,2022-05-03_11-02-08,fp7d
2021-08-12,SZ,12,12,0,12,2022-05-03_11-02-08,fp7d
2021-08-12,TG,21,29,8,21,2022-05-03_11-02-08,fp7d
2021-08-12,TI,53,68,15,53,2022-05-03_11-02-08,fp7d
2021-08-12,UR,6,6,0,6,2022-05-03_11-02-08,fp7d
2021-08-12,VD,85,86,1,85,2022-05-03_11-02-08,fp7d
2021-08-12,VS,21,21,0,21,2022-05-03_11-02-08,fp7d
2021-08-12,ZG,8,8,0,8,2022-05-03_11-02-08,fp7d
2021-08-12,ZH,190,193,19,174,2022-05-03_11-02-08,fp7d
2021-08-13,AG,52,50,0,50,2022-05-03_11-02-08,fp7d
2021-08-13,AI,0,0,0,0,2022-05-03_11-02-08,fp7d
2021-08-13,AR,6,6,0,6,2022-05-03_11-02-08,fp7d
2021-08-13,BE,91,82,2,80,2022-05-03_11-02-08,fp7d
2021-08-13,BL,20,16,0,16,2022-05-03_11-02-08,fp7d
2021-08-13,BS,54,50,0,50,2022-05-03_11-02-08,fp7d
2021-08-13,FR,24,24,0,24,2022-05-03_11-02-08,fp7d
2021-08-13,GE,38,51,13,38,2022-05-03_11-02-08,fp7d
2021-08-13,GL,6,5,0,5,2022-05-03_11-02-08,fp7d
2021-08-13,GR,16,16,0,16,2022-05-03_11-02-08,fp7d
2021-08-13,JU,6,6,0,6,2022-05-03_11-02-08,fp7d
2021-08-13,LU,54,50,2,48,2022-05-03_11-02-08,fp7d
2021-08-13,NE,10,10,0,10,2022-05-03_11-02-08,fp7d
2021-08-13,NW,6,5,0,5,2022-05-03_11-02-08,fp7d
2021-08-13,OW,0,0,0,0,2022-05-03_11-02-08,fp7d
2021-08-13,SG,54,55,1,54,2022-05-03_11-02-08,fp7d
2021-08-13,SH,8,8,0,8,2022-05-03_11-02-08,fp7d
2021-08-13,SO,17,17,0,17,2022-05-03_11-02-08,fp7d
2021-08-13,SZ,12,12,0,12,2022-05-03_11-02-08,fp7d
2021-08-13,TG,21,29,8,21,2022-05-03_11-02-08,fp7d
2021-08-13,TI,53,68,15,53,2022-05-03_11-02-08,fp7d
2021-08-13,UR,6,6,0,6,2022-05-03_11-02-08,fp7d
2021-08-13,VD,85,86,1,85,2022-05-03_11-02-08,fp7d
2021-08-13,VS,21,21,0,21,2022-05-03_11-02-08,fp7d
2021-08-13,ZG,8,8,0,8,2022-05-03_11-02-08,fp7d
2021-08-13,ZH,190,194,19,175,2022-05-03_11-02-08,fp7d
2021-08-14,AG,52,50,0,50,2022-05-03_11-02-08,fp7d
2021-08-14,AI,0,0,0,0,2022-05-03_11-02-08,fp7d
2021-08-14,AR,6,6,0,6,2022-05-03_11-02-08,fp7d
2021-08-14,BE,91,82,2,80,2022-05-03_11-02-08,fp7d
2021-08-14,BL,20,16,0,16,2022-05-03_11-02-08,fp7d
2021-08-14,BS,54,50,0,50,2022-05-03_11-02-08,fp7d
2021-08-14,FR,24,24,0,24,2022-05-03_11-02-08,fp7d
2021-08-14,GE,38,51,13,38,2022-05-03_11-02-08,fp7d
2021-08-14,GL,6,5,0,5,2022-05-03_11-02-08,fp7d
2021-08-14,GR,16,16,0,16,2022-05-03_11-02-08,fp7d
2021-08-14,JU,6,6,0,6,2022-05-03_11-02-08,fp7d
2021-08-14,LU,54,50,2,48,2022-05-03_11-02-08,fp7d
2021-08-14,NE,10,10,0,10,2022-05-03_11-02-08,fp7d
2021-08-14,NW,6,5,0,5,2022-05-03_11-02-08,fp7d
2021-08-14,OW,0,0,0,0,2022-05-03_11-02-08,fp7d
2021-08-14,SG,54,55,1,54,2022-05-03_11-02-08,fp7d
2021-08-14,SH,8,8,0,8,2022-05-03_11-02-08,fp7d
2021-08-14,SO,17,17,0,17,2022-05-03_11-02-08,fp7d
2021-08-14,SZ,12,12,0,12,2022-05-03_11-02-08,fp7d
2021-08-14,TG,21,29,8,21,2022-05-03_11-02-08,fp7d
2021-08-14,TI,53,68,15,53,2022-05-03_11-02-08,fp7d
2021-08-14,UR,6,6,0,6,2022-05-03_11-02-08,fp7d
2021-08-14,VD,85,86,1,85,2022-05-03_11-02-08,fp7d
2021-08-14,VS,21,21,0,21,2022-05-03_11-02-08,fp7d
2021-08-14,ZG,8,8,0,8,2022-05-03_11-02-08,fp7d
2021-08-14,ZH,190,189,14,175,2022-05-03_11-02-08,fp7d
2021-08-15,AG,52,50,0,50,2022-05-03_11-02-08,fp7d
2021-08-15,AI,0,0,0,0,2022-05-03_11-02-08,fp7d
2021-08-15,AR,6,6,0,6,2022-05-03_11-02-08,fp7d
2021-08-15,BE,91,82,2,80,2022-05-03_11-02-08,fp7d
2021-08-15,BL,20,16,0,16,2022-05-03_11-02-08,fp7d
2021-08-15,BS,54,50,0,50,2022-05-03_11-02-08,fp7d
2021-08-15,FR,24,24,0,24,2022-05-03_11-02-08,fp7d
2021-08-15,GE,38,51,13,38,2022-05-03_11-02-08,fp7d
2021-08-15,GL,6,5,0,5,2022-05-03_11-02-08,fp7d
2021-08-15,GR,16,16,0,16,2022-05-03_11-02-08,fp7d
2021-08-15,JU,6,6,0,6,2022-05-03_11-02-08,fp7d
2021-08-15,LU,54,50,2,48,2022-05-03_11-02-08,fp7d
2021-08-15,NE,10,10,0,10,2022-05-03_11-02-08,fp7d
2021-08-15,NW,6,5,0,5,2022-05-03_11-02-08,fp7d
2021-08-15,OW,0,0,0,0,2022-05-03_11-02-08,fp7d
2021-08-15,SG,54,55,1,54,2022-05-03_11-02-08,fp7d
2021-08-15,SH,8,8,0,8,2022-05-03_11-02-08,fp7d
2021-08-15,SO,17,17,0,17,2022-05-03_11-02-08,fp7d
2021-08-15,SZ,12,12,0,12,2022-05-03_11-02-08,fp7d
2021-08-15,TG,21,29,8,21,2022-05-03_11-02-08,fp7d
2021-08-15,TI,53,68,15,53,2022-05-03_11-02-08,fp7d
2021-08-15,UR,6,6,0,6,2022-05-03_11-02-08,fp7d
2021-08-15,VD,85,86,1,85,2022-05-03_11-02-08,fp7d
2021-08-15,VS,21,21,0,21,2022-05-03_11-02-08,fp7d
2021-08-15,ZG,8,8,0,8,2022-05-03_11-02-08,fp7d
2021-08-15,ZH,190,188,14,174,2022-05-03_11-02-08,fp7d
2021-08-16,AG,52,50,0,50,2022-05-03_11-02-08,fp7d
2021-08-16,AI,0,0,0,0,2022-05-03_11-02-08,fp7d
2021-08-16,AR,6,6,0,6,2022-05-03_11-02-08,fp7d
2021-08-16,BE,91,82,2,80,2022-05-03_11-02-08,fp7d
2021-08-16,BL,20,16,0,16,2022-05-03_11-02-08,fp7d
2021-08-16,BS,54,50,0,50,2022-05-03_11-02-08,fp7d
2021-08-16,FR,24,24,0,24,2022-05-03_11-02-08,fp7d
2021-08-16,GE,38,51,13,38,2022-05-03_11-02-08,fp7d
2021-08-16,GL,6,5,0,5,2022-05-03_11-02-08,fp7d
2021-08-16,GR,16,16,0,16,2022-05-03_11-02-08,fp7d
2021-08-16,JU,6,6,0,6,2022-05-03_11-02-08,fp7d
2021-08-16,LU,54,50,2,48,2022-05-03_11-02-08,fp7d
2021-08-16,NE,10,10,0,10,2022-05-03_11-02-08,fp7d
2021-08-16,NW,6,5,0,5,2022-05-03_11-02-08,fp7d
2021-08-16,OW,0,0,0,0,2022-05-03_11-02-08,fp7d
2021-08-16,SG,54,55,1,54,2022-05-03_11-02-08,fp7d
2021-08-16,SH,8,8,0,8,2022-05-03_11-02-08,fp7d
2021-08-16,SO,17,17,0,17,2022-05-03_11-02-08,fp7d
2021-08-16,SZ,12,12,0,12,2022-05-03_11-02-08,fp7d
2021-08-16,TG,21,29,8,21,2022-05-03_11-02-08,fp7d
2021-08-16,TI,53,68,15,53,2022-05-03_11-02-08,fp7d
2021-08-16,UR,6,6,0,6,2022-05-03_11-02-08,fp7d
2021-08-16,VD,85,86,1,85,2022-05-03_11-02-08,fp7d
2021-08-16,VS,21,21,0,21,2022-05-03_11-02-08,fp7d
2021-08-16,ZG,8,8,0,8,2022-05-03_11-02-08,fp7d
2021-08-16,ZH,190,189,14,175,2022-05-03_11-02-08,fp7d
2021-08-17,AG,52,50,0,50,2022-05-03_11-02-08,fp7d
2021-08-17,AI,0,0,0,0,2022-05-03_11-02-08,fp7d
2021-08-17,AR,6,6,0,6,2022-05-03_11-02-08,fp7d
2021-08-17,BE,91,82,2,80,2022-05-03_11-02-08,fp7d
2021-08-17,BL,20,16,0,16,2022-05-03_11-02-08,fp7d
2021-08-17,BS,54,50,0,50,2022-05-03_11-02-08,fp7d
2021-08-17,FR,24,24,0,24,2022-05-03_11-02-08,fp7d
2021-08-17,GE,38,51,13,38,2022-05-03_11-02-08,fp7d
2021-08-17,GL,6,5,0,5,2022-05-03_11-02-08,fp7d
2021-08-17,GR,16,16,0,16,2022-05-03_11-02-08,fp7d
2021-08-17,JU,6,6,0,6,2022-05-03_11-02-08,fp7d
2021-08-17,LU,54,50,2,48,2022-05-03_11-02-08,fp7d
2021-08-17,NE,10,10,0,10,2022-05-03_11-02-08,fp7d
2021-08-17,NW,6,5,0,5,2022-05-03_11-02-08,fp7d
2021-08-17,OW,0,0,0,0,2022-05-03_11-02-08,fp7d
2021-08-17,SG,54,55,1,54,2022-05-03_11-02-08,fp7d
2021-08-17,SH,8,8,0,8,2022-05-03_11-02-08,fp7d
2021-08-17,SO,17,17,0,17,2022-05-03_11-02-08,fp7d
2021-08-17,SZ,12,12,0,12,2022-05-03_11-02-08,fp7d
2021-08-17,TG,21,29,8,21,2022-05-03_11-02-08,fp7d
2021-08-17,TI,53,68,15,53,2022-05-03_11-02-08,fp7d
2021-08-17,UR,6,6,0,6,2022-05-03_11-02-08,fp7d
2021-08-17,VD,85,86,1,85,2022-05-03_11-02-08,fp7d
2021-08-17,VS,21,21,0,21,2022-05-03_11-02-08,fp7d
2021-08-17,ZG,8,8,0,8,2022-05-03_11-02-08,fp7d
2021-08-17,ZH,190,189,14,175,2022-05-03_11-02-08,fp7d
2021-08-18,AG,52,50,0,50,2022-05-03_11-02-08,fp7d
2021-08-18,AI,0,0,0,0,2022-05-03_11-02-08,fp7d
2021-08-18,AR,6,6,0,6,2022-05-03_11-02-08,fp7d
2021-08-18,BE,91,82,2,80,2022-05-03_11-02-08,fp7d
2021-08-18,BL,20,16,0,16,2022-05-03_11-02-08,fp7d
2021-08-18,BS,54,50,0,50,2022-05-03_11-02-08,fp7d
2021-08-18,FR,24,24,0,24,2022-05-03_11-02-08,fp7d
2021-08-18,GE,38,51,13,38,2022-05-03_11-02-08,fp7d
2021-08-18,GL,6,5,0,5,2022-05-03_11-02-08,fp7d
2021-08-18,GR,16,16,0,16,2022-05-03_11-02-08,fp7d
2021-08-18,JU,6,6,0,6,2022-05-03_11-02-08,fp7d
2021-08-18,LU,54,50,2,48,2022-05-03_11-02-08,fp7d
2021-08-18,NE,10,10,0,10,2022-05-03_11-02-08,fp7d
2021-08-18,NW,6,5,0,5,2022-05-03_11-02-08,fp7d
2021-08-18,OW,0,0,0,0,2022-05-03_11-02-08,fp7d
2021-08-18,SG,54,45,1,44,2022-05-03_11-02-08,fp7d
2021-08-18,SH,8,6,0,6,2022-05-03_11-02-08,fp7d
2021-08-18,SO,17,17,0,17,2022-05-03_11-02-08,fp7d
2021-08-18,SZ,12,12,0,12,2022-05-03_11-02-08,fp7d
2021-08-18,TG,21,29,8,21,2022-05-03_11-02-08,fp7d
2021-08-18,TI,53,68,15,53,2022-05-03_11-02-08,fp7d
2021-08-18,UR,6,6,0,6,2022-05-03_11-02-08,fp7d
2021-08-18,VD,85,86,1,85,2022-05-03_11-02-08,fp7d
2021-08-18,VS,21,21,0,21,2022-05-03_11-02-08,fp7d
2021-08-18,ZG,8,8,0,8,2022-05-03_11-02-08,fp7d
2021-08-18,ZH,190,187,14,173,2022-05-03_11-02-08,fp7d
2021-08-19,AG,52,50,0,50,2022-05-03_11-02-08,fp7d
2021-08-19,AI,0,0,0,0,2022-05-03_11-02-08,fp7d
2021-08-19,AR,6,6,0,6,2022-05-03_11-02-08,fp7d
2021-08-19,BE,91,82,2,80,2022-05-03_11-02-08,fp7d
2021-08-19,BL,20,16,0,16,2022-05-03_11-02-08,fp7d
2021-08-19,BS,54,50,0,50,2022-05-03_11-02-08,fp7d
2021-08-19,FR,24,24,0,24,2022-05-03_11-02-08,fp7d
2021-08-19,GE,38,50,12,38,2022-05-03_11-02-08,fp7d
2021-08-19,GL,6,5,0,5,2022-05-03_11-02-08,fp7d
2021-08-19,GR,16,16,0,16,2022-05-03_11-02-08,fp7d
2021-08-19,JU,6,6,0,6,2022-05-03_11-02-08,fp7d
2021-08-19,LU,54,50,2,48,2022-05-03_11-02-08,fp7d
2021-08-19,NE,10,10,0,10,2022-05-03_11-02-08,fp7d
2021-08-19,NW,6,5,0,5,2022-05-03_11-02-08,fp7d
2021-08-19,OW,0,0,0,0,2022-05-03_11-02-08,fp7d
2021-08-19,SG,54,45,1,44,2022-05-03_11-02-08,fp7d
2021-08-19,SH,8,6,0,6,2022-05-03_11-02-08,fp7d
2021-08-19,SO,17,17,0,17,2022-05-03_11-02-08,fp7d
2021-08-19,SZ,12,12,0,12,2022-05-03_11-02-08,fp7d
2021-08-19,TG,21,29,8,21,2022-05-03_11-02-08,fp7d
2021-08-19,TI,53,68,15,53,2022-05-03_11-02-08,fp7d
2021-08-19,UR,6,6,0,6,2022-05-03_11-02-08,fp7d
2021-08-19,VD,85,86,1,85,2022-05-03_11-02-08,fp7d
2021-08-19,VS,21,21,0,21,2022-05-03_11-02-08,fp7d
2021-08-19,ZG,8,8,0,8,2022-05-03_11-02-08,fp7d
2021-08-19,ZH,190,184,14,170,2022-05-03_11-02-08,fp7d
2021-08-20,AG,52,50,0,50,2022-05-03_11-02-08,fp7d
2021-08-20,AI,0,0,0,0,2022-05-03_11-02-08,fp7d
2021-08-20,AR,6,6,0,6,2022-05-03_11-02-08,fp7d
2021-08-20,BE,91,82,2,80,2022-05-03_11-02-08,fp7d
2021-08-20,BL,20,16,0,16,2022-05-03_11-02-08,fp7d
2021-08-20,BS,54,50,0,50,2022-05-03_11-02-08,fp7d
2021-08-20,FR,24,24,0,24,2022-05-03_11-02-08,fp7d
2021-08-20,GE,38,50,12,38,2022-05-03_11-02-08,fp7d
2021-08-20,GL,6,5,0,5,2022-05-03_11-02-08,fp7d
2021-08-20,GR,16,16,0,16,2022-05-03_11-02-08,fp7d
2021-08-20,JU,6,6,0,6,2022-05-03_11-02-08,fp7d
2021-08-20,LU,54,50,2,48,2022-05-03_11-02-08,fp7d
2021-08-20,NE,10,10,0,10,2022-05-03_11-02-08,fp7d
2021-08-20,NW,6,5,0,5,2022-05-03_11-02-08,fp7d
2021-08-20,OW,0,0,0,0,2022-05-03_11-02-08,fp7d
2021-08-20,SG,54,45,1,44,2022-05-03_11-02-08,fp7d
2021-08-20,SH,8,6,0,6,2022-05-03_11-02-08,fp7d
2021-08-20,SO,17,17,0,17,2022-05-03_11-02-08,fp7d
2021-08-20,SZ,12,12,0,12,2022-05-03_11-02-08,fp7d
2021-08-20,TG,21,29,8,21,2022-05-03_11-02-08,fp7d
2021-08-20,TI,53,68,15,53,2022-05-03_11-02-08,fp7d
2021-08-20,UR,6,6,0,6,2022-05-03_11-02-08,fp7d
2021-08-20,VD,85,86,1,85,2022-05-03_11-02-08,fp7d
2021-08-20,VS,21,21,0,21,2022-05-03_11-02-08,fp7d
2021-08-20,ZG,8,8,0,8,2022-05-03_11-02-08,fp7d
2021-08-20,ZH,190,183,12,171,2022-05-03_11-02-08,fp7d
2021-08-21,AG,52,50,0,50,2022-05-03_11-02-08,fp7d
2021-08-21,AI,0,0,0,0,2022-05-03_11-02-08,fp7d
2021-08-21,AR,6,6,0,6,2022-05-03_11-02-08,fp7d
2021-08-21,BE,91,82,2,80,2022-05-03_11-02-08,fp7d
2021-08-21,BL,20,16,0,16,2022-05-03_11-02-08,fp7d
2021-08-21,BS,54,46,0,46,2022-05-03_11-02-08,fp7d
2021-08-21,FR,24,22,0,22,2022-05-03_11-02-08,fp7d
2021-08-21,GE,38,51,13,38,2022-05-03_11-02-08,fp7d
2021-08-21,GL,6,5,0,5,2022-05-03_11-02-08,fp7d
2021-08-21,GR,16,16,0,16,2022-05-03_11-02-08,fp7d
2021-08-21,JU,6,6,0,6,2022-05-03_11-02-08,fp7d
2021-08-21,LU,54,50,2,48,2022-05-03_11-02-08,fp7d
2021-08-21,NE,10,10,0,10,2022-05-03_11-02-08,fp7d
2021-08-21,NW,6,5,0,5,2022-05-03_11-02-08,fp7d
2021-08-21,OW,0,0,0,0,2022-05-03_11-02-08,fp7d
2021-08-21,SG,54,45,1,44,2022-05-03_11-02-08,fp7d
2021-08-21,SH,8,6,0,6,2022-05-03_11-02-08,fp7d
2021-08-21,SO,17,17,0,17,2022-05-03_11-02-08,fp7d
2021-08-21,SZ,12,12,0,12,2022-05-03_11-02-08,fp7d
2021-08-21,TG,21,29,8,21,2022-05-03_11-02-08,fp7d
2021-08-21,TI,53,68,15,53,2022-05-03_11-02-08,fp7d
2021-08-21,UR,6,6,0,6,2022-05-03_11-02-08,fp7d
2021-08-21,VD,85,86,1,85,2022-05-03_11-02-08,fp7d
2021-08-21,VS,21,21,0,21,2022-05-03_11-02-08,fp7d
2021-08-21,ZG,8,8,0,8,2022-05-03_11-02-08,fp7d
2021-08-21,ZH,190,182,12,170,2022-05-03_11-02-08,fp7d
2021-08-22,AG,52,48,0,48,2022-05-03_11-02-08,fp7d
2021-08-22,AI,0,0,0,0,2022-05-03_11-02-08,fp7d
2021-08-22,AR,6,6,0,6,2022-05-03_11-02-08,fp7d
2021-08-22,BE,91,82,2,80,2022-05-03_11-02-08,fp7d
2021-08-22,BL,20,16,0,16,2022-05-03_11-02-08,fp7d
2021-08-22,BS,54,46,0,46,2022-05-03_11-02-08,fp7d
2021-08-22,FR,24,22,0,22,2022-05-03_11-02-08,fp7d
2021-08-22,GE,38,51,13,38,2022-05-03_11-02-08,fp7d
2021-08-22,GL,6,5,0,5,2022-05-03_11-02-08,fp7d
2021-08-22,GR,16,16,0,16,2022-05-03_11-02-08,fp7d
2021-08-22,JU,6,6,0,6,2022-05-03_11-02-08,fp7d
2021-08-22,LU,54,46,0,46,2022-05-03_11-02-08,fp7d
2021-08-22,NE,10,10,0,10,2022-05-03_11-02-08,fp7d
2021-08-22,NW,6,5,0,5,2022-05-03_11-02-08,fp7d
2021-08-22,OW,0,0,0,0,2022-05-03_11-02-08,fp7d
2021-08-22,SG,54,45,1,44,2022-05-03_11-02-08,fp7d
2021-08-22,SH,8,6,0,6,2022-05-03_11-02-08,fp7d
2021-08-22,SO,17,17,0,17,2022-05-03_11-02-08,fp7d
2021-08-22,SZ,12,12,0,12,2022-05-03_11-02-08,fp7d
2021-08-22,TG,21,29,8,21,2022-05-03_11-02-08,fp7d
2021-08-22,TI,53,68,15,53,2022-05-03_11-02-08,fp7d
2021-08-22,UR,6,6,0,6,2022-05-03_11-02-08,fp7d
2021-08-22,VD,85,86,1,85,2022-05-03_11-02-08,fp7d
2021-08-22,VS,21,21,0,21,2022-05-03_11-02-08,fp7d
2021-08-22,ZG,8,8,0,8,2022-05-03_11-02-08,fp7d
2021-08-22,ZH,190,182,12,170,2022-05-03_11-02-08,fp7d
2021-08-23,AG,52,48,0,48,2022-05-03_11-02-08,fp7d
2021-08-23,AI,0,0,0,0,2022-05-03_11-02-08,fp7d
2021-08-23,AR,6,6,0,6,2022-05-03_11-02-08,fp7d
2021-08-23,BE,91,82,2,80,2022-05-03_11-02-08,fp7d
2021-08-23,BL,20,16,0,16,2022-05-03_11-02-08,fp7d
2021-08-23,BS,54,50,0,50,2022-05-03_11-02-08,fp7d
2021-08-23,FR,24,22,0,22,2022-05-03_11-02-08,fp7d
2021-08-23,GE,38,51,13,38,2022-05-03_11-02-08,fp7d
2021-08-23,GL,6,5,0,5,2022-05-03_11-02-08,fp7d
2021-08-23,GR,16,16,0,16,2022-05-03_11-02-08,fp7d
2021-08-23,JU,6,6,0,6,2022-05-03_11-02-08,fp7d
2021-08-23,LU,54,46,0,46,2022-05-03_11-02-08,fp7d
2021-08-23,NE,10,10,0,10,2022-05-03_11-02-08,fp7d
2021-08-23,NW,6,5,0,5,2022-05-03_11-02-08,fp7d
2021-08-23,OW,0,0,0,0,2022-05-03_11-02-08,fp7d
2021-08-23,SG,54,45,1,44,2022-05-03_11-02-08,fp7d
2021-08-23,SH,8,6,0,6,2022-05-03_11-02-08,fp7d
2021-08-23,SO,17,17,0,17,2022-05-03_11-02-08,fp7d
2021-08-23,SZ,12,11,0,11,2022-05-03_11-02-08,fp7d
2021-08-23,TG,21,29,8,21,2022-05-03_11-02-08,fp7d
2021-08-23,TI,53,68,15,53,2022-05-03_11-02-08,fp7d
2021-08-23,UR,6,6,0,6,2022-05-03_11-02-08,fp7d
2021-08-23,VD,85,86,1,85,2022-05-03_11-02-08,fp7d
2021-08-23,VS,21,21,0,21,2022-05-03_11-02-08,fp7d
2021-08-23,ZG,8,8,0,8,2022-05-03_11-02-08,fp7d
2021-08-23,ZH,190,181,12,169,2022-05-03_11-02-08,fp7d
2021-08-24,AG,52,48,0,48,2022-05-03_11-02-08,fp7d
2021-08-24,AI,0,0,0,0,2022-05-03_11-02-08,fp7d
2021-08-24,AR,6,6,0,6,2022-05-03_11-02-08,fp7d
2021-08-24,BE,91,82,2,80,2022-05-03_11-02-08,fp7d
2021-08-24,BL,20,16,0,16,2022-05-03_11-02-08,fp7d
2021-08-24,BS,54,50,0,50,2022-05-03_11-02-08,fp7d
2021-08-24,FR,24,24,0,24,2022-05-03_11-02-08,fp7d
2021-08-24,GE,38,51,13,38,2022-05-03_11-02-08,fp7d
2021-08-24,GL,6,5,0,5,2022-05-03_11-02-08,fp7d
2021-08-24,GR,16,16,0,16,2022-05-03_11-02-08,fp7d
2021-08-24,JU,6,6,0,6,2022-05-03_11-02-08,fp7d
2021-08-24,LU,54,48,0,48,2022-05-03_11-02-08,fp7d
2021-08-24,NE,10,10,0,10,2022-05-03_11-02-08,fp7d
2021-08-24,NW,6,5,0,5,2022-05-03_11-02-08,fp7d
2021-08-24,OW,0,0,0,0,2022-05-03_11-02-08,fp7d
2021-08-24,SG,54,45,1,44,2022-05-03_11-02-08,fp7d
2021-08-24,SH,8,6,0,6,2022-05-03_11-02-08,fp7d
2021-08-24,SO,17,17,0,17,2022-05-03_11-02-08,fp7d
2021-08-24,SZ,12,11,0,11,2022-05-03_11-02-08,fp7d
2021-08-24,TG,21,29,8,21,2022-05-03_11-02-08,fp7d
2021-08-24,TI,53,68,15,53,2022-05-03_11-02-08,fp7d
2021-08-24,UR,6,6,0,6,2022-05-03_11-02-08,fp7d
2021-08-24,VD,85,86,1,85,2022-05-03_11-02-08,fp7d
2021-08-24,VS,21,21,0,21,2022-05-03_11-02-08,fp7d
2021-08-24,ZG,8,8,0,8,2022-05-03_11-02-08,fp7d
2021-08-24,ZH,190,185,14,171,2022-05-03_11-02-08,fp7d
2021-08-25,AG,52,46,0,46,2022-05-03_11-02-08,fp7d
2021-08-25,AI,0,0,0,0,2022-05-03_11-02-08,fp7d
2021-08-25,AR,6,6,0,6,2022-05-03_11-02-08,fp7d
2021-08-25,BE,91,82,2,80,2022-05-03_11-02-08,fp7d
2021-08-25,BL,20,16,0,16,2022-05-03_11-02-08,fp7d
2021-08-25,BS,54,50,0,50,2022-05-03_11-02-08,fp7d
2021-08-25,FR,24,24,0,24,2022-05-03_11-02-08,fp7d
2021-08-25,GE,38,51,13,38,2022-05-03_11-02-08,fp7d
2021-08-25,GL,6,5,0,5,2022-05-03_11-02-08,fp7d
2021-08-25,GR,16,16,0,16,2022-05-03_11-02-08,fp7d
2021-08-25,JU,6,6,0,6,2022-05-03_11-02-08,fp7d
2021-08-25,LU,54,48,0,48,2022-05-03_11-02-08,fp7d
2021-08-25,NE,10,10,0,10,2022-05-03_11-02-08,fp7d
2021-08-25,NW,6,5,0,5,2022-05-03_11-02-08,fp7d
2021-08-25,OW,0,0,0,0,2022-05-03_11-02-08,fp7d
2021-08-25,SG,54,45,1,44,2022-05-03_11-02-08,fp7d
2021-08-25,SH,8,7,0,7,2022-05-03_11-02-08,fp7d
2021-08-25,SO,17,17,0,17,2022-05-03_11-02-08,fp7d
2021-08-25,SZ,12,11,0,11,2022-05-03_11-02-08,fp7d
2021-08-25,TG,21,30,9,21,2022-05-03_11-02-08,fp7d
2021-08-25,TI,53,68,15,53,2022-05-03_11-02-08,fp7d
2021-08-25,UR,6,6,0,6,2022-05-03_11-02-08,fp7d
2021-08-25,VD,85,86,1,85,2022-05-03_11-02-08,fp7d
2021-08-25,VS,21,21,0,21,2022-05-03_11-02-08,fp7d
2021-08-25,ZG,8,8,0,8,2022-05-03_11-02-08,fp7d
2021-08-25,ZH,190,183,14,169,2022-05-03_11-02-08,fp7d
2021-08-26,AG,52,46,0,46,2022-05-03_11-02-08,fp7d
2021-08-26,AI,0,0,0,0,2022-05-03_11-02-08,fp7d
2021-08-26,AR,6,6,0,6,2022-05-03_11-02-08,fp7d
2021-08-26,BE,91,82,2,80,2022-05-03_11-02-08,fp7d
2021-08-26,BL,20,16,0,16,2022-05-03_11-02-08,fp7d
2021-08-26,BS,54,50,0,50,2022-05-03_11-02-08,fp7d
2021-08-26,FR,24,24,0,24,2022-05-03_11-02-08,fp7d
2021-08-26,GE,38,51,13,38,2022-05-03_11-02-08,fp7d
2021-08-26,GL,6,5,0,5,2022-05-03_11-02-08,fp7d
2021-08-26,GR,16,16,0,16,2022-05-03_11-02-08,fp7d
2021-08-26,JU,6,6,0,6,2022-05-03_11-02-08,fp7d
2021-08-26,LU,54,48,0,48,2022-05-03_11-02-08,fp7d
2021-08-26,NE,10,10,0,10,2022-05-03_11-02-08,fp7d
2021-08-26,NW,6,5,0,5,2022-05-03_11-02-08,fp7d
2021-08-26,OW,0,0,0,0,2022-05-03_11-02-08,fp7d
2021-08-26,SG,54,45,1,44,2022-05-03_11-02-08,fp7d
2021-08-26,SH,8,7,0,7,2022-05-03_11-02-08,fp7d
2021-08-26,SO,17,17,0,17,2022-05-03_11-02-08,fp7d
2021-08-26,SZ,12,11,0,11,2022-05-03_11-02-08,fp7d
2021-08-26,TG,21,30,9,21,2022-05-03_11-02-08,fp7d
2021-08-26,TI,53,68,15,53,2022-05-03_11-02-08,fp7d
2021-08-26,UR,6,6,0,6,2022-05-03_11-02-08,fp7d
2021-08-26,VD,85,86,1,85,2022-05-03_11-02-08,fp7d
2021-08-26,VS,21,21,0,21,2022-05-03_11-02-08,fp7d
2021-08-26,ZG,8,8,0,8,2022-05-03_11-02-08,fp7d
2021-08-26,ZH,190,186,14,172,2022-05-03_11-02-08,fp7d
2021-08-27,AG,52,46,0,46,2022-05-03_11-02-08,fp7d
2021-08-27,AI,0,0,0,0,2022-05-03_11-02-08,fp7d
2021-08-27,AR,6,6,0,6,2022-05-03_11-02-08,fp7d
2021-08-27,BE,91,81,2,79,2022-05-03_11-02-08,fp7d
2021-08-27,BL,20,16,0,16,2022-05-03_11-02-08,fp7d
2021-08-27,BS,54,50,0,50,2022-05-03_11-02-08,fp7d
2021-08-27,FR,24,24,0,24,2022-05-03_11-02-08,fp7d
2021-08-27,GE,38,54,16,38,2022-05-03_11-02-08,fp7d
2021-08-27,GL,6,5,0,5,2022-05-03_11-02-08,fp7d
2021-08-27,GR,16,16,0,16,2022-05-03_11-02-08,fp7d
2021-08-27,JU,6,6,0,6,2022-05-03_11-02-08,fp7d
2021-08-27,LU,54,50,2,48,2022-05-03_11-02-08,fp7d
2021-08-27,NE,10,10,0,10,2022-05-03_11-02-08,fp7d
2021-08-27,NW,6,5,0,5,2022-05-03_11-02-08,fp7d
2021-08-27,OW,0,0,0,0,2022-05-03_11-02-08,fp7d
2021-08-27,SG,54,45,1,44,2022-05-03_11-02-08,fp7d
2021-08-27,SH,8,6,0,6,2022-05-03_11-02-08,fp7d
2021-08-27,SO,17,17,0,17,2022-05-03_11-02-08,fp7d
2021-08-27,SZ,12,11,0,11,2022-05-03_11-02-08,fp7d
2021-08-27,TG,21,30,9,21,2022-05-03_11-02-08,fp7d
2021-08-27,TI,53,68,15,53,2022-05-03_11-02-08,fp7d
2021-08-27,UR,6,6,0,6,2022-05-03_11-02-08,fp7d
2021-08-27,VD,85,86,1,85,2022-05-03_11-02-08,fp7d
2021-08-27,VS,21,21,0,21,2022-05-03_11-02-08,fp7d
2021-08-27,ZG,8,8,0,8,2022-05-03_11-02-08,fp7d
2021-08-27,ZH,190,189,14,175,2022-05-03_11-02-08,fp7d
2021-08-28,AG,52,48,0,48,2022-05-03_11-02-08,fp7d
2021-08-28,AI,0,0,0,0,2022-05-03_11-02-08,fp7d
2021-08-28,AR,6,6,0,6,2022-05-03_11-02-08,fp7d
2021-08-28,BE,92,82,2,80,2022-05-03_11-02-08,fp7d
2021-08-28,BL,20,16,0,16,2022-05-03_11-02-08,fp7d
2021-08-28,BS,54,46,0,46,2022-05-03_11-02-08,fp7d
2021-08-28,FR,24,24,0,24,2022-05-03_11-02-08,fp7d
2021-08-28,GE,38,56,18,38,2022-05-03_11-02-08,fp7d
2021-08-28,GL,6,5,0,5,2022-05-03_11-02-08,fp7d
2021-08-28,GR,16,16,0,16,2022-05-03_11-02-08,fp7d
2021-08-28,JU,6,6,0,6,2022-05-03_11-02-08,fp7d
2021-08-28,LU,54,50,2,48,2022-05-03_11-02-08,fp7d
2021-08-28,NE,10,10,0,10,2022-05-03_11-02-08,fp7d
2021-08-28,NW,6,5,0,5,2022-05-03_11-02-08,fp7d
2021-08-28,OW,0,0,0,0,2022-05-03_11-02-08,fp7d
2021-08-28,SG,54,45,1,44,2022-05-03_11-02-08,fp7d
2021-08-28,SH,8,6,0,6,2022-05-03_11-02-08,fp7d
2021-08-28,SO,17,17,0,17,2022-05-03_11-02-08,fp7d
2021-08-28,SZ,12,12,0,12,2022-05-03_11-02-08,fp7d
2021-08-28,TG,21,30,9,21,2022-05-03_11-02-08,fp7d
2021-08-28,TI,53,68,15,53,2022-05-03_11-02-08,fp7d
2021-08-28,UR,6,6,0,6,2022-05-03_11-02-08,fp7d
2021-08-28,VD,85,86,1,85,2022-05-03_11-02-08,fp7d
2021-08-28,VS,21,21,0,21,2022-05-03_11-02-08,fp7d
2021-08-28,ZG,8,8,0,8,2022-05-03_11-02-08,fp7d
2021-08-28,ZH,190,184,12,172,2022-05-03_11-02-08,fp7d
2021-08-29,AG,52,48,0,48,2022-05-03_11-02-08,fp7d
2021-08-29,AI,0,0,0,0,2022-05-03_11-02-08,fp7d
2021-08-29,AR,6,6,0,6,2022-05-03_11-02-08,fp7d
2021-08-29,BE,92,82,2,80,2022-05-03_11-02-08,fp7d
2021-08-29,BL,20,16,0,16,2022-05-03_11-02-08,fp7d
2021-08-29,BS,54,46,0,46,2022-05-03_11-02-08,fp7d
2021-08-29,FR,24,24,0,24,2022-05-03_11-02-08,fp7d
2021-08-29,GE,38,56,18,38,2022-05-03_11-02-08,fp7d
2021-08-29,GL,6,5,0,5,2022-05-03_11-02-08,fp7d
2021-08-29,GR,16,16,0,16,2022-05-03_11-02-08,fp7d
2021-08-29,JU,6,6,0,6,2022-05-03_11-02-08,fp7d
2021-08-29,LU,54,50,2,48,2022-05-03_11-02-08,fp7d
2021-08-29,NE,10,10,0,10,2022-05-03_11-02-08,fp7d
2021-08-29,NW,6,5,0,5,2022-05-03_11-02-08,fp7d
2021-08-29,OW,0,0,0,0,2022-05-03_11-02-08,fp7d
2021-08-29,SG,54,45,1,44,2022-05-03_11-02-08,fp7d
2021-08-29,SH,8,7,0,7,2022-05-03_11-02-08,fp7d
2021-08-29,SO,17,17,0,17,2022-05-03_11-02-08,fp7d
2021-08-29,SZ,12,12,0,12,2022-05-03_11-02-08,fp7d
2021-08-29,TG,21,30,9,21,2022-05-03_11-02-08,fp7d
2021-08-29,TI,53,68,15,53,2022-05-03_11-02-08,fp7d
2021-08-29,UR,6,6,0,6,2022-05-03_11-02-08,fp7d
2021-08-29,VD,85,86,1,85,2022-05-03_11-02-08,fp7d
2021-08-29,VS,21,21,0,21,2022-05-03_11-02-08,fp7d
2021-08-29,ZG,8,8,0,8,2022-05-03_11-02-08,fp7d
2021-08-29,ZH,190,185,12,173,2022-05-03_11-02-08,fp7d
2021-08-30,AG,52,48,0,48,2022-05-03_11-02-08,fp7d
2021-08-30,AI,0,0,0,0,2022-05-03_11-02-08,fp7d
2021-08-30,AR,6,6,0,6,2022-05-03_11-02-08,fp7d
2021-08-30,BE,92,83,2,81,2022-05-03_11-02-08,fp7d
2021-08-30,BL,20,16,0,16,2022-05-03_11-02-08,fp7d
2021-08-30,BS,54,46,0,46,2022-05-03_11-02-08,fp7d
2021-08-30,FR,24,24,0,24,2022-05-03_11-02-08,fp7d
2021-08-30,GE,38,56,18,38,2022-05-03_11-02-08,fp7d
2021-08-30,GL,6,4,0,4,2022-05-03_11-02-08,fp7d
2021-08-30,GR,16,16,0,16,2022-05-03_11-02-08,fp7d
2021-08-30,JU,6,6,0,6,2022-05-03_11-02-08,fp7d
2021-08-30,LU,54,48,0,48,2022-05-03_11-02-08,fp7d
2021-08-30,NE,10,10,0,10,2022-05-03_11-02-08,fp7d
2021-08-30,NW,6,4,0,4,2022-05-03_11-02-08,fp7d
2021-08-30,OW,0,0,0,0,2022-05-03_11-02-08,fp7d
2021-08-30,SG,54,45,1,44,2022-05-03_11-02-08,fp7d
2021-08-30,SH,8,6,0,6,2022-05-03_11-02-08,fp7d
2021-08-30,SO,17,17,0,17,2022-05-03_11-02-08,fp7d
2021-08-30,SZ,12,12,0,12,2022-05-03_11-02-08,fp7d
2021-08-30,TG,21,29,8,21,2022-05-03_11-02-08,fp7d
2021-08-30,TI,53,68,15,53,2022-05-03_11-02-08,fp7d
2021-08-30,UR,6,6,0,6,2022-05-03_11-02-08,fp7d
2021-08-30,VD,85,86,1,85,2022-05-03_11-02-08,fp7d
2021-08-30,VS,21,21,0,21,2022-05-03_11-02-08,fp7d
2021-08-30,ZG,8,8,0,8,2022-05-03_11-02-08,fp7d
2021-08-30,ZH,190,187,13,174,2022-05-03_11-02-08,fp7d
2021-08-31,AG,52,48,0,48,2022-05-03_11-02-08,fp7d
2021-08-31,AI,0,0,0,0,2022-05-03_11-02-08,fp7d
2021-08-31,AR,6,6,0,6,2022-05-03_11-02-08,fp7d
2021-08-31,BE,92,83,2,81,2022-05-03_11-02-08,fp7d
2021-08-31,BL,20,16,0,16,2022-05-03_11-02-08,fp7d
2021-08-31,BS,54,46,0,46,2022-05-03_11-02-08,fp7d
2021-08-31,FR,24,22,0,22,2022-05-03_11-02-08,fp7d
2021-08-31,GE,38,56,18,38,2022-05-03_11-02-08,fp7d
2021-08-31,GL,6,4,0,4,2022-05-03_11-02-08,fp7d
2021-08-31,GR,16,16,0,16,2022-05-03_11-02-08,fp7d
2021-08-31,JU,6,6,0,6,2022-05-03_11-02-08,fp7d
2021-08-31,LU,54,48,0,48,2022-05-03_11-02-08,fp7d
2021-08-31,NE,10,10,0,10,2022-05-03_11-02-08,fp7d
2021-08-31,NW,6,4,0,4,2022-05-03_11-02-08,fp7d
2021-08-31,OW,0,0,0,0,2022-05-03_11-02-08,fp7d
2021-08-31,SG,54,45,1,44,2022-05-03_11-02-08,fp7d
2021-08-31,SH,8,6,0,6,2022-05-03_11-02-08,fp7d
2021-08-31,SO,17,17,0,17,2022-05-03_11-02-08,fp7d
2021-08-31,SZ,12,12,0,12,2022-05-03_11-02-08,fp7d
2021-08-31,TG,21,29,8,21,2022-05-03_11-02-08,fp7d
2021-08-31,TI,53,68,15,53,2022-05-03_11-02-08,fp7d
2021-08-31,UR,6,6,0,6,2022-05-03_11-02-08,fp7d
2021-08-31,VD,85,86,1,85,2022-05-03_11-02-08,fp7d
2021-08-31,VS,21,21,0,21,2022-05-03_11-02-08,fp7d
2021-08-31,ZG,8,8,0,8,2022-05-03_11-02-08,fp7d
2021-08-31,ZH,190,187,13,174,2022-05-03_11-02-08,fp7d
2021-09-01,AG,52,48,0,48,2022-05-03_11-02-08,fp7d
2021-09-01,AI,0,0,0,0,2022-05-03_11-02-08,fp7d
2021-09-01,AR,6,6,0,6,2022-05-03_11-02-08,fp7d
2021-09-01,BE,92,82,2,80,2022-05-03_11-02-08,fp7d
2021-09-01,BL,20,16,0,16,2022-05-03_11-02-08,fp7d
2021-09-01,BS,54,50,0,50,2022-05-03_11-02-08,fp7d
2021-09-01,FR,24,22,0,22,2022-05-03_11-02-08,fp7d
2021-09-01,GE,38,56,18,38,2022-05-03_11-02-08,fp7d
2021-09-01,GL,6,4,0,4,2022-05-03_11-02-08,fp7d
2021-09-01,GR,16,16,0,16,2022-05-03_11-02-08,fp7d
2021-09-01,JU,6,6,0,6,2022-05-03_11-02-08,fp7d
2021-09-01,LU,54,48,0,48,2022-05-03_11-02-08,fp7d
2021-09-01,NE,10,10,0,10,2022-05-03_11-02-08,fp7d
2021-09-01,NW,6,4,0,4,2022-05-03_11-02-08,fp7d
2021-09-01,OW,0,0,0,0,2022-05-03_11-02-08,fp7d
2021-09-01,SG,54,45,1,44,2022-05-03_11-02-08,fp7d
2021-09-01,SH,8,6,0,6,2022-05-03_11-02-08,fp7d
2021-09-01,SO,17,17,0,17,2022-05-03_11-02-08,fp7d
2021-09-01,SZ,12,12,0,12,2022-05-03_11-02-08,fp7d
2021-09-01,TG,21,29,8,21,2022-05-03_11-02-08,fp7d
2021-09-01,TI,53,68,15,53,2022-05-03_11-02-08,fp7d
2021-09-01,UR,6,6,0,6,2022-05-03_11-02-08,fp7d
2021-09-01,VD,85,86,1,85,2022-05-03_11-02-08,fp7d
2021-09-01,VS,21,21,0,21,2022-05-03_11-02-08,fp7d
2021-09-01,ZG,8,8,0,8,2022-05-03_11-02-08,fp7d
2021-09-01,ZH,190,185,12,173,2022-05-03_11-02-08,fp7d
2021-09-02,AG,52,48,0,48,2022-05-03_11-02-08,fp7d
2021-09-02,AI,0,0,0,0,2022-05-03_11-02-08,fp7d
2021-09-02,AR,6,6,0,6,2022-05-03_11-02-08,fp7d
2021-09-02,BE,92,82,2,80,2022-05-03_11-02-08,fp7d
2021-09-02,BL,20,16,0,16,2022-05-03_11-02-08,fp7d
2021-09-02,BS,54,50,0,50,2022-05-03_11-02-08,fp7d
2021-09-02,FR,24,22,0,22,2022-05-03_11-02-08,fp7d
2021-09-02,GE,38,56,18,38,2022-05-03_11-02-08,fp7d
2021-09-02,GL,6,4,0,4,2022-05-03_11-02-08,fp7d
2021-09-02,GR,16,16,0,16,2022-05-03_11-02-08,fp7d
2021-09-02,JU,6,6,0,6,2022-05-03_11-02-08,fp7d
2021-09-02,LU,54,48,0,48,2022-05-03_11-02-08,fp7d
2021-09-02,NE,10,10,0,10,2022-05-03_11-02-08,fp7d
2021-09-02,NW,6,4,0,4,2022-05-03_11-02-08,fp7d
2021-09-02,OW,0,0,0,0,2022-05-03_11-02-08,fp7d
2021-09-02,SG,54,45,1,44,2022-05-03_11-02-08,fp7d
2021-09-02,SH,8,6,0,6,2022-05-03_11-02-08,fp7d
2021-09-02,SO,17,17,0,17,2022-05-03_11-02-08,fp7d
2021-09-02,SZ,12,12,0,12,2022-05-03_11-02-08,fp7d
2021-09-02,TG,21,29,8,21,2022-05-03_11-02-08,fp7d
2021-09-02,TI,53,68,15,53,2022-05-03_11-02-08,fp7d
2021-09-02,UR,6,6,0,6,2022-05-03_11-02-08,fp7d
2021-09-02,VD,85,85,1,84,2022-05-03_11-02-08,fp7d
2021-09-02,VS,21,21,0,21,2022-05-03_11-02-08,fp7d
2021-09-02,ZG,8,8,0,8,2022-05-03_11-02-08,fp7d
2021-09-02,ZH,190,184,12,172,2022-05-03_11-02-08,fp7d
2021-09-03,AG,52,48,0,48,2022-05-03_11-02-08,fp7d
2021-09-03,AI,0,0,0,0,2022-05-03_11-02-08,fp7d
2021-09-03,AR,6,6,0,6,2022-05-03_11-02-08,fp7d
2021-09-03,BE,92,82,2,80,2022-05-03_11-02-08,fp7d
2021-09-03,BL,20,16,0,16,2022-05-03_11-02-08,fp7d
2021-09-03,BS,54,50,0,50,2022-05-03_11-02-08,fp7d
2021-09-03,FR,24,22,0,22,2022-05-03_11-02-08,fp7d
2021-09-03,GE,38,56,18,38,2022-05-03_11-02-08,fp7d
2021-09-03,GL,6,4,0,4,2022-05-03_11-02-08,fp7d
2021-09-03,GR,16,16,0,16,2022-05-03_11-02-08,fp7d
2021-09-03,JU,6,6,0,6,2022-05-03_11-02-08,fp7d
2021-09-03,LU,54,50,2,48,2022-05-03_11-02-08,fp7d
2021-09-03,NE,10,10,0,10,2022-05-03_11-02-08,fp7d
2021-09-03,NW,6,4,0,4,2022-05-03_11-02-08,fp7d
2021-09-03,OW,0,0,0,0,2022-05-03_11-02-08,fp7d
2021-09-03,SG,54,45,1,44,2022-05-03_11-02-08,fp7d
2021-09-03,SH,8,6,0,6,2022-05-03_11-02-08,fp7d
2021-09-03,SO,17,17,0,17,2022-05-03_11-02-08,fp7d
2021-09-03,SZ,12,12,0,12,2022-05-03_11-02-08,fp7d
2021-09-03,TG,21,29,8,21,2022-05-03_11-02-08,fp7d
2021-09-03,TI,53,68,15,53,2022-05-03_11-02-08,fp7d
2021-09-03,UR,6,6,0,6,2022-05-03_11-02-08,fp7d
2021-09-03,VD,85,85,1,84,2022-05-03_11-02-08,fp7d
2021-09-03,VS,21,21,0,21,2022-05-03_11-02-08,fp7d
2021-09-03,ZG,8,8,0,8,2022-05-03_11-02-08,fp7d
2021-09-03,ZH,190,186,12,174,2022-05-03_11-02-08,fp7d
2021-09-04,AG,52,48,0,48,2022-05-03_11-02-08,fp7d
2021-09-04,AI,0,0,0,0,2022-05-03_11-02-08,fp7d
2021-09-04,AR,6,6,0,6,2022-05-03_11-02-08,fp7d
2021-09-04,BE,92,82,2,80,2022-05-03_11-02-08,fp7d
2021-09-04,BL,20,16,0,16,2022-05-03_11-02-08,fp7d
2021-09-04,BS,54,46,0,46,2022-05-03_11-02-08,fp7d
2021-09-04,FR,24,22,0,22,2022-05-03_11-02-08,fp7d
2021-09-04,GE,38,56,18,38,2022-05-03_11-02-08,fp7d
2021-09-04,GL,6,4,0,4,2022-05-03_11-02-08,fp7d
2021-09-04,GR,16,16,0,16,2022-05-03_11-02-08,fp7d
2021-09-04,JU,6,6,0,6,2022-05-03_11-02-08,fp7d
2021-09-04,LU,54,48,0,48,2022-05-03_11-02-08,fp7d
2021-09-04,NE,10,10,0,10,2022-05-03_11-02-08,fp7d
2021-09-04,NW,6,4,0,4,2022-05-03_11-02-08,fp7d
2021-09-04,OW,0,0,0,0,2022-05-03_11-02-08,fp7d
2021-09-04,SG,54,45,1,44,2022-05-03_11-02-08,fp7d
2021-09-04,SH,8,6,0,6,2022-05-03_11-02-08,fp7d
2021-09-04,SO,17,17,0,17,2022-05-03_11-02-08,fp7d
2021-09-04,SZ,12,12,0,12,2022-05-03_11-02-08,fp7d
2021-09-04,TG,21,29,8,21,2022-05-03_11-02-08,fp7d
2021-09-04,TI,53,68,15,53,2022-05-03_11-02-08,fp7d
2021-09-04,UR,6,6,0,6,2022-05-03_11-02-08,fp7d
2021-09-04,VD,85,85,1,84,2022-05-03_11-02-08,fp7d
2021-09-04,VS,21,21,0,21,2022-05-03_11-02-08,fp7d
2021-09-04,ZG,8,8,0,8,2022-05-03_11-02-08,fp7d
2021-09-04,ZH,190,178,6,172,2022-05-03_11-02-08,fp7d
2021-09-05,AG,52,47,0,47,2022-05-03_11-02-08,fp7d
2021-09-05,AI,0,0,0,0,2022-05-03_11-02-08,fp7d
2021-09-05,AR,6,6,0,6,2022-05-03_11-02-08,fp7d
2021-09-05,BE,104,88,2,86,2022-05-03_11-02-08,fp7d
2021-09-05,BL,20,16,0,16,2022-05-03_11-02-08,fp7d
2021-09-05,BS,54,46,0,46,2022-05-03_11-02-08,fp7d
2021-09-05,FR,24,22,0,22,2022-05-03_11-02-08,fp7d
2021-09-05,GE,38,56,18,38,2022-05-03_11-02-08,fp7d
2021-09-05,GL,6,4,0,4,2022-05-03_11-02-08,fp7d
2021-09-05,GR,16,16,0,16,2022-05-03_11-02-08,fp7d
2021-09-05,JU,6,6,0,6,2022-05-03_11-02-08,fp7d
2021-09-05,LU,54,48,0,48,2022-05-03_11-02-08,fp7d
2021-09-05,NE,10,10,0,10,2022-05-03_11-02-08,fp7d
2021-09-05,NW,6,4,0,4,2022-05-03_11-02-08,fp7d
2021-09-05,OW,0,0,0,0,2022-05-03_11-02-08,fp7d
2021-09-05,SG,54,45,1,44,2022-05-03_11-02-08,fp7d
2021-09-05,SH,8,6,0,6,2022-05-03_11-02-08,fp7d
2021-09-05,SO,17,17,0,17,2022-05-03_11-02-08,fp7d
2021-09-05,SZ,12,12,0,12,2022-05-03_11-02-08,fp7d
2021-09-05,TG,21,29,8,21,2022-05-03_11-02-08,fp7d
2021-09-05,TI,53,68,15,53,2022-05-03_11-02-08,fp7d
2021-09-05,UR,6,6,0,6,2022-05-03_11-02-08,fp7d
2021-09-05,VD,85,85,1,84,2022-05-03_11-02-08,fp7d
2021-09-05,VS,21,21,0,21,2022-05-03_11-02-08,fp7d
2021-09-05,ZG,8,8,0,8,2022-05-03_11-02-08,fp7d
2021-09-05,ZH,190,178,6,172,2022-05-03_11-02-08,fp7d
2021-09-06,AG,52,48,0,48,2022-05-03_11-02-08,fp7d
2021-09-06,AI,0,0,0,0,2022-05-03_11-02-08,fp7d
2021-09-06,AR,6,6,0,6,2022-05-03_11-02-08,fp7d
2021-09-06,BE,104,93,2,91,2022-05-03_11-02-08,fp7d
2021-09-06,BL,20,16,0,16,2022-05-03_11-02-08,fp7d
2021-09-06,BS,54,50,0,50,2022-05-03_11-02-08,fp7d
2021-09-06,FR,24,22,0,22,2022-05-03_11-02-08,fp7d
2021-09-06,GE,38,56,18,38,2022-05-03_11-02-08,fp7d
2021-09-06,GL,6,5,0,5,2022-05-03_11-02-08,fp7d
2021-09-06,GR,16,16,0,16,2022-05-03_11-02-08,fp7d
2021-09-06,JU,6,6,0,6,2022-05-03_11-02-08,fp7d
2021-09-06,LU,54,50,2,48,2022-05-03_11-02-08,fp7d
2021-09-06,NE,9,9,0,9,2022-05-03_11-02-08,fp7d
2021-09-06,NW,6,4,0,4,2022-05-03_11-02-08,fp7d
2021-09-06,OW,0,0,0,0,2022-05-03_11-02-08,fp7d
2021-09-06,SG,54,48,1,47,2022-05-03_11-02-08,fp7d
2021-09-06,SH,8,6,0,6,2022-05-03_11-02-08,fp7d
2021-09-06,SO,17,17,0,17,2022-05-03_11-02-08,fp7d
2021-09-06,SZ,12,10,0,10,2022-05-03_11-02-08,fp7d
2021-09-06,TG,21,26,5,21,2022-05-03_11-02-08,fp7d
2021-09-06,TI,53,68,15,53,2022-05-03_11-02-08,fp7d
2021-09-06,UR,6,6,0,6,2022-05-03_11-02-08,fp7d
2021-09-06,VD,85,85,1,84,2022-05-03_11-02-08,fp7d
2021-09-06,VS,21,21,0,21,2022-05-03_11-02-08,fp7d
2021-09-06,ZG,8,8,0,8,2022-05-03_11-02-08,fp7d
2021-09-06,ZH,190,178,6,172,2022-05-03_11-02-08,fp7d
2021-09-07,AG,52,48,0,48,2022-05-03_11-02-08,fp7d
2021-09-07,AI,0,0,0,0,2022-05-03_11-02-08,fp7d
2021-09-07,AR,6,6,0,6,2022-05-03_11-02-08,fp7d
2021-09-07,BE,104,91,2,89,2022-05-03_11-02-08,fp7d
2021-09-07,BL,20,16,0,16,2022-05-03_11-02-08,fp7d
2021-09-07,BS,54,50,0,50,2022-05-03_11-02-08,fp7d
2021-09-07,FR,24,22,0,22,2022-05-03_11-02-08,fp7d
2021-09-07,GE,38,56,18,38,2022-05-03_11-02-08,fp7d
2021-09-07,GL,6,5,0,5,2022-05-03_11-02-08,fp7d
2021-09-07,GR,16,16,0,16,2022-05-03_11-02-08,fp7d
2021-09-07,JU,6,6,0,6,2022-05-03_11-02-08,fp7d
2021-09-07,LU,54,50,2,48,2022-05-03_11-02-08,fp7d
2021-09-07,NE,9,9,0,9,2022-05-03_11-02-08,fp7d
2021-09-07,NW,6,5,0,5,2022-05-03_11-02-08,fp7d
2021-09-07,OW,0,0,0,0,2022-05-03_11-02-08,fp7d
2021-09-07,SG,54,48,1,47,2022-05-03_11-02-08,fp7d
2021-09-07,SH,8,6,0,6,2022-05-03_11-02-08,fp7d
2021-09-07,SO,17,17,0,17,2022-05-03_11-02-08,fp7d
2021-09-07,SZ,12,10,0,10,2022-05-03_11-02-08,fp7d
2021-09-07,TG,21,26,5,21,2022-05-03_11-02-08,fp7d
2021-09-07,TI,53,68,15,53,2022-05-03_11-02-08,fp7d
2021-09-07,UR,6,6,0,6,2022-05-03_11-02-08,fp7d
2021-09-07,VD,85,85,1,84,2022-05-03_11-02-08,fp7d
2021-09-07,VS,21,21,0,21,2022-05-03_11-02-08,fp7d
2021-09-07,ZG,8,8,0,8,2022-05-03_11-02-08,fp7d
2021-09-07,ZH,190,181,6,175,2022-05-03_11-02-08,fp7d
2021-09-08,AG,52,48,0,48,2022-05-03_11-02-08,fp7d
2021-09-08,AI,0,0,0,0,2022-05-03_11-02-08,fp7d
2021-09-08,AR,6,6,0,6,2022-05-03_11-02-08,fp7d
2021-09-08,BE,104,91,2,89,2022-05-03_11-02-08,fp7d
2021-09-08,BL,20,16,0,16,2022-05-03_11-02-08,fp7d
2021-09-08,BS,54,50,0,50,2022-05-03_11-02-08,fp7d
2021-09-08,FR,24,22,0,22,2022-05-03_11-02-08,fp7d
2021-09-08,GE,38,56,18,38,2022-05-03_11-02-08,fp7d
2021-09-08,GL,6,6,0,6,2022-05-03_11-02-08,fp7d
2021-09-08,GR,16,16,0,16,2022-05-03_11-02-08,fp7d
2021-09-08,JU,6,6,0,6,2022-05-03_11-02-08,fp7d
2021-09-08,LU,54,50,2,48,2022-05-03_11-02-08,fp7d
2021-09-08,NE,10,10,0,10,2022-05-03_11-02-08,fp7d
2021-09-08,NW,6,5,0,5,2022-05-03_11-02-08,fp7d
2021-09-08,OW,0,0,0,0,2022-05-03_11-02-08,fp7d
2021-09-08,SG,54,48,1,47,2022-05-03_11-02-08,fp7d
2021-09-08,SH,8,6,0,6,2022-05-03_11-02-08,fp7d
2021-09-08,SO,17,17,0,17,2022-05-03_11-02-08,fp7d
2021-09-08,SZ,12,10,0,10,2022-05-03_11-02-08,fp7d
2021-09-08,TG,21,26,5,21,2022-05-03_11-02-08,fp7d
2021-09-08,TI,53,68,15,53,2022-05-03_11-02-08,fp7d
2021-09-08,UR,6,6,0,6,2022-05-03_11-02-08,fp7d
2021-09-08,VD,85,85,1,84,2022-05-03_11-02-08,fp7d
2021-09-08,VS,21,21,0,21,2022-05-03_11-02-08,fp7d
2021-09-08,ZG,8,8,0,8,2022-05-03_11-02-08,fp7d
2021-09-08,ZH,190,180,6,174,2022-05-03_11-02-08,fp7d
2021-09-09,AG,52,48,0,48,2022-05-03_11-02-08,fp7d
2021-09-09,AI,0,0,0,0,2022-05-03_11-02-08,fp7d
2021-09-09,AR,6,6,0,6,2022-05-03_11-02-08,fp7d
2021-09-09,BE,103,89,2,87,2022-05-03_11-02-08,fp7d
2021-09-09,BL,20,16,0,16,2022-05-03_11-02-08,fp7d
2021-09-09,BS,54,50,0,50,2022-05-03_11-02-08,fp7d
2021-09-09,FR,24,22,0,22,2022-05-03_11-02-08,fp7d
2021-09-09,GE,38,56,18,38,2022-05-03_11-02-08,fp7d
2021-09-09,GL,6,6,0,6,2022-05-03_11-02-08,fp7d
2021-09-09,GR,16,16,0,16,2022-05-03_11-02-08,fp7d
2021-09-09,JU,6,6,0,6,2022-05-03_11-02-08,fp7d
2021-09-09,LU,54,50,2,48,2022-05-03_11-02-08,fp7d
2021-09-09,NE,10,10,0,10,2022-05-03_11-02-08,fp7d
2021-09-09,NW,6,5,0,5,2022-05-03_11-02-08,fp7d
2021-09-09,OW,0,0,0,0,2022-05-03_11-02-08,fp7d
2021-09-09,SG,54,48,1,47,2022-05-03_11-02-08,fp7d
2021-09-09,SH,8,6,0,6,2022-05-03_11-02-08,fp7d
2021-09-09,SO,17,16,0,16,2022-05-03_11-02-08,fp7d
2021-09-09,SZ,12,10,0,10,2022-05-03_11-02-08,fp7d
2021-09-09,TG,21,27,6,21,2022-05-03_11-02-08,fp7d
2021-09-09,TI,53,57,4,53,2022-05-03_11-02-08,fp7d
2021-09-09,UR,6,6,0,6,2022-05-03_11-02-08,fp7d
2021-09-09,VD,85,84,1,83,2022-05-03_11-02-08,fp7d
2021-09-09,VS,21,21,0,21,2022-05-03_11-02-08,fp7d
2021-09-09,ZG,8,8,0,8,2022-05-03_11-02-08,fp7d
2021-09-09,ZH,190,181,7,174,2022-05-03_11-02-08,fp7d
2021-09-10,AG,52,48,0,48,2022-05-03_11-02-08,fp7d
2021-09-10,AI,0,0,0,0,2022-05-03_11-02-08,fp7d
2021-09-10,AR,6,6,0,6,2022-05-03_11-02-08,fp7d
2021-09-10,BE,103,88,2,86,2022-05-03_11-02-08,fp7d
2021-09-10,BL,20,15,0,15,2022-05-03_11-02-08,fp7d
2021-09-10,BS,54,50,0,50,2022-05-03_11-02-08,fp7d
2021-09-10,FR,24,22,0,22,2022-05-03_11-02-08,fp7d
2021-09-10,GE,38,52,14,38,2022-05-03_11-02-08,fp7d
2021-09-10,GL,6,6,0,6,2022-05-03_11-02-08,fp7d
2021-09-10,GR,16,16,0,16,2022-05-03_11-02-08,fp7d
2021-09-10,JU,6,6,0,6,2022-05-03_11-02-08,fp7d
2021-09-10,LU,54,50,2,48,2022-05-03_11-02-08,fp7d
2021-09-10,NE,10,10,0,10,2022-05-03_11-02-08,fp7d
2021-09-10,NW,6,5,0,5,2022-05-03_11-02-08,fp7d
2021-09-10,OW,0,0,0,0,2022-05-03_11-02-08,fp7d
2021-09-10,SG,54,48,1,47,2022-05-03_11-02-08,fp7d
2021-09-10,SH,8,6,0,6,2022-05-03_11-02-08,fp7d
2021-09-10,SO,17,16,0,16,2022-05-03_11-02-08,fp7d
2021-09-10,SZ,12,10,0,10,2022-05-03_11-02-08,fp7d
2021-09-10,TG,21,27,6,21,2022-05-03_11-02-08,fp7d
2021-09-10,TI,53,57,4,53,2022-05-03_11-02-08,fp7d
2021-09-10,UR,6,6,0,6,2022-05-03_11-02-08,fp7d
2021-09-10,VD,85,85,1,84,2022-05-03_11-02-08,fp7d
2021-09-10,VS,21,21,0,21,2022-05-03_11-02-08,fp7d
2021-09-10,ZG,8,8,0,8,2022-05-03_11-02-08,fp7d
2021-09-10,ZH,190,181,6,175,2022-05-03_11-02-08,fp7d
2021-09-11,AG,52,48,0,48,2022-05-03_11-02-08,fp7d
2021-09-11,AI,0,0,0,0,2022-05-03_11-02-08,fp7d
2021-09-11,AR,6,6,0,6,2022-05-03_11-02-08,fp7d
2021-09-11,BE,103,89,2,87,2022-05-03_11-02-08,fp7d
2021-09-11,BL,20,15,0,15,2022-05-03_11-02-08,fp7d
2021-09-11,BS,54,46,0,46,2022-05-03_11-02-08,fp7d
2021-09-11,FR,24,22,0,22,2022-05-03_11-02-08,fp7d
2021-09-11,GE,38,52,14,38,2022-05-03_11-02-08,fp7d
2021-09-11,GL,6,6,0,6,2022-05-03_11-02-08,fp7d
2021-09-11,GR,16,16,0,16,2022-05-03_11-02-08,fp7d
2021-09-11,JU,6,6,0,6,2022-05-03_11-02-08,fp7d
2021-09-11,LU,54,48,2,46,2022-05-03_11-02-08,fp7d
2021-09-11,NE,10,10,0,10,2022-05-03_11-02-08,fp7d
2021-09-11,NW,6,5,0,5,2022-05-03_11-02-08,fp7d
2021-09-11,OW,0,0,0,0,2022-05-03_11-02-08,fp7d
2021-09-11,SG,54,48,1,47,2022-05-03_11-02-08,fp7d
2021-09-11,SH,8,6,0,6,2022-05-03_11-02-08,fp7d
2021-09-11,SO,17,16,0,16,2022-05-03_11-02-08,fp7d
2021-09-11,SZ,12,10,0,10,2022-05-03_11-02-08,fp7d
2021-09-11,TG,21,27,6,21,2022-05-03_11-02-08,fp7d
2021-09-11,TI,53,57,4,53,2022-05-03_11-02-08,fp7d
2021-09-11,UR,6,6,0,6,2022-05-03_11-02-08,fp7d
2021-09-11,VD,85,85,1,84,2022-05-03_11-02-08,fp7d
2021-09-11,VS,21,21,0,21,2022-05-03_11-02-08,fp7d
2021-09-11,ZG,8,8,0,8,2022-05-03_11-02-08,fp7d
2021-09-11,ZH,190,181,6,175,2022-05-03_11-02-08,fp7d
2021-09-12,AG,52,48,0,48,2022-05-03_11-02-08,fp7d
2021-09-12,AI,0,0,0,0,2022-05-03_11-02-08,fp7d
2021-09-12,AR,6,6,0,6,2022-05-03_11-02-08,fp7d
2021-09-12,BE,103,86,2,84,2022-05-03_11-02-08,fp7d
2021-09-12,BL,20,15,0,15,2022-05-03_11-02-08,fp7d
2021-09-12,BS,54,46,0,46,2022-05-03_11-02-08,fp7d
2021-09-12,FR,24,22,0,22,2022-05-03_11-02-08,fp7d
2021-09-12,GE,38,52,14,38,2022-05-03_11-02-08,fp7d
2021-09-12,GL,6,5,0,5,2022-05-03_11-02-08,fp7d
2021-09-12,GR,16,16,0,16,2022-05-03_11-02-08,fp7d
2021-09-12,JU,6,6,0,6,2022-05-03_11-02-08,fp7d
2021-09-12,LU,54,47,2,45,2022-05-03_11-02-08,fp7d
2021-09-12,NE,10,10,0,10,2022-05-03_11-02-08,fp7d
2021-09-12,NW,6,5,0,5,2022-05-03_11-02-08,fp7d
2021-09-12,OW,0,0,0,0,2022-05-03_11-02-08,fp7d
2021-09-12,SG,54,48,1,47,2022-05-03_11-02-08,fp7d
2021-09-12,SH,8,6,0,6,2022-05-03_11-02-08,fp7d
2021-09-12,SO,17,16,0,16,2022-05-03_11-02-08,fp7d
2021-09-12,SZ,12,10,0,10,2022-05-03_11-02-08,fp7d
2021-09-12,TG,21,27,6,21,2022-05-03_11-02-08,fp7d
2021-09-12,TI,53,57,4,53,2022-05-03_11-02-08,fp7d
2021-09-12,UR,6,6,0,6,2022-05-03_11-02-08,fp7d
2021-09-12,VD,85,85,1,84,2022-05-03_11-02-08,fp7d
2021-09-12,VS,21,21,0,21,2022-05-03_11-02-08,fp7d
2021-09-12,ZG,8,8,0,8,2022-05-03_11-02-08,fp7d
2021-09-12,ZH,190,180,6,174,2022-05-03_11-02-08,fp7d
2021-09-13,AG,52,48,0,48,2022-05-03_11-02-08,fp7d
2021-09-13,AI,0,0,0,0,2022-05-03_11-02-08,fp7d
2021-09-13,AR,6,6,0,6,2022-05-03_11-02-08,fp7d
2021-09-13,BE,103,90,2,88,2022-05-03_11-02-08,fp7d
2021-09-13,BL,20,15,0,15,2022-05-03_11-02-08,fp7d
2021-09-13,BS,54,50,0,50,2022-05-03_11-02-08,fp7d
2021-09-13,FR,24,22,0,22,2022-05-03_11-02-08,fp7d
2021-09-13,GE,38,56,18,38,2022-05-03_11-02-08,fp7d
2021-09-13,GL,6,6,0,6,2022-05-03_11-02-08,fp7d
2021-09-13,GR,16,16,0,16,2022-05-03_11-02-08,fp7d
2021-09-13,JU,6,6,0,6,2022-05-03_11-02-08,fp7d
2021-09-13,LU,54,47,2,45,2022-05-03_11-02-08,fp7d
2021-09-13,NE,10,10,0,10,2022-05-03_11-02-08,fp7d
2021-09-13,NW,6,5,0,5,2022-05-03_11-02-08,fp7d
2021-09-13,OW,0,0,0,0,2022-05-03_11-02-08,fp7d
2021-09-13,SG,54,48,1,47,2022-05-03_11-02-08,fp7d
2021-09-13,SH,8,6,0,6,2022-05-03_11-02-08,fp7d
2021-09-13,SO,17,17,0,17,2022-05-03_11-02-08,fp7d
2021-09-13,SZ,12,10,0,10,2022-05-03_11-02-08,fp7d
2021-09-13,TG,21,27,6,21,2022-05-03_11-02-08,fp7d
2021-09-13,TI,53,57,4,53,2022-05-03_11-02-08,fp7d
2021-09-13,UR,6,6,0,6,2022-05-03_11-02-08,fp7d
2021-09-13,VD,85,85,1,84,2022-05-03_11-02-08,fp7d
2021-09-13,VS,21,21,0,21,2022-05-03_11-02-08,fp7d
2021-09-13,ZG,8,8,0,8,2022-05-03_11-02-08,fp7d
2021-09-13,ZH,190,182,7,175,2022-05-03_11-02-08,fp7d
2021-09-14,AG,52,49,1,48,2022-05-03_11-02-08,fp7d
2021-09-14,AI,0,0,0,0,2022-05-03_11-02-08,fp7d
2021-09-14,AR,6,6,0,6,2022-05-03_11-02-08,fp7d
2021-09-14,BE,103,88,2,86,2022-05-03_11-02-08,fp7d
2021-09-14,BL,20,15,0,15,2022-05-03_11-02-08,fp7d
2021-09-14,BS,54,50,0,50,2022-05-03_11-02-08,fp7d
2021-09-14,FR,24,22,0,22,2022-05-03_11-02-08,fp7d
2021-09-14,GE,38,56,18,38,2022-05-03_11-02-08,fp7d
2021-09-14,GL,6,6,0,6,2022-05-03_11-02-08,fp7d
2021-09-14,GR,16,16,0,16,2022-05-03_11-02-08,fp7d
2021-09-14,JU,6,6,0,6,2022-05-03_11-02-08,fp7d
2021-09-14,LU,54,47,2,45,2022-05-03_11-02-08,fp7d
2021-09-14,NE,10,10,0,10,2022-05-03_11-02-08,fp7d
2021-09-14,NW,6,5,0,5,2022-05-03_11-02-08,fp7d
2021-09-14,OW,0,0,0,0,2022-05-03_11-02-08,fp7d
2021-09-14,SG,54,48,1,47,2022-05-03_11-02-08,fp7d
2021-09-14,SH,8,6,0,6,2022-05-03_11-02-08,fp7d
2021-09-14,SO,17,17,0,17,2022-05-03_11-02-08,fp7d
2021-09-14,SZ,12,10,0,10,2022-05-03_11-02-08,fp7d
2021-09-14,TG,21,27,6,21,2022-05-03_11-02-08,fp7d
2021-09-14,TI,53,57,4,53,2022-05-03_11-02-08,fp7d
2021-09-14,UR,6,6,0,6,2022-05-03_11-02-08,fp7d
2021-09-14,VD,85,85,1,84,2022-05-03_11-02-08,fp7d
2021-09-14,VS,21,21,0,21,2022-05-03_11-02-08,fp7d
2021-09-14,ZG,8,8,0,8,2022-05-03_11-02-08,fp7d
2021-09-14,ZH,190,183,8,175,2022-05-03_11-02-08,fp7d
2021-09-15,AG,52,49,1,48,2022-05-03_11-02-08,fp7d
2021-09-15,AI,0,0,0,0,2022-05-03_11-02-08,fp7d
2021-09-15,AR,6,6,0,6,2022-05-03_11-02-08,fp7d
2021-09-15,BE,103,88,2,86,2022-05-03_11-02-08,fp7d
2021-09-15,BL,20,15,0,15,2022-05-03_11-02-08,fp7d
2021-09-15,BS,54,50,0,50,2022-05-03_11-02-08,fp7d
2021-09-15,FR,24,22,0,22,2022-05-03_11-02-08,fp7d
2021-09-15,GE,38,56,18,38,2022-05-03_11-02-08,fp7d
2021-09-15,GL,6,6,0,6,2022-05-03_11-02-08,fp7d
2021-09-15,GR,16,16,0,16,2022-05-03_11-02-08,fp7d
2021-09-15,JU,6,6,0,6,2022-05-03_11-02-08,fp7d
2021-09-15,LU,54,47,2,45,2022-05-03_11-02-08,fp7d
2021-09-15,NE,10,10,0,10,2022-05-03_11-02-08,fp7d
2021-09-15,NW,6,5,0,5,2022-05-03_11-02-08,fp7d
2021-09-15,OW,0,0,0,0,2022-05-03_11-02-08,fp7d
2021-09-15,SG,54,48,1,47,2022-05-03_11-02-08,fp7d
2021-09-15,SH,8,6,0,6,2022-05-03_11-02-08,fp7d
2021-09-15,SO,17,17,0,17,2022-05-03_11-02-08,fp7d
2021-09-15,SZ,12,10,0,10,2022-05-03_11-02-08,fp7d
2021-09-15,TG,21,28,7,21,2022-05-03_11-02-08,fp7d
2021-09-15,TI,53,57,4,53,2022-05-03_11-02-08,fp7d
2021-09-15,UR,6,6,0,6,2022-05-03_11-02-08,fp7d
2021-09-15,VD,85,86,1,85,2022-05-03_11-02-08,fp7d
2021-09-15,VS,21,21,0,21,2022-05-03_11-02-08,fp7d
2021-09-15,ZG,8,8,0,8,2022-05-03_11-02-08,fp7d
2021-09-15,ZH,190,181,6,175,2022-05-03_11-02-08,fp7d
2021-09-16,AG,52,49,1,48,2022-05-03_11-02-08,fp7d
2021-09-16,AI,0,0,0,0,2022-05-03_11-02-08,fp7d
2021-09-16,AR,6,6,0,6,2022-05-03_11-02-08,fp7d
2021-09-16,BE,103,88,2,86,2022-05-03_11-02-08,fp7d
2021-09-16,BL,20,15,0,15,2022-05-03_11-02-08,fp7d
2021-09-16,BS,54,50,0,50,2022-05-03_11-02-08,fp7d
2021-09-16,FR,24,22,0,22,2022-05-03_11-02-08,fp7d
2021-09-16,GE,38,56,18,38,2022-05-03_11-02-08,fp7d
2021-09-16,GL,6,6,0,6,2022-05-03_11-02-08,fp7d
2021-09-16,GR,16,16,0,16,2022-05-03_11-02-08,fp7d
2021-09-16,JU,6,6,0,6,2022-05-03_11-02-08,fp7d
2021-09-16,LU,54,47,2,45,2022-05-03_11-02-08,fp7d
2021-09-16,NE,10,10,0,10,2022-05-03_11-02-08,fp7d
2021-09-16,NW,6,6,0,6,2022-05-03_11-02-08,fp7d
2021-09-16,OW,0,0,0,0,2022-05-03_11-02-08,fp7d
2021-09-16,SG,54,48,1,47,2022-05-03_11-02-08,fp7d
2021-09-16,SH,8,7,0,7,2022-05-03_11-02-08,fp7d
2021-09-16,SO,17,17,0,17,2022-05-03_11-02-08,fp7d
2021-09-16,SZ,12,10,0,10,2022-05-03_11-02-08,fp7d
2021-09-16,TG,21,27,6,21,2022-05-03_11-02-08,fp7d
2021-09-16,TI,53,57,4,53,2022-05-03_11-02-08,fp7d
2021-09-16,UR,6,6,0,6,2022-05-03_11-02-08,fp7d
2021-09-16,VD,85,86,1,85,2022-05-03_11-02-08,fp7d
2021-09-16,VS,21,21,0,21,2022-05-03_11-02-08,fp7d
2021-09-16,ZG,8,8,0,8,2022-05-03_11-02-08,fp7d
2021-09-16,ZH,190,182,7,175,2022-05-03_11-02-08,fp7d
2021-09-17,AG,52,49,1,48,2022-05-03_11-02-08,fp7d
2021-09-17,AI,0,0,0,0,2022-05-03_11-02-08,fp7d
2021-09-17,AR,6,6,0,6,2022-05-03_11-02-08,fp7d
2021-09-17,BE,103,88,2,86,2022-05-03_11-02-08,fp7d
2021-09-17,BL,20,15,0,15,2022-05-03_11-02-08,fp7d
2021-09-17,BS,54,50,0,50,2022-05-03_11-02-08,fp7d
2021-09-17,FR,24,22,0,22,2022-05-03_11-02-08,fp7d
2021-09-17,GE,38,56,18,38,2022-05-03_11-02-08,fp7d
2021-09-17,GL,6,6,0,6,2022-05-03_11-02-08,fp7d
2021-09-17,GR,16,16,0,16,2022-05-03_11-02-08,fp7d
2021-09-17,JU,6,6,0,6,2022-05-03_11-02-08,fp7d
2021-09-17,LU,54,47,2,45,2022-05-03_11-02-08,fp7d
2021-09-17,NE,10,10,0,10,2022-05-03_11-02-08,fp7d
2021-09-17,NW,6,5,0,5,2022-05-03_11-02-08,fp7d
2021-09-17,OW,0,0,0,0,2022-05-03_11-02-08,fp7d
2021-09-17,SG,54,48,1,47,2022-05-03_11-02-08,fp7d
2021-09-17,SH,8,6,0,6,2022-05-03_11-02-08,fp7d
2021-09-17,SO,17,17,0,17,2022-05-03_11-02-08,fp7d
2021-09-17,SZ,12,10,0,10,2022-05-03_11-02-08,fp7d
2021-09-17,TG,21,28,7,21,2022-05-03_11-02-08,fp7d
2021-09-17,TI,53,57,4,53,2022-05-03_11-02-08,fp7d
2021-09-17,UR,6,6,0,6,2022-05-03_11-02-08,fp7d
2021-09-17,VD,85,86,1,85,2022-05-03_11-02-08,fp7d
2021-09-17,VS,21,21,0,21,2022-05-03_11-02-08,fp7d
2021-09-17,ZG,8,8,0,8,2022-05-03_11-02-08,fp7d
2021-09-17,ZH,190,181,7,174,2022-05-03_11-02-08,fp7d
2021-09-18,AG,52,49,1,48,2022-05-03_11-02-08,fp7d
2021-09-18,AI,0,0,0,0,2022-05-03_11-02-08,fp7d
2021-09-18,AR,6,6,0,6,2022-05-03_11-02-08,fp7d
2021-09-18,BE,103,87,2,85,2022-05-03_11-02-08,fp7d
2021-09-18,BL,20,15,0,15,2022-05-03_11-02-08,fp7d
2021-09-18,BS,54,46,0,46,2022-05-03_11-02-08,fp7d
2021-09-18,FR,24,22,0,22,2022-05-03_11-02-08,fp7d
2021-09-18,GE,38,56,18,38,2022-05-03_11-02-08,fp7d
2021-09-18,GL,6,6,0,6,2022-05-03_11-02-08,fp7d
2021-09-18,GR,16,18,2,16,2022-05-03_11-02-08,fp7d
2021-09-18,JU,6,6,0,6,2022-05-03_11-02-08,fp7d
2021-09-18,LU,54,45,0,45,2022-05-03_11-02-08,fp7d
2021-09-18,NE,10,10,0,10,2022-05-03_11-02-08,fp7d
2021-09-18,NW,6,5,0,5,2022-05-03_11-02-08,fp7d
2021-09-18,OW,0,0,0,0,2022-05-03_11-02-08,fp7d
2021-09-18,SG,54,48,1,47,2022-05-03_11-02-08,fp7d
2021-09-18,SH,8,6,0,6,2022-05-03_11-02-08,fp7d
2021-09-18,SO,17,17,0,17,2022-05-03_11-02-08,fp7d
2021-09-18,SZ,12,10,0,10,2022-05-03_11-02-08,fp7d
2021-09-18,TG,21,28,7,21,2022-05-03_11-02-08,fp7d
2021-09-18,TI,53,57,4,53,2022-05-03_11-02-08,fp7d
2021-09-18,UR,6,6,0,6,2022-05-03_11-02-08,fp7d
2021-09-18,VD,85,86,1,85,2022-05-03_11-02-08,fp7d
2021-09-18,VS,21,21,0,21,2022-05-03_11-02-08,fp7d
2021-09-18,ZG,8,8,0,8,2022-05-03_11-02-08,fp7d
2021-09-18,ZH,190,185,12,173,2022-05-03_11-02-08,fp7d
2021-09-19,AG,52,49,1,48,2022-05-03_11-02-08,fp7d
2021-09-19,AI,0,0,0,0,2022-05-03_11-02-08,fp7d
2021-09-19,AR,6,6,0,6,2022-05-03_11-02-08,fp7d
2021-09-19,BE,103,87,2,85,2022-05-03_11-02-08,fp7d
2021-09-19,BL,20,15,0,15,2022-05-03_11-02-08,fp7d
2021-09-19,BS,54,44,0,44,2022-05-03_11-02-08,fp7d
2021-09-19,FR,24,22,0,22,2022-05-03_11-02-08,fp7d
2021-09-19,GE,38,56,18,38,2022-05-03_11-02-08,fp7d
2021-09-19,GL,6,6,0,6,2022-05-03_11-02-08,fp7d
2021-09-19,GR,16,16,0,16,2022-05-03_11-02-08,fp7d
2021-09-19,JU,6,6,0,6,2022-05-03_11-02-08,fp7d
2021-09-19,LU,54,45,0,45,2022-05-03_11-02-08,fp7d
2021-09-19,NE,10,10,0,10,2022-05-03_11-02-08,fp7d
2021-09-19,NW,6,5,0,5,2022-05-03_11-02-08,fp7d
2021-09-19,OW,0,0,0,0,2022-05-03_11-02-08,fp7d
2021-09-19,SG,54,48,1,47,2022-05-03_11-02-08,fp7d
2021-09-19,SH,8,6,0,6,2022-05-03_11-02-08,fp7d
2021-09-19,SO,17,17,0,17,2022-05-03_11-02-08,fp7d
2021-09-19,SZ,12,10,0,10,2022-05-03_11-02-08,fp7d
2021-09-19,TG,21,28,7,21,2022-05-03_11-02-08,fp7d
2021-09-19,TI,53,57,4,53,2022-05-03_11-02-08,fp7d
2021-09-19,UR,6,6,0,6,2022-05-03_11-02-08,fp7d
2021-09-19,VD,85,86,1,85,2022-05-03_11-02-08,fp7d
2021-09-19,VS,21,21,0,21,2022-05-03_11-02-08,fp7d
2021-09-19,ZG,8,8,0,8,2022-05-03_11-02-08,fp7d
2021-09-19,ZH,190,178,6,172,2022-05-03_11-02-08,fp7d
2021-09-20,AG,52,49,1,48,2022-05-03_11-02-08,fp7d
2021-09-20,AI,0,0,0,0,2022-05-03_11-02-08,fp7d
2021-09-20,AR,6,6,0,6,2022-05-03_11-02-08,fp7d
2021-09-20,BE,103,89,2,87,2022-05-03_11-02-08,fp7d
2021-09-20,BL,20,15,0,15,2022-05-03_11-02-08,fp7d
2021-09-20,BS,54,50,0,50,2022-05-03_11-02-08,fp7d
2021-09-20,FR,24,22,0,22,2022-05-03_11-02-08,fp7d
2021-09-20,GE,38,56,18,38,2022-05-03_11-02-08,fp7d
2021-09-20,GL,6,6,0,6,2022-05-03_11-02-08,fp7d
2021-09-20,GR,16,16,0,16,2022-05-03_11-02-08,fp7d
2021-09-20,JU,6,6,0,6,2022-05-03_11-02-08,fp7d
2021-09-20,LU,54,47,2,45,2022-05-03_11-02-08,fp7d
2021-09-20,NE,10,10,0,10,2022-05-03_11-02-08,fp7d
2021-09-20,NW,6,5,0,5,2022-05-03_11-02-08,fp7d
2021-09-20,OW,0,0,0,0,2022-05-03_11-02-08,fp7d
2021-09-20,SG,54,48,1,47,2022-05-03_11-02-08,fp7d
2021-09-20,SH,8,6,0,6,2022-05-03_11-02-08,fp7d
2021-09-20,SO,17,19,2,17,2022-05-03_11-02-08,fp7d
2021-09-20,SZ,12,11,0,11,2022-05-03_11-02-08,fp7d
2021-09-20,TG,21,30,9,21,2022-05-03_11-02-08,fp7d
2021-09-20,TI,53,57,4,53,2022-05-03_11-02-08,fp7d
2021-09-20,UR,6,6,0,6,2022-05-03_11-02-08,fp7d
2021-09-20,VD,85,86,1,85,2022-05-03_11-02-08,fp7d
2021-09-20,VS,21,21,0,21,2022-05-03_11-02-08,fp7d
2021-09-20,ZG,8,8,0,8,2022-05-03_11-02-08,fp7d
2021-09-20,ZH,190,179,7,172,2022-05-03_11-02-08,fp7d
2021-09-21,AG,52,49,1,48,2022-05-03_11-02-08,fp7d
2021-09-21,AI,0,0,0,0,2022-05-03_11-02-08,fp7d
2021-09-21,AR,6,6,0,6,2022-05-03_11-02-08,fp7d
2021-09-21,BE,103,89,2,87,2022-05-03_11-02-08,fp7d
2021-09-21,BL,20,15,0,15,2022-05-03_11-02-08,fp7d
2021-09-21,BS,54,50,0,50,2022-05-03_11-02-08,fp7d
2021-09-21,FR,24,22,0,22,2022-05-03_11-02-08,fp7d
2021-09-21,GE,38,56,18,38,2022-05-03_11-02-08,fp7d
2021-09-21,GL,6,6,0,6,2022-05-03_11-02-08,fp7d
2021-09-21,GR,16,16,0,16,2022-05-03_11-02-08,fp7d
2021-09-21,JU,6,6,0,6,2022-05-03_11-02-08,fp7d
2021-09-21,LU,54,47,2,45,2022-05-03_11-02-08,fp7d
2021-09-21,NE,10,10,0,10,2022-05-03_11-02-08,fp7d
2021-09-21,NW,6,5,0,5,2022-05-03_11-02-08,fp7d
2021-09-21,OW,0,0,0,0,2022-05-03_11-02-08,fp7d
2021-09-21,SG,54,48,1,47,2022-05-03_11-02-08,fp7d
2021-09-21,SH,8,6,0,6,2022-05-03_11-02-08,fp7d
2021-09-21,SO,17,19,2,17,2022-05-03_11-02-08,fp7d
2021-09-21,SZ,12,11,0,11,2022-05-03_11-02-08,fp7d
2021-09-21,TG,21,28,7,21,2022-05-03_11-02-08,fp7d
2021-09-21,TI,53,57,4,53,2022-05-03_11-02-08,fp7d
2021-09-21,UR,6,6,0,6,2022-05-03_11-02-08,fp7d
2021-09-21,VD,85,85,1,84,2022-05-03_11-02-08,fp7d
2021-09-21,VS,21,21,0,21,2022-05-03_11-02-08,fp7d
2021-09-21,ZG,8,8,0,8,2022-05-03_11-02-08,fp7d
2021-09-21,ZH,190,182,7,175,2022-05-03_11-02-08,fp7d
2021-09-22,AG,52,49,1,48,2022-05-03_11-02-08,fp7d
2021-09-22,AI,0,0,0,0,2022-05-03_11-02-08,fp7d
2021-09-22,AR,6,6,0,6,2022-05-03_11-02-08,fp7d
2021-09-22,BE,103,88,2,86,2022-05-03_11-02-08,fp7d
2021-09-22,BL,20,15,0,15,2022-05-03_11-02-08,fp7d
2021-09-22,BS,54,50,0,50,2022-05-03_11-02-08,fp7d
2021-09-22,FR,24,22,0,22,2022-05-03_11-02-08,fp7d
2021-09-22,GE,38,56,18,38,2022-05-03_11-02-08,fp7d
2021-09-22,GL,6,6,0,6,2022-05-03_11-02-08,fp7d
2021-09-22,GR,16,16,0,16,2022-05-03_11-02-08,fp7d
2021-09-22,JU,6,6,0,6,2022-05-03_11-02-08,fp7d
2021-09-22,LU,54,45,2,43,2022-05-03_11-02-08,fp7d
2021-09-22,NE,10,10,0,10,2022-05-03_11-02-08,fp7d
2021-09-22,NW,6,5,0,5,2022-05-03_11-02-08,fp7d
2021-09-22,OW,0,0,0,0,2022-05-03_11-02-08,fp7d
2021-09-22,SG,54,48,1,47,2022-05-03_11-02-08,fp7d
2021-09-22,SH,8,7,0,7,2022-05-03_11-02-08,fp7d
2021-09-22,SO,17,20,3,17,2022-05-03_11-02-08,fp7d
2021-09-22,SZ,12,11,0,11,2022-05-03_11-02-08,fp7d
2021-09-22,TG,21,28,7,21,2022-05-03_11-02-08,fp7d
2021-09-22,TI,53,57,4,53,2022-05-03_11-02-08,fp7d
2021-09-22,UR,6,6,0,6,2022-05-03_11-02-08,fp7d
2021-09-22,VD,85,85,1,84,2022-05-03_11-02-08,fp7d
2021-09-22,VS,21,21,0,21,2022-05-03_11-02-08,fp7d
2021-09-22,ZG,8,5,0,5,2022-05-03_11-02-08,fp7d
2021-09-22,ZH,190,181,7,174,2022-05-03_11-02-08,fp7d
2021-09-23,AG,52,49,1,48,2022-05-03_11-02-08,fp7d
2021-09-23,AI,0,0,0,0,2022-05-03_11-02-08,fp7d
2021-09-23,AR,6,6,0,6,2022-05-03_11-02-08,fp7d
2021-09-23,BE,103,88,2,86,2022-05-03_11-02-08,fp7d
2021-09-23,BL,20,15,0,15,2022-05-03_11-02-08,fp7d
2021-09-23,BS,54,50,0,50,2022-05-03_11-02-08,fp7d
2021-09-23,FR,24,22,0,22,2022-05-03_11-02-08,fp7d
2021-09-23,GE,38,56,18,38,2022-05-03_11-02-08,fp7d
2021-09-23,GL,6,6,0,6,2022-05-03_11-02-08,fp7d
2021-09-23,GR,16,16,0,16,2022-05-03_11-02-08,fp7d
2021-09-23,JU,6,6,0,6,2022-05-03_11-02-08,fp7d
2021-09-23,LU,54,46,2,44,2022-05-03_11-02-08,fp7d
2021-09-23,NE,10,10,0,10,2022-05-03_11-02-08,fp7d
2021-09-23,NW,6,5,0,5,2022-05-03_11-02-08,fp7d
2021-09-23,OW,0,0,0,0,2022-05-03_11-02-08,fp7d
2021-09-23,SG,54,48,1,47,2022-05-03_11-02-08,fp7d
2021-09-23,SH,8,7,0,7,2022-05-03_11-02-08,fp7d
2021-09-23,SO,17,19,2,17,2022-05-03_11-02-08,fp7d
2021-09-23,SZ,12,11,0,11,2022-05-03_11-02-08,fp7d
2021-09-23,TG,21,26,6,20,2022-05-03_11-02-08,fp7d
2021-09-23,TI,53,57,4,53,2022-05-03_11-02-08,fp7d
2021-09-23,UR,6,6,0,6,2022-05-03_11-02-08,fp7d
2021-09-23,VD,85,85,1,84,2022-05-03_11-02-08,fp7d
2021-09-23,VS,21,21,0,21,2022-05-03_11-02-08,fp7d
2021-09-23,ZG,8,6,0,6,2022-05-03_11-02-08,fp7d
2021-09-23,ZH,190,180,6,174,2022-05-03_11-02-08,fp7d
2021-09-24,AG,52,49,1,48,2022-05-03_11-02-08,fp7d
2021-09-24,AI,0,0,0,0,2022-05-03_11-02-08,fp7d
2021-09-24,AR,6,6,0,6,2022-05-03_11-02-08,fp7d
2021-09-24,BE,103,88,2,86,2022-05-03_11-02-08,fp7d
2021-09-24,BL,20,15,0,15,2022-05-03_11-02-08,fp7d
2021-09-24,BS,54,50,0,50,2022-05-03_11-02-08,fp7d
2021-09-24,FR,24,22,0,22,2022-05-03_11-02-08,fp7d
2021-09-24,GE,38,56,18,38,2022-05-03_11-02-08,fp7d
2021-09-24,GL,6,6,0,6,2022-05-03_11-02-08,fp7d
2021-09-24,GR,16,16,0,16,2022-05-03_11-02-08,fp7d
2021-09-24,JU,6,6,0,6,2022-05-03_11-02-08,fp7d
2021-09-24,LU,54,45,2,43,2022-05-03_11-02-08,fp7d
2021-09-24,NE,10,10,0,10,2022-05-03_11-02-08,fp7d
2021-09-24,NW,6,5,0,5,2022-05-03_11-02-08,fp7d
2021-09-24,OW,0,0,0,0,2022-05-03_11-02-08,fp7d
2021-09-24,SG,54,48,1,47,2022-05-03_11-02-08,fp7d
2021-09-24,SH,8,7,0,7,2022-05-03_11-02-08,fp7d
2021-09-24,SO,17,19,2,17,2022-05-03_11-02-08,fp7d
2021-09-24,SZ,12,11,0,11,2022-05-03_11-02-08,fp7d
2021-09-24,TG,21,28,7,21,2022-05-03_11-02-08,fp7d
2021-09-24,TI,53,57,4,53,2022-05-03_11-02-08,fp7d
2021-09-24,UR,6,6,0,6,2022-05-03_11-02-08,fp7d
2021-09-24,VD,85,85,1,84,2022-05-03_11-02-08,fp7d
2021-09-24,VS,21,21,0,21,2022-05-03_11-02-08,fp7d
2021-09-24,ZG,8,6,0,6,2022-05-03_11-02-08,fp7d
2021-09-24,ZH,190,180,7,173,2022-05-03_11-02-08,fp7d
2021-09-25,AG,52,49,1,48,2022-05-03_11-02-08,fp7d
2021-09-25,AI,0,0,0,0,2022-05-03_11-02-08,fp7d
2021-09-25,AR,6,6,0,6,2022-05-03_11-02-08,fp7d
2021-09-25,BE,103,87,2,85,2022-05-03_11-02-08,fp7d
2021-09-25,BL,20,15,0,15,2022-05-03_11-02-08,fp7d
2021-09-25,BS,54,46,0,46,2022-05-03_11-02-08,fp7d
2021-09-25,FR,24,22,0,22,2022-05-03_11-02-08,fp7d
2021-09-25,GE,38,56,18,38,2022-05-03_11-02-08,fp7d
2021-09-25,GL,6,6,0,6,2022-05-03_11-02-08,fp7d
2021-09-25,GR,16,16,0,16,2022-05-03_11-02-08,fp7d
2021-09-25,JU,6,6,0,6,2022-05-03_11-02-08,fp7d
2021-09-25,LU,54,47,2,45,2022-05-03_11-02-08,fp7d
2021-09-25,NE,10,10,0,10,2022-05-03_11-02-08,fp7d
2021-09-25,NW,6,5,0,5,2022-05-03_11-02-08,fp7d
2021-09-25,OW,0,0,0,0,2022-05-03_11-02-08,fp7d
2021-09-25,SG,54,44,1,43,2022-05-03_11-02-08,fp7d
2021-09-25,SH,8,7,0,7,2022-05-03_11-02-08,fp7d
2021-09-25,SO,17,19,2,17,2022-05-03_11-02-08,fp7d
2021-09-25,SZ,12,10,0,10,2022-05-03_11-02-08,fp7d
2021-09-25,TG,21,28,7,21,2022-05-03_11-02-08,fp7d
2021-09-25,TI,53,57,4,53,2022-05-03_11-02-08,fp7d
2021-09-25,UR,6,6,0,6,2022-05-03_11-02-08,fp7d
2021-09-25,VD,85,85,1,84,2022-05-03_11-02-08,fp7d
2021-09-25,VS,21,21,0,21,2022-05-03_11-02-08,fp7d
2021-09-25,ZG,8,6,0,6,2022-05-03_11-02-08,fp7d
2021-09-25,ZH,190,177,7,170,2022-05-03_11-02-08,fp7d
2021-09-26,AG,52,49,1,48,2022-05-03_11-02-08,fp7d
2021-09-26,AI,0,0,0,0,2022-05-03_11-02-08,fp7d
2021-09-26,AR,6,6,0,6,2022-05-03_11-02-08,fp7d
2021-09-26,BE,103,86,2,84,2022-05-03_11-02-08,fp7d
2021-09-26,BL,20,16,0,16,2022-05-03_11-02-08,fp7d
2021-09-26,BS,54,46,0,46,2022-05-03_11-02-08,fp7d
2021-09-26,FR,24,22,0,22,2022-05-03_11-02-08,fp7d
2021-09-26,GE,38,56,18,38,2022-05-03_11-02-08,fp7d
2021-09-26,GL,6,6,0,6,2022-05-03_11-02-08,fp7d
2021-09-26,GR,16,16,0,16,2022-05-03_11-02-08,fp7d
2021-09-26,JU,6,6,0,6,2022-05-03_11-02-08,fp7d
2021-09-26,LU,54,48,2,46,2022-05-03_11-02-08,fp7d
2021-09-26,NE,10,10,0,10,2022-05-03_11-02-08,fp7d
2021-09-26,NW,6,5,0,5,2022-05-03_11-02-08,fp7d
2021-09-26,OW,0,0,0,0,2022-05-03_11-02-08,fp7d
2021-09-26,SG,54,44,1,43,2022-05-03_11-02-08,fp7d
2021-09-26,SH,8,7,0,7,2022-05-03_11-02-08,fp7d
2021-09-26,SO,17,16,0,16,2022-05-03_11-02-08,fp7d
2021-09-26,SZ,12,10,0,10,2022-05-03_11-02-08,fp7d
2021-09-26,TG,21,28,7,21,2022-05-03_11-02-08,fp7d
2021-09-26,TI,53,57,4,53,2022-05-03_11-02-08,fp7d
2021-09-26,UR,6,6,0,6,2022-05-03_11-02-08,fp7d
2021-09-26,VD,85,85,1,84,2022-05-03_11-02-08,fp7d
2021-09-26,VS,21,21,0,21,2022-05-03_11-02-08,fp7d
2021-09-26,ZG,8,6,0,6,2022-05-03_11-02-08,fp7d
2021-09-26,ZH,190,179,7,172,2022-05-03_11-02-08,fp7d
2021-09-27,AG,52,49,1,48,2022-05-03_11-02-08,fp7d
2021-09-27,AI,0,0,0,0,2022-05-03_11-02-08,fp7d
2021-09-27,AR,6,6,0,6,2022-05-03_11-02-08,fp7d
2021-09-27,BE,103,89,2,87,2022-05-03_11-02-08,fp7d
2021-09-27,BL,20,16,0,16,2022-05-03_11-02-08,fp7d
2021-09-27,BS,54,50,0,50,2022-05-03_11-02-08,fp7d
2021-09-27,FR,24,22,0,22,2022-05-03_11-02-08,fp7d
2021-09-27,GE,38,56,18,38,2022-05-03_11-02-08,fp7d
2021-09-27,GL,6,6,0,6,2022-05-03_11-02-08,fp7d
2021-09-27,GR,16,16,0,16,2022-05-03_11-02-08,fp7d
2021-09-27,JU,6,6,0,6,2022-05-03_11-02-08,fp7d
2021-09-27,LU,54,48,2,46,2022-05-03_11-02-08,fp7d
2021-09-27,NE,10,10,0,10,2022-05-03_11-02-08,fp7d
2021-09-27,NW,6,5,0,5,2022-05-03_11-02-08,fp7d
2021-09-27,OW,0,0,0,0,2022-05-03_11-02-08,fp7d
2021-09-27,SG,54,44,1,43,2022-05-03_11-02-08,fp7d
2021-09-27,SH,8,7,0,7,2022-05-03_11-02-08,fp7d
2021-09-27,SO,17,17,0,17,2022-05-03_11-02-08,fp7d
2021-09-27,SZ,12,11,0,11,2022-05-03_11-02-08,fp7d
2021-09-27,TG,21,28,7,21,2022-05-03_11-02-08,fp7d
2021-09-27,TI,53,57,4,53,2022-05-03_11-02-08,fp7d
2021-09-27,UR,6,6,0,6,2022-05-03_11-02-08,fp7d
2021-09-27,VD,85,85,1,84,2022-05-03_11-02-08,fp7d
2021-09-27,VS,21,21,0,21,2022-05-03_11-02-08,fp7d
2021-09-27,ZG,8,6,0,6,2022-05-03_11-02-08,fp7d
2021-09-27,ZH,190,181,7,174,2022-05-03_11-02-08,fp7d
2021-09-28,AG,52,49,1,48,2022-05-03_11-02-08,fp7d
2021-09-28,AI,0,0,0,0,2022-05-03_11-02-08,fp7d
2021-09-28,AR,6,6,0,6,2022-05-03_11-02-08,fp7d
2021-09-28,BE,104,90,2,88,2022-05-03_11-02-08,fp7d
2021-09-28,BL,20,16,0,16,2022-05-03_11-02-08,fp7d
2021-09-28,BS,54,50,0,50,2022-05-03_11-02-08,fp7d
2021-09-28,FR,24,22,0,22,2022-05-03_11-02-08,fp7d
2021-09-28,GE,38,56,18,38,2022-05-03_11-02-08,fp7d
2021-09-28,GL,6,6,0,6,2022-05-03_11-02-08,fp7d
2021-09-28,GR,16,16,0,16,2022-05-03_11-02-08,fp7d
2021-09-28,JU,6,6,0,6,2022-05-03_11-02-08,fp7d
2021-09-28,LU,54,49,2,47,2022-05-03_11-02-08,fp7d
2021-09-28,NE,10,10,0,10,2022-05-03_11-02-08,fp7d
2021-09-28,NW,6,5,0,5,2022-05-03_11-02-08,fp7d
2021-09-28,OW,0,0,0,0,2022-05-03_11-02-08,fp7d
2021-09-28,SG,54,44,1,43,2022-05-03_11-02-08,fp7d
2021-09-28,SH,8,7,0,7,2022-05-03_11-02-08,fp7d
2021-09-28,SO,17,18,1,17,2022-05-03_11-02-08,fp7d
2021-09-28,SZ,12,11,0,11,2022-05-03_11-02-08,fp7d
2021-09-28,TG,21,28,7,21,2022-05-03_11-02-08,fp7d
2021-09-28,TI,53,57,4,53,2022-05-03_11-02-08,fp7d
2021-09-28,UR,6,6,0,6,2022-05-03_11-02-08,fp7d
2021-09-28,VD,85,85,1,84,2022-05-03_11-02-08,fp7d
2021-09-28,VS,21,21,0,21,2022-05-03_11-02-08,fp7d
2021-09-28,ZG,8,6,0,6,2022-05-03_11-02-08,fp7d
2021-09-28,ZH,190,180,7,173,2022-05-03_11-02-08,fp7d
2021-09-29,AG,52,49,1,48,2022-05-03_11-02-08,fp7d
2021-09-29,AI,0,0,0,0,2022-05-03_11-02-08,fp7d
2021-09-29,AR,6,6,0,6,2022-05-03_11-02-08,fp7d
2021-09-29,BE,104,90,2,88,2022-05-03_11-02-08,fp7d
2021-09-29,BL,20,16,0,16,2022-05-03_11-02-08,fp7d
2021-09-29,BS,54,50,0,50,2022-05-03_11-02-08,fp7d
2021-09-29,FR,24,22,0,22,2022-05-03_11-02-08,fp7d
2021-09-29,GE,38,56,18,38,2022-05-03_11-02-08,fp7d
2021-09-29,GL,6,6,0,6,2022-05-03_11-02-08,fp7d
2021-09-29,GR,16,16,0,16,2022-05-03_11-02-08,fp7d
2021-09-29,JU,6,6,0,6,2022-05-03_11-02-08,fp7d
2021-09-29,LU,54,49,2,47,2022-05-03_11-02-08,fp7d
2021-09-29,NE,10,10,0,10,2022-05-03_11-02-08,fp7d
2021-09-29,NW,6,5,0,5,2022-05-03_11-02-08,fp7d
2021-09-29,OW,0,0,0,0,2022-05-03_11-02-08,fp7d
2021-09-29,SG,54,44,1,43,2022-05-03_11-02-08,fp7d
2021-09-29,SH,8,7,0,7,2022-05-03_11-02-08,fp7d
2021-09-29,SO,17,17,0,17,2022-05-03_11-02-08,fp7d
2021-09-29,SZ,12,11,0,11,2022-05-03_11-02-08,fp7d
2021-09-29,TG,21,28,7,21,2022-05-03_11-02-08,fp7d
2021-09-29,TI,53,57,4,53,2022-05-03_11-02-08,fp7d
2021-09-29,UR,6,6,0,6,2022-05-03_11-02-08,fp7d
2021-09-29,VD,85,86,1,85,2022-05-03_11-02-08,fp7d
2021-09-29,VS,21,21,0,21,2022-05-03_11-02-08,fp7d
2021-09-29,ZG,8,7,0,7,2022-05-03_11-02-08,fp7d
2021-09-29,ZH,190,181,7,174,2022-05-03_11-02-08,fp7d
2021-09-30,AG,52,49,1,48,2022-05-03_11-02-08,fp7d
2021-09-30,AI,0,0,0,0,2022-05-03_11-02-08,fp7d
2021-09-30,AR,6,6,0,6,2022-05-03_11-02-08,fp7d
2021-09-30,BE,104,91,2,89,2022-05-03_11-02-08,fp7d
2021-09-30,BL,20,16,0,16,2022-05-03_11-02-08,fp7d
2021-09-30,BS,54,50,0,50,2022-05-03_11-02-08,fp7d
2021-09-30,FR,24,22,0,22,2022-05-03_11-02-08,fp7d
2021-09-30,GE,38,56,18,38,2022-05-03_11-02-08,fp7d
2021-09-30,GL,6,6,0,6,2022-05-03_11-02-08,fp7d
2021-09-30,GR,16,16,0,16,2022-05-03_11-02-08,fp7d
2021-09-30,JU,6,6,0,6,2022-05-03_11-02-08,fp7d
2021-09-30,LU,54,49,2,47,2022-05-03_11-02-08,fp7d
2021-09-30,NE,10,10,0,10,2022-05-03_11-02-08,fp7d
2021-09-30,NW,6,5,0,5,2022-05-03_11-02-08,fp7d
2021-09-30,OW,0,0,0,0,2022-05-03_11-02-08,fp7d
2021-09-30,SG,54,44,1,43,2022-05-03_11-02-08,fp7d
2021-09-30,SH,8,7,0,7,2022-05-03_11-02-08,fp7d
2021-09-30,SO,17,17,0,17,2022-05-03_11-02-08,fp7d
2021-09-30,SZ,12,11,0,11,2022-05-03_11-02-08,fp7d
2021-09-30,TG,21,28,7,21,2022-05-03_11-02-08,fp7d
2021-09-30,TI,53,57,4,53,2022-05-03_11-02-08,fp7d
2021-09-30,UR,6,6,0,6,2022-05-03_11-02-08,fp7d
2021-09-30,VD,85,86,1,85,2022-05-03_11-02-08,fp7d
2021-09-30,VS,21,21,0,21,2022-05-03_11-02-08,fp7d
2021-09-30,ZG,8,7,0,7,2022-05-03_11-02-08,fp7d
2021-09-30,ZH,190,179,6,173,2022-05-03_11-02-08,fp7d
2021-10-01,AG,52,48,1,47,2022-05-03_11-02-08,fp7d
2021-10-01,AI,0,0,0,0,2022-05-03_11-02-08,fp7d
2021-10-01,AR,6,6,0,6,2022-05-03_11-02-08,fp7d
2021-10-01,BE,104,91,2,89,2022-05-03_11-02-08,fp7d
2021-10-01,BL,20,15,0,15,2022-05-03_11-02-08,fp7d
2021-10-01,BS,54,50,0,50,2022-05-03_11-02-08,fp7d
2021-10-01,FR,24,22,0,22,2022-05-03_11-02-08,fp7d
2021-10-01,GE,38,56,18,38,2022-05-03_11-02-08,fp7d
2021-10-01,GL,6,6,0,6,2022-05-03_11-02-08,fp7d
2021-10-01,GR,16,16,0,16,2022-05-03_11-02-08,fp7d
2021-10-01,JU,6,6,0,6,2022-05-03_11-02-08,fp7d
2021-10-01,LU,54,49,2,47,2022-05-03_11-02-08,fp7d
2021-10-01,NE,10,10,0,10,2022-05-03_11-02-08,fp7d
2021-10-01,NW,6,5,0,5,2022-05-03_11-02-08,fp7d
2021-10-01,OW,0,0,0,0,2022-05-03_11-02-08,fp7d
2021-10-01,SG,54,44,1,43,2022-05-03_11-02-08,fp7d
2021-10-01,SH,8,7,0,7,2022-05-03_11-02-08,fp7d
2021-10-01,SO,17,18,1,17,2022-05-03_11-02-08,fp7d
2021-10-01,SZ,12,11,0,11,2022-05-03_11-02-08,fp7d
2021-10-01,TG,21,28,7,21,2022-05-03_11-02-08,fp7d
2021-10-01,TI,53,57,4,53,2022-05-03_11-02-08,fp7d
2021-10-01,UR,6,6,0,6,2022-05-03_11-02-08,fp7d
2021-10-01,VD,85,86,1,85,2022-05-03_11-02-08,fp7d
2021-10-01,VS,21,21,0,21,2022-05-03_11-02-08,fp7d
2021-10-01,ZG,8,7,0,7,2022-05-03_11-02-08,fp7d
2021-10-01,ZH,190,182,7,175,2022-05-03_11-02-08,fp7d
2021-10-02,AG,52,48,1,47,2022-05-03_11-02-08,fp7d
2021-10-02,AI,0,0,0,0,2022-05-03_11-02-08,fp7d
2021-10-02,AR,6,6,0,6,2022-05-03_11-02-08,fp7d
2021-10-02,BE,104,88,2,86,2022-05-03_11-02-08,fp7d
2021-10-02,BL,20,15,0,15,2022-05-03_11-02-08,fp7d
2021-10-02,BS,54,46,0,46,2022-05-03_11-02-08,fp7d
2021-10-02,FR,24,22,0,22,2022-05-03_11-02-08,fp7d
2021-10-02,GE,38,56,18,38,2022-05-03_11-02-08,fp7d
2021-10-02,GL,6,6,0,6,2022-05-03_11-02-08,fp7d
2021-10-02,GR,16,16,0,16,2022-05-03_11-02-08,fp7d
2021-10-02,JU,6,6,0,6,2022-05-03_11-02-08,fp7d
2021-10-02,LU,54,47,0,47,2022-05-03_11-02-08,fp7d
2021-10-02,NE,10,10,0,10,2022-05-03_11-02-08,fp7d
2021-10-02,NW,6,5,0,5,2022-05-03_11-02-08,fp7d
2021-10-02,OW,0,0,0,0,2022-05-03_11-02-08,fp7d
2021-10-02,SG,54,40,1,39,2022-05-03_11-02-08,fp7d
2021-10-02,SH,8,7,0,7,2022-05-03_11-02-08,fp7d
2021-10-02,SO,17,17,0,17,2022-05-03_11-02-08,fp7d
2021-10-02,SZ,12,11,0,11,2022-05-03_11-02-08,fp7d
2021-10-02,TG,21,28,7,21,2022-05-03_11-02-08,fp7d
2021-10-02,TI,53,57,4,53,2022-05-03_11-02-08,fp7d
2021-10-02,UR,6,6,0,6,2022-05-03_11-02-08,fp7d
2021-10-02,VD,85,86,1,85,2022-05-03_11-02-08,fp7d
2021-10-02,VS,21,21,0,21,2022-05-03_11-02-08,fp7d
2021-10-02,ZG,8,7,0,7,2022-05-03_11-02-08,fp7d
2021-10-02,ZH,190,177,6,171,2022-05-03_11-02-08,fp7d
2021-10-03,AG,52,47,1,46,2022-05-03_11-02-08,fp7d
2021-10-03,AI,0,0,0,0,2022-05-03_11-02-08,fp7d
2021-10-03,AR,6,6,0,6,2022-05-03_11-02-08,fp7d
2021-10-03,BE,104,86,2,84,2022-05-03_11-02-08,fp7d
2021-10-03,BL,20,15,0,15,2022-05-03_11-02-08,fp7d
2021-10-03,BS,54,46,0,46,2022-05-03_11-02-08,fp7d
2021-10-03,FR,24,22,0,22,2022-05-03_11-02-08,fp7d
2021-10-03,GE,38,56,18,38,2022-05-03_11-02-08,fp7d
2021-10-03,GL,6,6,0,6,2022-05-03_11-02-08,fp7d
2021-10-03,GR,16,16,0,16,2022-05-03_11-02-08,fp7d
2021-10-03,JU,6,6,0,6,2022-05-03_11-02-08,fp7d
2021-10-03,LU,54,47,0,47,2022-05-03_11-02-08,fp7d
2021-10-03,NE,10,10,0,10,2022-05-03_11-02-08,fp7d
2021-10-03,NW,6,5,0,5,2022-05-03_11-02-08,fp7d
2021-10-03,OW,0,0,0,0,2022-05-03_11-02-08,fp7d
2021-10-03,SG,54,40,1,39,2022-05-03_11-02-08,fp7d
2021-10-03,SH,8,7,0,7,2022-05-03_11-02-08,fp7d
2021-10-03,SO,17,17,0,17,2022-05-03_11-02-08,fp7d
2021-10-03,SZ,12,11,0,11,2022-05-03_11-02-08,fp7d
2021-10-03,TG,21,28,7,21,2022-05-03_11-02-08,fp7d
2021-10-03,TI,53,57,4,53,2022-05-03_11-02-08,fp7d
2021-10-03,UR,6,6,0,6,2022-05-03_11-02-08,fp7d
2021-10-03,VD,85,86,1,85,2022-05-03_11-02-08,fp7d
2021-10-03,VS,21,21,0,21,2022-05-03_11-02-08,fp7d
2021-10-03,ZG,8,7,0,7,2022-05-03_11-02-08,fp7d
2021-10-03,ZH,190,177,6,171,2022-05-03_11-02-08,fp7d
2021-10-04,AG,52,47,1,46,2022-05-03_11-02-08,fp7d
2021-10-04,AI,0,0,0,0,2022-05-03_11-02-08,fp7d
2021-10-04,AR,6,6,0,6,2022-05-03_11-02-08,fp7d
2021-10-04,BE,104,89,2,87,2022-05-03_11-02-08,fp7d
2021-10-04,BL,20,15,0,15,2022-05-03_11-02-08,fp7d
2021-10-04,BS,54,50,0,50,2022-05-03_11-02-08,fp7d
2021-10-04,FR,24,22,0,22,2022-05-03_11-02-08,fp7d
2021-10-04,GE,38,56,18,38,2022-05-03_11-02-08,fp7d
2021-10-04,GL,6,6,0,6,2022-05-03_11-02-08,fp7d
2021-10-04,GR,16,16,0,16,2022-05-03_11-02-08,fp7d
2021-10-04,JU,6,6,0,6,2022-05-03_11-02-08,fp7d
2021-10-04,LU,54,48,2,46,2022-05-03_11-02-08,fp7d
2021-10-04,NE,10,10,0,10,2022-05-03_11-02-08,fp7d
2021-10-04,NW,6,5,0,5,2022-05-03_11-02-08,fp7d
2021-10-04,OW,0,0,0,0,2022-05-03_11-02-08,fp7d
2021-10-04,SG,54,40,1,39,2022-05-03_11-02-08,fp7d
2021-10-04,SH,8,7,0,7,2022-05-03_11-02-08,fp7d
2021-10-04,SO,17,18,1,17,2022-05-03_11-02-08,fp7d
2021-10-04,SZ,12,11,0,11,2022-05-03_11-02-08,fp7d
2021-10-04,TG,21,28,7,21,2022-05-03_11-02-08,fp7d
2021-10-04,TI,53,57,4,53,2022-05-03_11-02-08,fp7d
2021-10-04,UR,6,6,0,6,2022-05-03_11-02-08,fp7d
2021-10-04,VD,85,86,1,85,2022-05-03_11-02-08,fp7d
2021-10-04,VS,21,21,0,21,2022-05-03_11-02-08,fp7d
2021-10-04,ZG,8,7,0,7,2022-05-03_11-02-08,fp7d
2021-10-04,ZH,190,178,7,171,2022-05-03_11-02-08,fp7d
2021-10-05,AG,52,47,1,46,2022-05-03_11-02-08,fp7d
2021-10-05,AI,0,0,0,0,2022-05-03_11-02-08,fp7d
2021-10-05,AR,6,6,0,6,2022-05-03_11-02-08,fp7d
2021-10-05,BE,104,89,2,87,2022-05-03_11-02-08,fp7d
2021-10-05,BL,20,15,0,15,2022-05-03_11-02-08,fp7d
2021-10-05,BS,54,50,0,50,2022-05-03_11-02-08,fp7d
2021-10-05,FR,24,22,0,22,2022-05-03_11-02-08,fp7d
2021-10-05,GE,38,56,18,38,2022-05-03_11-02-08,fp7d
2021-10-05,GL,6,6,0,6,2022-05-03_11-02-08,fp7d
2021-10-05,GR,16,16,0,16,2022-05-03_11-02-08,fp7d
2021-10-05,JU,6,6,0,6,2022-05-03_11-02-08,fp7d
2021-10-05,LU,54,49,2,47,2022-05-03_11-02-08,fp7d
2021-10-05,NE,10,10,0,10,2022-05-03_11-02-08,fp7d
2021-10-05,NW,6,4,0,4,2022-05-03_11-02-08,fp7d
2021-10-05,OW,0,0,0,0,2022-05-03_11-02-08,fp7d
2021-10-05,SG,54,40,1,39,2022-05-03_11-02-08,fp7d
2021-10-05,SH,8,7,0,7,2022-05-03_11-02-08,fp7d
2021-10-05,SO,17,19,2,17,2022-05-03_11-02-08,fp7d
2021-10-05,SZ,12,12,0,12,2022-05-03_11-02-08,fp7d
2021-10-05,TG,21,28,7,21,2022-05-03_11-02-08,fp7d
2021-10-05,TI,53,57,4,53,2022-05-03_11-02-08,fp7d
2021-10-05,UR,6,6,0,6,2022-05-03_11-02-08,fp7d
2021-10-05,VD,85,86,1,85,2022-05-03_11-02-08,fp7d
2021-10-05,VS,21,21,0,21,2022-05-03_11-02-08,fp7d
2021-10-05,ZG,8,8,0,8,2022-05-03_11-02-08,fp7d
2021-10-05,ZH,190,179,7,172,2022-05-03_11-02-08,fp7d
2021-10-06,AG,52,46,1,45,2022-05-03_11-02-08,fp7d
2021-10-06,AI,0,0,0,0,2022-05-03_11-02-08,fp7d
2021-10-06,AR,6,6,0,6,2022-05-03_11-02-08,fp7d
2021-10-06,BE,104,87,2,85,2022-05-03_11-02-08,fp7d
2021-10-06,BL,20,15,0,15,2022-05-03_11-02-08,fp7d
2021-10-06,BS,54,50,0,50,2022-05-03_11-02-08,fp7d
2021-10-06,FR,24,22,0,22,2022-05-03_11-02-08,fp7d
2021-10-06,GE,38,56,18,38,2022-05-03_11-02-08,fp7d
2021-10-06,GL,6,6,0,6,2022-05-03_11-02-08,fp7d
2021-10-06,GR,16,16,0,16,2022-05-03_11-02-08,fp7d
2021-10-06,JU,6,6,0,6,2022-05-03_11-02-08,fp7d
2021-10-06,LU,54,49,2,47,2022-05-03_11-02-08,fp7d
2021-10-06,NE,10,10,0,10,2022-05-03_11-02-08,fp7d
2021-10-06,NW,6,4,0,4,2022-05-03_11-02-08,fp7d
2021-10-06,OW,0,0,0,0,2022-05-03_11-02-08,fp7d
2021-10-06,SG,54,40,1,39,2022-05-03_11-02-08,fp7d
2021-10-06,SH,8,7,0,7,2022-05-03_11-02-08,fp7d
2021-10-06,SO,17,17,0,17,2022-05-03_11-02-08,fp7d
2021-10-06,SZ,12,12,0,12,2022-05-03_11-02-08,fp7d
2021-10-06,TG,21,28,7,21,2022-05-03_11-02-08,fp7d
2021-10-06,TI,53,57,4,53,2022-05-03_11-02-08,fp7d
2021-10-06,UR,6,6,0,6,2022-05-03_11-02-08,fp7d
2021-10-06,VD,85,85,1,84,2022-05-03_11-02-08,fp7d
2021-10-06,VS,21,21,0,21,2022-05-03_11-02-08,fp7d
2021-10-06,ZG,8,8,0,8,2022-05-03_11-02-08,fp7d
2021-10-06,ZH,190,179,7,172,2022-05-03_11-02-08,fp7d
2021-10-07,AG,52,47,1,46,2022-05-03_11-02-08,fp7d
2021-10-07,AI,0,0,0,0,2022-05-03_11-02-08,fp7d
2021-10-07,AR,6,6,0,6,2022-05-03_11-02-08,fp7d
2021-10-07,BE,104,86,2,84,2022-05-03_11-02-08,fp7d
2021-10-07,BL,20,15,0,15,2022-05-03_11-02-08,fp7d
2021-10-07,BS,54,50,0,50,2022-05-03_11-02-08,fp7d
2021-10-07,FR,24,22,0,22,2022-05-03_11-02-08,fp7d
2021-10-07,GE,38,56,18,38,2022-05-03_11-02-08,fp7d
2021-10-07,GL,6,6,0,6,2022-05-03_11-02-08,fp7d
2021-10-07,GR,16,16,0,16,2022-05-03_11-02-08,fp7d
2021-10-07,JU,6,6,0,6,2022-05-03_11-02-08,fp7d
2021-10-07,LU,54,49,2,47,2022-05-03_11-02-08,fp7d
2021-10-07,NE,10,10,0,10,2022-05-03_11-02-08,fp7d
2021-10-07,NW,6,4,0,4,2022-05-03_11-02-08,fp7d
2021-10-07,OW,0,0,0,0,2022-05-03_11-02-08,fp7d
2021-10-07,SG,54,40,1,39,2022-05-03_11-02-08,fp7d
2021-10-07,SH,8,7,0,7,2022-05-03_11-02-08,fp7d
2021-10-07,SO,17,17,0,17,2022-05-03_11-02-08,fp7d
2021-10-07,SZ,12,12,0,12,2022-05-03_11-02-08,fp7d
2021-10-07,TG,21,28,7,21,2022-05-03_11-02-08,fp7d
2021-10-07,TI,53,57,4,53,2022-05-03_11-02-08,fp7d
2021-10-07,UR,6,6,0,6,2022-05-03_11-02-08,fp7d
2021-10-07,VD,85,86,1,85,2022-05-03_11-02-08,fp7d
2021-10-07,VS,21,21,0,21,2022-05-03_11-02-08,fp7d
2021-10-07,ZG,8,8,0,8,2022-05-03_11-02-08,fp7d
2021-10-07,ZH,190,181,7,174,2022-05-03_11-02-08,fp7d
2021-10-08,AG,52,45,1,44,2022-05-03_11-02-08,fp7d
2021-10-08,AI,0,0,0,0,2022-05-03_11-02-08,fp7d
2021-10-08,AR,6,6,0,6,2022-05-03_11-02-08,fp7d
2021-10-08,BE,104,87,2,85,2022-05-03_11-02-08,fp7d
2021-10-08,BL,20,15,0,15,2022-05-03_11-02-08,fp7d
2021-10-08,BS,54,50,0,50,2022-05-03_11-02-08,fp7d
2021-10-08,FR,24,22,0,22,2022-05-03_11-02-08,fp7d
2021-10-08,GE,38,56,18,38,2022-05-03_11-02-08,fp7d
2021-10-08,GL,6,6,0,6,2022-05-03_11-02-08,fp7d
2021-10-08,GR,16,16,0,16,2022-05-03_11-02-08,fp7d
2021-10-08,JU,6,6,0,6,2022-05-03_11-02-08,fp7d
2021-10-08,LU,54,49,2,47,2022-05-03_11-02-08,fp7d
2021-10-08,NE,10,10,0,10,2022-05-03_11-02-08,fp7d
2021-10-08,NW,6,4,0,4,2022-05-03_11-02-08,fp7d
2021-10-08,OW,0,0,0,0,2022-05-03_11-02-08,fp7d
2021-10-08,SG,54,40,1,39,2022-05-03_11-02-08,fp7d
2021-10-08,SH,8,7,0,7,2022-05-03_11-02-08,fp7d
2021-10-08,SO,17,17,0,17,2022-05-03_11-02-08,fp7d
2021-10-08,SZ,12,12,0,12,2022-05-03_11-02-08,fp7d
2021-10-08,TG,21,28,7,21,2022-05-03_11-02-08,fp7d
2021-10-08,TI,53,57,4,53,2022-05-03_11-02-08,fp7d
2021-10-08,UR,6,6,0,6,2022-05-03_11-02-08,fp7d
2021-10-08,VD,85,86,1,85,2022-05-03_11-02-08,fp7d
2021-10-08,VS,21,21,0,21,2022-05-03_11-02-08,fp7d
2021-10-08,ZG,8,8,0,8,2022-05-03_11-02-08,fp7d
2021-10-08,ZH,190,178,7,171,2022-05-03_11-02-08,fp7d
2021-10-09,AG,52,45,1,44,2022-05-03_11-02-08,fp7d
2021-10-09,AI,0,0,0,0,2022-05-03_11-02-08,fp7d
2021-10-09,AR,6,6,0,6,2022-05-03_11-02-08,fp7d
2021-10-09,BE,104,87,2,85,2022-05-03_11-02-08,fp7d
2021-10-09,BL,20,15,0,15,2022-05-03_11-02-08,fp7d
2021-10-09,BS,54,46,0,46,2022-05-03_11-02-08,fp7d
2021-10-09,FR,24,22,0,22,2022-05-03_11-02-08,fp7d
2021-10-09,GE,38,56,18,38,2022-05-03_11-02-08,fp7d
2021-10-09,GL,6,6,0,6,2022-05-03_11-02-08,fp7d
2021-10-09,GR,16,16,0,16,2022-05-03_11-02-08,fp7d
2021-10-09,JU,6,6,0,6,2022-05-03_11-02-08,fp7d
2021-10-09,LU,54,47,0,47,2022-05-03_11-02-08,fp7d
2021-10-09,NE,10,10,0,10,2022-05-03_11-02-08,fp7d
2021-10-09,NW,6,4,0,4,2022-05-03_11-02-08,fp7d
2021-10-09,OW,0,0,0,0,2022-05-03_11-02-08,fp7d
2021-10-09,SG,54,40,1,39,2022-05-03_11-02-08,fp7d
2021-10-09,SH,8,7,0,7,2022-05-03_11-02-08,fp7d
2021-10-09,SO,17,17,0,17,2022-05-03_11-02-08,fp7d
2021-10-09,SZ,12,12,0,12,2022-05-03_11-02-08,fp7d
2021-10-09,TG,21,28,7,21,2022-05-03_11-02-08,fp7d
2021-10-09,TI,53,57,4,53,2022-05-03_11-02-08,fp7d
2021-10-09,UR,6,6,0,6,2022-05-03_11-02-08,fp7d
2021-10-09,VD,85,86,1,85,2022-05-03_11-02-08,fp7d
2021-10-09,VS,21,21,0,21,2022-05-03_11-02-08,fp7d
2021-10-09,ZG,8,8,0,8,2022-05-03_11-02-08,fp7d
2021-10-09,ZH,190,178,7,171,2022-05-03_11-02-08,fp7d
2021-10-10,AG,52,45,1,44,2022-05-03_11-02-08,fp7d
2021-10-10,AI,0,0,0,0,2022-05-03_11-02-08,fp7d
2021-10-10,AR,6,6,0,6,2022-05-03_11-02-08,fp7d
2021-10-10,BE,104,87,2,85,2022-05-03_11-02-08,fp7d
2021-10-10,BL,20,15,0,15,2022-05-03_11-02-08,fp7d
2021-10-10,BS,54,46,0,46,2022-05-03_11-02-08,fp7d
2021-10-10,FR,24,22,0,22,2022-05-03_11-02-08,fp7d
2021-10-10,GE,38,56,18,38,2022-05-03_11-02-08,fp7d
2021-10-10,GL,6,6,0,6,2022-05-03_11-02-08,fp7d
2021-10-10,GR,16,16,0,16,2022-05-03_11-02-08,fp7d
2021-10-10,JU,6,6,0,6,2022-05-03_11-02-08,fp7d
2021-10-10,LU,54,47,0,47,2022-05-03_11-02-08,fp7d
2021-10-10,NE,10,10,0,10,2022-05-03_11-02-08,fp7d
2021-10-10,NW,6,4,0,4,2022-05-03_11-02-08,fp7d
2021-10-10,OW,0,0,0,0,2022-05-03_11-02-08,fp7d
2021-10-10,SG,54,40,1,39,2022-05-03_11-02-08,fp7d
2021-10-10,SH,8,7,0,7,2022-05-03_11-02-08,fp7d
2021-10-10,SO,17,17,0,17,2022-05-03_11-02-08,fp7d
2021-10-10,SZ,12,12,0,12,2022-05-03_11-02-08,fp7d
2021-10-10,TG,21,28,7,21,2022-05-03_11-02-08,fp7d
2021-10-10,TI,53,57,4,53,2022-05-03_11-02-08,fp7d
2021-10-10,UR,6,6,0,6,2022-05-03_11-02-08,fp7d
2021-10-10,VD,85,86,1,85,2022-05-03_11-02-08,fp7d
2021-10-10,VS,21,21,0,21,2022-05-03_11-02-08,fp7d
2021-10-10,ZG,8,8,0,8,2022-05-03_11-02-08,fp7d
2021-10-10,ZH,190,176,7,169,2022-05-03_11-02-08,fp7d
2021-10-11,AG,52,47,1,46,2022-05-03_11-02-08,fp7d
2021-10-11,AI,0,0,0,0,2022-05-03_11-02-08,fp7d
2021-10-11,AR,6,6,0,6,2022-05-03_11-02-08,fp7d
2021-10-11,BE,104,87,2,85,2022-05-03_11-02-08,fp7d
2021-10-11,BL,20,15,0,15,2022-05-03_11-02-08,fp7d
2021-10-11,BS,54,50,0,50,2022-05-03_11-02-08,fp7d
2021-10-11,FR,24,22,0,22,2022-05-03_11-02-08,fp7d
2021-10-11,GE,38,56,18,38,2022-05-03_11-02-08,fp7d
2021-10-11,GL,6,6,0,6,2022-05-03_11-02-08,fp7d
2021-10-11,GR,16,16,0,16,2022-05-03_11-02-08,fp7d
2021-10-11,JU,6,6,0,6,2022-05-03_11-02-08,fp7d
2021-10-11,LU,54,47,0,47,2022-05-03_11-02-08,fp7d
2021-10-11,NE,10,10,0,10,2022-05-03_11-02-08,fp7d
2021-10-11,NW,6,4,0,4,2022-05-03_11-02-08,fp7d
2021-10-11,OW,0,0,0,0,2022-05-03_11-02-08,fp7d
2021-10-11,SG,54,40,1,39,2022-05-03_11-02-08,fp7d
2021-10-11,SH,8,8,0,8,2022-05-03_11-02-08,fp7d
2021-10-11,SO,17,17,0,17,2022-05-03_11-02-08,fp7d
2021-10-11,SZ,12,12,0,12,2022-05-03_11-02-08,fp7d
2021-10-11,TG,21,28,7,21,2022-05-03_11-02-08,fp7d
2021-10-11,TI,53,57,4,53,2022-05-03_11-02-08,fp7d
2021-10-11,UR,6,6,0,6,2022-05-03_11-02-08,fp7d
2021-10-11,VD,85,86,1,85,2022-05-03_11-02-08,fp7d
2021-10-11,VS,21,21,0,21,2022-05-03_11-02-08,fp7d
2021-10-11,ZG,8,8,0,8,2022-05-03_11-02-08,fp7d
2021-10-11,ZH,190,181,7,174,2022-05-03_11-02-08,fp7d
2021-10-12,AG,52,47,1,46,2022-05-03_11-02-08,fp7d
2021-10-12,AI,0,0,0,0,2022-05-03_11-02-08,fp7d
2021-10-12,AR,6,6,0,6,2022-05-03_11-02-08,fp7d
2021-10-12,BE,104,87,2,85,2022-05-03_11-02-08,fp7d
2021-10-12,BL,20,15,0,15,2022-05-03_11-02-08,fp7d
2021-10-12,BS,54,50,0,50,2022-05-03_11-02-08,fp7d
2021-10-12,FR,24,22,0,22,2022-05-03_11-02-08,fp7d
2021-10-12,GE,38,56,18,38,2022-05-03_11-02-08,fp7d
2021-10-12,GL,6,4,0,4,2022-05-03_11-02-08,fp7d
2021-10-12,GR,16,16,0,16,2022-05-03_11-02-08,fp7d
2021-10-12,JU,6,6,0,6,2022-05-03_11-02-08,fp7d
2021-10-12,LU,54,48,2,46,2022-05-03_11-02-08,fp7d
2021-10-12,NE,10,10,0,10,2022-05-03_11-02-08,fp7d
2021-10-12,NW,6,4,0,4,2022-05-03_11-02-08,fp7d
2021-10-12,OW,0,0,0,0,2022-05-03_11-02-08,fp7d
2021-10-12,SG,54,40,1,39,2022-05-03_11-02-08,fp7d
2021-10-12,SH,8,8,0,8,2022-05-03_11-02-08,fp7d
2021-10-12,SO,17,17,0,17,2022-05-03_11-02-08,fp7d
2021-10-12,SZ,12,12,0,12,2022-05-03_11-02-08,fp7d
2021-10-12,TG,21,28,7,21,2022-05-03_11-02-08,fp7d
2021-10-12,TI,53,57,4,53,2022-05-03_11-02-08,fp7d
2021-10-12,UR,6,6,0,6,2022-05-03_11-02-08,fp7d
2021-10-12,VD,85,86,1,85,2022-05-03_11-02-08,fp7d
2021-10-12,VS,21,21,0,21,2022-05-03_11-02-08,fp7d
2021-10-12,ZG,8,8,0,8,2022-05-03_11-02-08,fp7d
2021-10-12,ZH,190,179,7,172,2022-05-03_11-02-08,fp7d
2021-10-13,AG,52,45,1,44,2022-05-03_11-02-08,fp7d
2021-10-13,AI,0,0,0,0,2022-05-03_11-02-08,fp7d
2021-10-13,AR,6,6,0,6,2022-05-03_11-02-08,fp7d
2021-10-13,BE,104,87,2,85,2022-05-03_11-02-08,fp7d
2021-10-13,BL,20,15,0,15,2022-05-03_11-02-08,fp7d
2021-10-13,BS,54,50,0,50,2022-05-03_11-02-08,fp7d
2021-10-13,FR,24,22,0,22,2022-05-03_11-02-08,fp7d
2021-10-13,GE,38,56,18,38,2022-05-03_11-02-08,fp7d
2021-10-13,GL,6,6,0,6,2022-05-03_11-02-08,fp7d
2021-10-13,GR,16,16,0,16,2022-05-03_11-02-08,fp7d
2021-10-13,JU,6,6,0,6,2022-05-03_11-02-08,fp7d
2021-10-13,LU,54,48,2,46,2022-05-03_11-02-08,fp7d
2021-10-13,NE,10,10,0,10,2022-05-03_11-02-08,fp7d
2021-10-13,NW,6,4,0,4,2022-05-03_11-02-08,fp7d
2021-10-13,OW,0,0,0,0,2022-05-03_11-02-08,fp7d
2021-10-13,SG,54,40,1,39,2022-05-03_11-02-08,fp7d
2021-10-13,SH,8,8,0,8,2022-05-03_11-02-08,fp7d
2021-10-13,SO,17,18,1,17,2022-05-03_11-02-08,fp7d
2021-10-13,SZ,12,12,0,12,2022-05-03_11-02-08,fp7d
2021-10-13,TG,21,28,7,21,2022-05-03_11-02-08,fp7d
2021-10-13,TI,53,57,4,53,2022-05-03_11-02-08,fp7d
2021-10-13,UR,6,6,0,6,2022-05-03_11-02-08,fp7d
2021-10-13,VD,85,86,1,85,2022-05-03_11-02-08,fp7d
2021-10-13,VS,21,21,0,21,2022-05-03_11-02-08,fp7d
2021-10-13,ZG,8,8,0,8,2022-05-03_11-02-08,fp7d
2021-10-13,ZH,190,177,7,170,2022-05-03_11-02-08,fp7d
2021-10-14,AG,52,47,1,46,2022-05-03_11-02-08,fp7d
2021-10-14,AI,0,0,0,0,2022-05-03_11-02-08,fp7d
2021-10-14,AR,6,6,0,6,2022-05-03_11-02-08,fp7d
2021-10-14,BE,104,87,2,85,2022-05-03_11-02-08,fp7d
2021-10-14,BL,20,15,0,15,2022-05-03_11-02-08,fp7d
2021-10-14,BS,54,50,0,50,2022-05-03_11-02-08,fp7d
2021-10-14,FR,24,22,0,22,2022-05-03_11-02-08,fp7d
2021-10-14,GE,38,56,18,38,2022-05-03_11-02-08,fp7d
2021-10-14,GL,6,6,0,6,2022-05-03_11-02-08,fp7d
2021-10-14,GR,16,16,0,16,2022-05-03_11-02-08,fp7d
2021-10-14,JU,6,6,0,6,2022-05-03_11-02-08,fp7d
2021-10-14,LU,54,47,0,47,2022-05-03_11-02-08,fp7d
2021-10-14,NE,10,10,0,10,2022-05-03_11-02-08,fp7d
2021-10-14,NW,6,4,0,4,2022-05-03_11-02-08,fp7d
2021-10-14,OW,0,0,0,0,2022-05-03_11-02-08,fp7d
2021-10-14,SG,54,40,1,39,2022-05-03_11-02-08,fp7d
2021-10-14,SH,8,8,0,8,2022-05-03_11-02-08,fp7d
2021-10-14,SO,17,17,0,17,2022-05-03_11-02-08,fp7d
2021-10-14,SZ,12,12,0,12,2022-05-03_11-02-08,fp7d
2021-10-14,TG,21,28,7,21,2022-05-03_11-02-08,fp7d
2021-10-14,TI,53,57,4,53,2022-05-03_11-02-08,fp7d
2021-10-14,UR,6,6,0,6,2022-05-03_11-02-08,fp7d
2021-10-14,VD,85,86,1,85,2022-05-03_11-02-08,fp7d
2021-10-14,VS,15,15,0,15,2022-05-03_11-02-08,fp7d
2021-10-14,ZG,8,8,0,8,2022-05-03_11-02-08,fp7d
2021-10-14,ZH,190,173,6,167,2022-05-03_11-02-08,fp7d
2021-10-15,AG,52,46,0,46,2022-05-03_11-02-08,fp7d
2021-10-15,AI,0,0,0,0,2022-05-03_11-02-08,fp7d
2021-10-15,AR,6,6,0,6,2022-05-03_11-02-08,fp7d
2021-10-15,BE,104,86,2,84,2022-05-03_11-02-08,fp7d
2021-10-15,BL,20,15,0,15,2022-05-03_11-02-08,fp7d
2021-10-15,BS,54,50,0,50,2022-05-03_11-02-08,fp7d
2021-10-15,FR,24,22,0,22,2022-05-03_11-02-08,fp7d
2021-10-15,GE,38,56,18,38,2022-05-03_11-02-08,fp7d
2021-10-15,GL,6,6,0,6,2022-05-03_11-02-08,fp7d
2021-10-15,GR,16,16,0,16,2022-05-03_11-02-08,fp7d
2021-10-15,JU,6,6,0,6,2022-05-03_11-02-08,fp7d
2021-10-15,LU,54,48,1,47,2022-05-03_11-02-08,fp7d
2021-10-15,NE,10,10,0,10,2022-05-03_11-02-08,fp7d
2021-10-15,NW,6,5,0,5,2022-05-03_11-02-08,fp7d
2021-10-15,OW,0,0,0,0,2022-05-03_11-02-08,fp7d
2021-10-15,SG,54,40,1,39,2022-05-03_11-02-08,fp7d
2021-10-15,SH,8,8,0,8,2022-05-03_11-02-08,fp7d
2021-10-15,SO,17,18,1,17,2022-05-03_11-02-08,fp7d
2021-10-15,SZ,12,12,0,12,2022-05-03_11-02-08,fp7d
2021-10-15,TG,21,28,7,21,2022-05-03_11-02-08,fp7d
2021-10-15,TI,53,57,4,53,2022-05-03_11-02-08,fp7d
2021-10-15,UR,6,6,0,6,2022-05-03_11-02-08,fp7d
2021-10-15,VD,85,86,1,85,2022-05-03_11-02-08,fp7d
2021-10-15,VS,21,21,0,21,2022-05-03_11-02-08,fp7d
2021-10-15,ZG,8,8,0,8,2022-05-03_11-02-08,fp7d
2021-10-15,ZH,190,176,7,169,2022-05-03_11-02-08,fp7d
2021-10-16,AG,52,46,0,46,2022-05-03_11-02-08,fp7d
2021-10-16,AI,0,0,0,0,2022-05-03_11-02-08,fp7d
2021-10-16,AR,6,6,0,6,2022-05-03_11-02-08,fp7d
2021-10-16,BE,104,87,2,85,2022-05-03_11-02-08,fp7d
2021-10-16,BL,20,15,0,15,2022-05-03_11-02-08,fp7d
2021-10-16,BS,54,50,0,50,2022-05-03_11-02-08,fp7d
2021-10-16,FR,24,22,0,22,2022-05-03_11-02-08,fp7d
2021-10-16,GE,38,56,18,38,2022-05-03_11-02-08,fp7d
2021-10-16,GL,6,6,0,6,2022-05-03_11-02-08,fp7d
2021-10-16,GR,16,16,0,16,2022-05-03_11-02-08,fp7d
2021-10-16,JU,6,6,0,6,2022-05-03_11-02-08,fp7d
2021-10-16,LU,54,49,2,47,2022-05-03_11-02-08,fp7d
2021-10-16,NE,10,10,0,10,2022-05-03_11-02-08,fp7d
2021-10-16,NW,6,5,0,5,2022-05-03_11-02-08,fp7d
2021-10-16,OW,0,0,0,0,2022-05-03_11-02-08,fp7d
2021-10-16,SG,54,40,1,39,2022-05-03_11-02-08,fp7d
2021-10-16,SH,8,8,0,8,2022-05-03_11-02-08,fp7d
2021-10-16,SO,17,18,1,17,2022-05-03_11-02-08,fp7d
2021-10-16,SZ,12,11,0,11,2022-05-03_11-02-08,fp7d
2021-10-16,TG,21,28,7,21,2022-05-03_11-02-08,fp7d
2021-10-16,TI,53,57,4,53,2022-05-03_11-02-08,fp7d
2021-10-16,UR,6,6,0,6,2022-05-03_11-02-08,fp7d
2021-10-16,VD,85,86,1,85,2022-05-03_11-02-08,fp7d
2021-10-16,VS,21,21,0,21,2022-05-03_11-02-08,fp7d
2021-10-16,ZG,8,8,0,8,2022-05-03_11-02-08,fp7d
2021-10-16,ZH,190,174,7,167,2022-05-03_11-02-08,fp7d
2021-10-17,AG,52,46,0,46,2022-05-03_11-02-08,fp7d
2021-10-17,AI,0,0,0,0,2022-05-03_11-02-08,fp7d
2021-10-17,AR,6,6,0,6,2022-05-03_11-02-08,fp7d
2021-10-17,BE,104,87,2,85,2022-05-03_11-02-08,fp7d
2021-10-17,BL,20,15,0,15,2022-05-03_11-02-08,fp7d
2021-10-17,BS,54,46,0,46,2022-05-03_11-02-08,fp7d
2021-10-17,FR,24,22,0,22,2022-05-03_11-02-08,fp7d
2021-10-17,GE,38,56,18,38,2022-05-03_11-02-08,fp7d
2021-10-17,GL,6,6,0,6,2022-05-03_11-02-08,fp7d
2021-10-17,GR,16,16,0,16,2022-05-03_11-02-08,fp7d
2021-10-17,JU,6,6,0,6,2022-05-03_11-02-08,fp7d
2021-10-17,LU,54,47,0,47,2022-05-03_11-02-08,fp7d
2021-10-17,NE,10,10,0,10,2022-05-03_11-02-08,fp7d
2021-10-17,NW,6,5,0,5,2022-05-03_11-02-08,fp7d
2021-10-17,OW,0,0,0,0,2022-05-03_11-02-08,fp7d
2021-10-17,SG,54,40,1,39,2022-05-03_11-02-08,fp7d
2021-10-17,SH,8,8,0,8,2022-05-03_11-02-08,fp7d
2021-10-17,SO,17,18,1,17,2022-05-03_11-02-08,fp7d
2021-10-17,SZ,12,11,0,11,2022-05-03_11-02-08,fp7d
2021-10-17,TG,21,28,7,21,2022-05-03_11-02-08,fp7d
2021-10-17,TI,53,57,4,53,2022-05-03_11-02-08,fp7d
2021-10-17,UR,6,6,0,6,2022-05-03_11-02-08,fp7d
2021-10-17,VD,85,86,1,85,2022-05-03_11-02-08,fp7d
2021-10-17,VS,21,21,0,21,2022-05-03_11-02-08,fp7d
2021-10-17,ZG,8,8,0,8,2022-05-03_11-02-08,fp7d
2021-10-17,ZH,190,174,7,167,2022-05-03_11-02-08,fp7d
2021-10-18,AG,52,47,1,46,2022-05-03_11-02-08,fp7d
2021-10-18,AI,0,0,0,0,2022-05-03_11-02-08,fp7d
2021-10-18,AR,6,6,0,6,2022-05-03_11-02-08,fp7d
2021-10-18,BE,104,89,2,87,2022-05-03_11-02-08,fp7d
2021-10-18,BL,20,15,0,15,2022-05-03_11-02-08,fp7d
2021-10-18,BS,54,50,0,50,2022-05-03_11-02-08,fp7d
2021-10-18,FR,24,22,0,22,2022-05-03_11-02-08,fp7d
2021-10-18,GE,38,56,18,38,2022-05-03_11-02-08,fp7d
2021-10-18,GL,6,6,0,6,2022-05-03_11-02-08,fp7d
2021-10-18,GR,16,16,0,16,2022-05-03_11-02-08,fp7d
2021-10-18,JU,6,6,0,6,2022-05-03_11-02-08,fp7d
2021-10-18,LU,54,49,2,47,2022-05-03_11-02-08,fp7d
2021-10-18,NE,10,10,0,10,2022-05-03_11-02-08,fp7d
2021-10-18,NW,6,5,0,5,2022-05-03_11-02-08,fp7d
2021-10-18,OW,0,0,0,0,2022-05-03_11-02-08,fp7d
2021-10-18,SG,54,40,1,39,2022-05-03_11-02-08,fp7d
2021-10-18,SH,8,8,0,8,2022-05-03_11-02-08,fp7d
2021-10-18,SO,17,18,1,17,2022-05-03_11-02-08,fp7d
2021-10-18,SZ,12,11,0,11,2022-05-03_11-02-08,fp7d
2021-10-18,TG,21,28,7,21,2022-05-03_11-02-08,fp7d
2021-10-18,TI,53,57,4,53,2022-05-03_11-02-08,fp7d
2021-10-18,UR,6,6,0,6,2022-05-03_11-02-08,fp7d
2021-10-18,VD,85,86,1,85,2022-05-03_11-02-08,fp7d
2021-10-18,VS,21,21,0,21,2022-05-03_11-02-08,fp7d
2021-10-18,ZG,8,8,0,8,2022-05-03_11-02-08,fp7d
2021-10-18,ZH,190,178,7,171,2022-05-03_11-02-08,fp7d
2021-10-19,AG,52,47,1,46,2022-05-03_11-02-08,fp7d
2021-10-19,AI,0,0,0,0,2022-05-03_11-02-08,fp7d
2021-10-19,AR,6,6,0,6,2022-05-03_11-02-08,fp7d
2021-10-19,BE,104,89,2,87,2022-05-03_11-02-08,fp7d
2021-10-19,BL,20,15,0,15,2022-05-03_11-02-08,fp7d
2021-10-19,BS,54,50,0,50,2022-05-03_11-02-08,fp7d
2021-10-19,FR,24,22,0,22,2022-05-03_11-02-08,fp7d
2021-10-19,GE,38,56,18,38,2022-05-03_11-02-08,fp7d
2021-10-19,GL,6,6,0,6,2022-05-03_11-02-08,fp7d
2021-10-19,GR,16,16,0,16,2022-05-03_11-02-08,fp7d
2021-10-19,JU,6,6,0,6,2022-05-03_11-02-08,fp7d
2021-10-19,LU,54,49,2,47,2022-05-03_11-02-08,fp7d
2021-10-19,NE,10,10,0,10,2022-05-03_11-02-08,fp7d
2021-10-19,NW,6,5,0,5,2022-05-03_11-02-08,fp7d
2021-10-19,OW,0,0,0,0,2022-05-03_11-02-08,fp7d
2021-10-19,SG,54,40,1,39,2022-05-03_11-02-08,fp7d
2021-10-19,SH,8,8,0,8,2022-05-03_11-02-08,fp7d
2021-10-19,SO,17,19,2,17,2022-05-03_11-02-08,fp7d
2021-10-19,SZ,12,11,0,11,2022-05-03_11-02-08,fp7d
2021-10-19,TG,21,28,7,21,2022-05-03_11-02-08,fp7d
2021-10-19,TI,53,57,4,53,2022-05-03_11-02-08,fp7d
2021-10-19,UR,6,6,0,6,2022-05-03_11-02-08,fp7d
2021-10-19,VD,85,86,1,85,2022-05-03_11-02-08,fp7d
2021-10-19,VS,21,21,0,21,2022-05-03_11-02-08,fp7d
2021-10-19,ZG,8,8,0,8,2022-05-03_11-02-08,fp7d
2021-10-19,ZH,190,177,7,170,2022-05-03_11-02-08,fp7d
2021-10-20,AG,52,47,1,46,2022-05-03_11-02-08,fp7d
2021-10-20,AI,0,0,0,0,2022-05-03_11-02-08,fp7d
2021-10-20,AR,6,6,0,6,2022-05-03_11-02-08,fp7d
2021-10-20,BE,104,88,2,86,2022-05-03_11-02-08,fp7d
2021-10-20,BL,20,15,0,15,2022-05-03_11-02-08,fp7d
2021-10-20,BS,54,50,0,50,2022-05-03_11-02-08,fp7d
2021-10-20,FR,24,22,0,22,2022-05-03_11-02-08,fp7d
2021-10-20,GE,38,56,18,38,2022-05-03_11-02-08,fp7d
2021-10-20,GL,6,6,0,6,2022-05-03_11-02-08,fp7d
2021-10-20,GR,16,16,0,16,2022-05-03_11-02-08,fp7d
2021-10-20,JU,6,6,0,6,2022-05-03_11-02-08,fp7d
2021-10-20,LU,54,49,2,47,2022-05-03_11-02-08,fp7d
2021-10-20,NE,10,10,0,10,2022-05-03_11-02-08,fp7d
2021-10-20,NW,6,5,0,5,2022-05-03_11-02-08,fp7d
2021-10-20,OW,0,0,0,0,2022-05-03_11-02-08,fp7d
2021-10-20,SG,54,40,1,39,2022-05-03_11-02-08,fp7d
2021-10-20,SH,8,8,0,8,2022-05-03_11-02-08,fp7d
2021-10-20,SO,17,19,2,17,2022-05-03_11-02-08,fp7d
2021-10-20,SZ,12,11,0,11,2022-05-03_11-02-08,fp7d
2021-10-20,TG,21,28,7,21,2022-05-03_11-02-08,fp7d
2021-10-20,TI,53,57,4,53,2022-05-03_11-02-08,fp7d
2021-10-20,UR,6,6,0,6,2022-05-03_11-02-08,fp7d
2021-10-20,VD,85,86,1,85,2022-05-03_11-02-08,fp7d
2021-10-20,VS,21,21,0,21,2022-05-03_11-02-08,fp7d
2021-10-20,ZG,8,8,0,8,2022-05-03_11-02-08,fp7d
2021-10-20,ZH,190,177,7,170,2022-05-03_11-02-08,fp7d
2021-10-21,AG,52,47,1,46,2022-05-03_11-02-08,fp7d
2021-10-21,AI,0,0,0,0,2022-05-03_11-02-08,fp7d
2021-10-21,AR,6,6,0,6,2022-05-03_11-02-08,fp7d
2021-10-21,BE,104,89,2,87,2022-05-03_11-02-08,fp7d
2021-10-21,BL,20,15,0,15,2022-05-03_11-02-08,fp7d
2021-10-21,BS,54,50,0,50,2022-05-03_11-02-08,fp7d
2021-10-21,FR,24,22,0,22,2022-05-03_11-02-08,fp7d
2021-10-21,GE,38,56,18,38,2022-05-03_11-02-08,fp7d
2021-10-21,GL,6,6,0,6,2022-05-03_11-02-08,fp7d
2021-10-21,GR,16,16,0,16,2022-05-03_11-02-08,fp7d
2021-10-21,JU,6,6,0,6,2022-05-03_11-02-08,fp7d
2021-10-21,LU,54,49,2,47,2022-05-03_11-02-08,fp7d
2021-10-21,NE,10,10,0,10,2022-05-03_11-02-08,fp7d
2021-10-21,NW,6,5,0,5,2022-05-03_11-02-08,fp7d
2021-10-21,OW,0,0,0,0,2022-05-03_11-02-08,fp7d
2021-10-21,SG,54,40,1,39,2022-05-03_11-02-08,fp7d
2021-10-21,SH,8,8,0,8,2022-05-03_11-02-08,fp7d
2021-10-21,SO,17,19,2,17,2022-05-03_11-02-08,fp7d
2021-10-21,SZ,12,11,0,11,2022-05-03_11-02-08,fp7d
2021-10-21,TG,21,28,7,21,2022-05-03_11-02-08,fp7d
2021-10-21,TI,53,57,4,53,2022-05-03_11-02-08,fp7d
2021-10-21,UR,6,6,0,6,2022-05-03_11-02-08,fp7d
2021-10-21,VD,85,86,1,85,2022-05-03_11-02-08,fp7d
2021-10-21,VS,21,21,0,21,2022-05-03_11-02-08,fp7d
2021-10-21,ZG,8,8,0,8,2022-05-03_11-02-08,fp7d
2021-10-21,ZH,190,179,7,172,2022-05-03_11-02-08,fp7d
2021-10-22,AG,52,45,1,44,2022-05-03_11-02-08,fp7d
2021-10-22,AI,0,0,0,0,2022-05-03_11-02-08,fp7d
2021-10-22,AR,6,6,0,6,2022-05-03_11-02-08,fp7d
2021-10-22,BE,104,90,2,88,2022-05-03_11-02-08,fp7d
2021-10-22,BL,20,15,0,15,2022-05-03_11-02-08,fp7d
2021-10-22,BS,54,50,0,50,2022-05-03_11-02-08,fp7d
2021-10-22,FR,24,22,0,22,2022-05-03_11-02-08,fp7d
2021-10-22,GE,38,56,18,38,2022-05-03_11-02-08,fp7d
2021-10-22,GL,6,6,0,6,2022-05-03_11-02-08,fp7d
2021-10-22,GR,16,16,0,16,2022-05-03_11-02-08,fp7d
2021-10-22,JU,6,6,0,6,2022-05-03_11-02-08,fp7d
2021-10-22,LU,54,49,2,47,2022-05-03_11-02-08,fp7d
2021-10-22,NE,10,10,0,10,2022-05-03_11-02-08,fp7d
2021-10-22,NW,6,5,0,5,2022-05-03_11-02-08,fp7d
2021-10-22,OW,0,0,0,0,2022-05-03_11-02-08,fp7d
2021-10-22,SG,54,40,1,39,2022-05-03_11-02-08,fp7d
2021-10-22,SH,8,8,0,8,2022-05-03_11-02-08,fp7d
2021-10-22,SO,17,19,2,17,2022-05-03_11-02-08,fp7d
2021-10-22,SZ,12,11,0,11,2022-05-03_11-02-08,fp7d
2021-10-22,TG,21,28,7,21,2022-05-03_11-02-08,fp7d
2021-10-22,TI,53,57,4,53,2022-05-03_11-02-08,fp7d
2021-10-22,UR,6,6,0,6,2022-05-03_11-02-08,fp7d
2021-10-22,VD,85,86,1,85,2022-05-03_11-02-08,fp7d
2021-10-22,VS,21,21,0,21,2022-05-03_11-02-08,fp7d
2021-10-22,ZG,8,8,0,8,2022-05-03_11-02-08,fp7d
2021-10-22,ZH,190,178,8,170,2022-05-03_11-02-08,fp7d
2021-10-23,AG,52,45,1,44,2022-05-03_11-02-08,fp7d
2021-10-23,AI,0,0,0,0,2022-05-03_11-02-08,fp7d
2021-10-23,AR,6,6,0,6,2022-05-03_11-02-08,fp7d
2021-10-23,BE,104,90,2,88,2022-05-03_11-02-08,fp7d
2021-10-23,BL,20,15,0,15,2022-05-03_11-02-08,fp7d
2021-10-23,BS,54,46,0,46,2022-05-03_11-02-08,fp7d
2021-10-23,FR,24,22,0,22,2022-05-03_11-02-08,fp7d
2021-10-23,GE,38,56,18,38,2022-05-03_11-02-08,fp7d
2021-10-23,GL,6,6,0,6,2022-05-03_11-02-08,fp7d
2021-10-23,GR,16,16,0,16,2022-05-03_11-02-08,fp7d
2021-10-23,JU,6,6,0,6,2022-05-03_11-02-08,fp7d
2021-10-23,LU,54,47,2,45,2022-05-03_11-02-08,fp7d
2021-10-23,NE,10,10,0,10,2022-05-03_11-02-08,fp7d
2021-10-23,NW,6,5,0,5,2022-05-03_11-02-08,fp7d
2021-10-23,OW,0,0,0,0,2022-05-03_11-02-08,fp7d
2021-10-23,SG,54,40,1,39,2022-05-03_11-02-08,fp7d
2021-10-23,SH,8,8,0,8,2022-05-03_11-02-08,fp7d
2021-10-23,SO,17,17,0,17,2022-05-03_11-02-08,fp7d
2021-10-23,SZ,12,11,0,11,2022-05-03_11-02-08,fp7d
2021-10-23,TG,21,28,7,21,2022-05-03_11-02-08,fp7d
2021-10-23,TI,53,57,4,53,2022-05-03_11-02-08,fp7d
2021-10-23,UR,6,6,0,6,2022-05-03_11-02-08,fp7d
2021-10-23,VD,85,86,1,85,2022-05-03_11-02-08,fp7d
2021-10-23,VS,21,21,0,21,2022-05-03_11-02-08,fp7d
2021-10-23,ZG,8,8,0,8,2022-05-03_11-02-08,fp7d
2021-10-23,ZH,190,176,7,169,2022-05-03_11-02-08,fp7d
2021-10-24,AG,52,45,1,44,2022-05-03_11-02-08,fp7d
2021-10-24,AI,0,0,0,0,2022-05-03_11-02-08,fp7d
2021-10-24,AR,6,6,0,6,2022-05-03_11-02-08,fp7d
2021-10-24,BE,104,90,2,88,2022-05-03_11-02-08,fp7d
2021-10-24,BL,20,15,0,15,2022-05-03_11-02-08,fp7d
2021-10-24,BS,54,46,0,46,2022-05-03_11-02-08,fp7d
2021-10-24,FR,24,22,0,22,2022-05-03_11-02-08,fp7d
2021-10-24,GE,38,56,18,38,2022-05-03_11-02-08,fp7d
2021-10-24,GL,6,6,0,6,2022-05-03_11-02-08,fp7d
2021-10-24,GR,16,16,0,16,2022-05-03_11-02-08,fp7d
2021-10-24,JU,6,6,0,6,2022-05-03_11-02-08,fp7d
2021-10-24,LU,54,47,0,47,2022-05-03_11-02-08,fp7d
2021-10-24,NE,10,10,0,10,2022-05-03_11-02-08,fp7d
2021-10-24,NW,6,5,0,5,2022-05-03_11-02-08,fp7d
2021-10-24,OW,0,0,0,0,2022-05-03_11-02-08,fp7d
2021-10-24,SG,54,40,1,39,2022-05-03_11-02-08,fp7d
2021-10-24,SH,8,8,0,8,2022-05-03_11-02-08,fp7d
2021-10-24,SO,17,18,1,17,2022-05-03_11-02-08,fp7d
2021-10-24,SZ,12,11,0,11,2022-05-03_11-02-08,fp7d
2021-10-24,TG,21,28,7,21,2022-05-03_11-02-08,fp7d
2021-10-24,TI,53,57,4,53,2022-05-03_11-02-08,fp7d
2021-10-24,UR,6,6,0,6,2022-05-03_11-02-08,fp7d
2021-10-24,VD,85,86,1,85,2022-05-03_11-02-08,fp7d
2021-10-24,VS,21,21,0,21,2022-05-03_11-02-08,fp7d
2021-10-24,ZG,8,8,0,8,2022-05-03_11-02-08,fp7d
2021-10-24,ZH,190,178,8,170,2022-05-03_11-02-08,fp7d
2021-10-25,AG,52,46,1,45,2022-05-03_11-02-08,fp7d
2021-10-25,AI,0,0,0,0,2022-05-03_11-02-08,fp7d
2021-10-25,AR,6,6,0,6,2022-05-03_11-02-08,fp7d
2021-10-25,BE,104,90,2,88,2022-05-03_11-02-08,fp7d
2021-10-25,BL,20,15,0,15,2022-05-03_11-02-08,fp7d
2021-10-25,BS,54,50,0,50,2022-05-03_11-02-08,fp7d
2021-10-25,FR,24,22,0,22,2022-05-03_11-02-08,fp7d
2021-10-25,GE,38,56,18,38,2022-05-03_11-02-08,fp7d
2021-10-25,GL,6,6,0,6,2022-05-03_11-02-08,fp7d
2021-10-25,GR,16,16,0,16,2022-05-03_11-02-08,fp7d
2021-10-25,JU,6,6,0,6,2022-05-03_11-02-08,fp7d
2021-10-25,LU,54,49,2,47,2022-05-03_11-02-08,fp7d
2021-10-25,NE,10,10,0,10,2022-05-03_11-02-08,fp7d
2021-10-25,NW,6,5,0,5,2022-05-03_11-02-08,fp7d
2021-10-25,OW,0,0,0,0,2022-05-03_11-02-08,fp7d
2021-10-25,SG,54,40,1,39,2022-05-03_11-02-08,fp7d
2021-10-25,SH,8,8,0,8,2022-05-03_11-02-08,fp7d
2021-10-25,SO,17,19,2,17,2022-05-03_11-02-08,fp7d
2021-10-25,SZ,12,10,0,10,2022-05-03_11-02-08,fp7d
2021-10-25,TG,21,28,7,21,2022-05-03_11-02-08,fp7d
2021-10-25,TI,53,57,4,53,2022-05-03_11-02-08,fp7d
2021-10-25,UR,6,6,0,6,2022-05-03_11-02-08,fp7d
2021-10-25,VD,85,86,1,85,2022-05-03_11-02-08,fp7d
2021-10-25,VS,21,21,0,21,2022-05-03_11-02-08,fp7d
2021-10-25,ZG,8,8,0,8,2022-05-03_11-02-08,fp7d
2021-10-25,ZH,190,174,7,167,2022-05-03_11-02-08,fp7d
2021-10-26,AG,52,46,1,45,2022-05-03_11-02-08,fp7d
2021-10-26,AI,0,0,0,0,2022-05-03_11-02-08,fp7d
2021-10-26,AR,6,6,0,6,2022-05-03_11-02-08,fp7d
2021-10-26,BE,104,90,2,88,2022-05-03_11-02-08,fp7d
2021-10-26,BL,20,15,0,15,2022-05-03_11-02-08,fp7d
2021-10-26,BS,54,50,0,50,2022-05-03_11-02-08,fp7d
2021-10-26,FR,24,22,0,22,2022-05-03_11-02-08,fp7d
2021-10-26,GE,38,56,18,38,2022-05-03_11-02-08,fp7d
2021-10-26,GL,6,6,0,6,2022-05-03_11-02-08,fp7d
2021-10-26,GR,16,16,0,16,2022-05-03_11-02-08,fp7d
2021-10-26,JU,6,6,0,6,2022-05-03_11-02-08,fp7d
2021-10-26,LU,54,49,2,47,2022-05-03_11-02-08,fp7d
2021-10-26,NE,10,10,0,10,2022-05-03_11-02-08,fp7d
2021-10-26,NW,6,5,0,5,2022-05-03_11-02-08,fp7d
2021-10-26,OW,0,0,0,0,2022-05-03_11-02-08,fp7d
2021-10-26,SG,54,40,1,39,2022-05-03_11-02-08,fp7d
2021-10-26,SH,8,8,0,8,2022-05-03_11-02-08,fp7d
2021-10-26,SO,17,19,2,17,2022-05-03_11-02-08,fp7d
2021-10-26,SZ,12,10,0,10,2022-05-03_11-02-08,fp7d
2021-10-26,TG,21,28,7,21,2022-05-03_11-02-08,fp7d
2021-10-26,TI,53,57,4,53,2022-05-03_11-02-08,fp7d
2021-10-26,UR,6,6,0,6,2022-05-03_11-02-08,fp7d
2021-10-26,VD,85,86,1,85,2022-05-03_11-02-08,fp7d
2021-10-26,VS,21,21,0,21,2022-05-03_11-02-08,fp7d
2021-10-26,ZG,8,8,0,8,2022-05-03_11-02-08,fp7d
2021-10-26,ZH,190,174,7,167,2022-05-03_11-02-08,fp7d
2021-10-27,AG,52,46,1,45,2022-05-03_11-02-08,fp7d
2021-10-27,AI,0,0,0,0,2022-05-03_11-02-08,fp7d
2021-10-27,AR,6,6,0,6,2022-05-03_11-02-08,fp7d
2021-10-27,BE,104,90,2,88,2022-05-03_11-02-08,fp7d
2021-10-27,BL,20,15,0,15,2022-05-03_11-02-08,fp7d
2021-10-27,BS,54,50,0,50,2022-05-03_11-02-08,fp7d
2021-10-27,FR,24,22,0,22,2022-05-03_11-02-08,fp7d
2021-10-27,GE,38,56,18,38,2022-05-03_11-02-08,fp7d
2021-10-27,GL,6,6,0,6,2022-05-03_11-02-08,fp7d
2021-10-27,GR,16,16,0,16,2022-05-03_11-02-08,fp7d
2021-10-27,JU,6,6,0,6,2022-05-03_11-02-08,fp7d
2021-10-27,LU,54,49,2,47,2022-05-03_11-02-08,fp7d
2021-10-27,NE,10,10,0,10,2022-05-03_11-02-08,fp7d
2021-10-27,NW,6,5,0,5,2022-05-03_11-02-08,fp7d
2021-10-27,OW,0,0,0,0,2022-05-03_11-02-08,fp7d
2021-10-27,SG,54,40,1,39,2022-05-03_11-02-08,fp7d
2021-10-27,SH,8,8,0,8,2022-05-03_11-02-08,fp7d
2021-10-27,SO,17,19,2,17,2022-05-03_11-02-08,fp7d
2021-10-27,SZ,12,11,0,11,2022-05-03_11-02-08,fp7d
2021-10-27,TG,21,28,7,21,2022-05-03_11-02-08,fp7d
2021-10-27,TI,53,57,4,53,2022-05-03_11-02-08,fp7d
2021-10-27,UR,6,6,0,6,2022-05-03_11-02-08,fp7d
2021-10-27,VD,85,86,1,85,2022-05-03_11-02-08,fp7d
2021-10-27,VS,21,21,0,21,2022-05-03_11-02-08,fp7d
2021-10-27,ZG,8,8,0,8,2022-05-03_11-02-08,fp7d
2021-10-27,ZH,190,175,7,168,2022-05-03_11-02-08,fp7d
2021-10-28,AG,52,46,1,45,2022-05-03_11-02-08,fp7d
2021-10-28,AI,0,0,0,0,2022-05-03_11-02-08,fp7d
2021-10-28,AR,6,6,0,6,2022-05-03_11-02-08,fp7d
2021-10-28,BE,104,90,2,88,2022-05-03_11-02-08,fp7d
2021-10-28,BL,20,15,0,15,2022-05-03_11-02-08,fp7d
2021-10-28,BS,54,50,0,50,2022-05-03_11-02-08,fp7d
2021-10-28,FR,24,22,0,22,2022-05-03_11-02-08,fp7d
2021-10-28,GE,38,56,18,38,2022-05-03_11-02-08,fp7d
2021-10-28,GL,6,6,0,6,2022-05-03_11-02-08,fp7d
2021-10-28,GR,16,16,0,16,2022-05-03_11-02-08,fp7d
2021-10-28,JU,6,6,0,6,2022-05-03_11-02-08,fp7d
2021-10-28,LU,54,49,2,47,2022-05-03_11-02-08,fp7d
2021-10-28,NE,10,10,0,10,2022-05-03_11-02-08,fp7d
2021-10-28,NW,6,5,0,5,2022-05-03_11-02-08,fp7d
2021-10-28,OW,0,0,0,0,2022-05-03_11-02-08,fp7d
2021-10-28,SG,54,40,1,39,2022-05-03_11-02-08,fp7d
2021-10-28,SH,8,8,0,8,2022-05-03_11-02-08,fp7d
2021-10-28,SO,17,19,2,17,2022-05-03_11-02-08,fp7d
2021-10-28,SZ,12,11,0,11,2022-05-03_11-02-08,fp7d
2021-10-28,TG,21,28,7,21,2022-05-03_11-02-08,fp7d
2021-10-28,TI,53,57,4,53,2022-05-03_11-02-08,fp7d
2021-10-28,UR,6,6,0,6,2022-05-03_11-02-08,fp7d
2021-10-28,VD,85,86,1,85,2022-05-03_11-02-08,fp7d
2021-10-28,VS,21,21,0,21,2022-05-03_11-02-08,fp7d
2021-10-28,ZG,8,8,0,8,2022-05-03_11-02-08,fp7d
2021-10-28,ZH,190,178,7,171,2022-05-03_11-02-08,fp7d
2021-10-29,AG,52,46,1,45,2022-05-03_11-02-08,fp7d
2021-10-29,AI,0,0,0,0,2022-05-03_11-02-08,fp7d
2021-10-29,AR,6,6,0,6,2022-05-03_11-02-08,fp7d
2021-10-29,BE,104,90,2,88,2022-05-03_11-02-08,fp7d
2021-10-29,BL,20,15,0,15,2022-05-03_11-02-08,fp7d
2021-10-29,BS,54,50,0,50,2022-05-03_11-02-08,fp7d
2021-10-29,FR,24,22,0,22,2022-05-03_11-02-08,fp7d
2021-10-29,GE,38,56,18,38,2022-05-03_11-02-08,fp7d
2021-10-29,GL,6,6,0,6,2022-05-03_11-02-08,fp7d
2021-10-29,GR,16,16,0,16,2022-05-03_11-02-08,fp7d
2021-10-29,JU,6,6,0,6,2022-05-03_11-02-08,fp7d
2021-10-29,LU,54,49,2,47,2022-05-03_11-02-08,fp7d
2021-10-29,NE,10,10,0,10,2022-05-03_11-02-08,fp7d
2021-10-29,NW,6,5,0,5,2022-05-03_11-02-08,fp7d
2021-10-29,OW,0,0,0,0,2022-05-03_11-02-08,fp7d
2021-10-29,SG,54,40,1,39,2022-05-03_11-02-08,fp7d
2021-10-29,SH,8,8,0,8,2022-05-03_11-02-08,fp7d
2021-10-29,SO,17,19,2,17,2022-05-03_11-02-08,fp7d
2021-10-29,SZ,12,11,0,11,2022-05-03_11-02-08,fp7d
2021-10-29,TG,21,28,7,21,2022-05-03_11-02-08,fp7d
2021-10-29,TI,53,57,4,53,2022-05-03_11-02-08,fp7d
2021-10-29,UR,6,6,0,6,2022-05-03_11-02-08,fp7d
2021-10-29,VD,85,86,1,85,2022-05-03_11-02-08,fp7d
2021-10-29,VS,21,21,0,21,2022-05-03_11-02-08,fp7d
2021-10-29,ZG,8,8,0,8,2022-05-03_11-02-08,fp7d
2021-10-29,ZH,190,177,6,171,2022-05-03_11-02-08,fp7d
2021-10-30,AG,52,46,1,45,2022-05-03_11-02-08,fp7d
2021-10-30,AI,0,0,0,0,2022-05-03_11-02-08,fp7d
2021-10-30,AR,6,6,0,6,2022-05-03_11-02-08,fp7d
2021-10-30,BE,104,88,2,86,2022-05-03_11-02-08,fp7d
2021-10-30,BL,20,15,0,15,2022-05-03_11-02-08,fp7d
2021-10-30,BS,54,46,0,46,2022-05-03_11-02-08,fp7d
2021-10-30,FR,24,22,0,22,2022-05-03_11-02-08,fp7d
2021-10-30,GE,38,56,18,38,2022-05-03_11-02-08,fp7d
2021-10-30,GL,6,6,0,6,2022-05-03_11-02-08,fp7d
2021-10-30,GR,16,16,0,16,2022-05-03_11-02-08,fp7d
2021-10-30,JU,6,6,0,6,2022-05-03_11-02-08,fp7d
2021-10-30,LU,54,49,2,47,2022-05-03_11-02-08,fp7d
2021-10-30,NE,10,10,0,10,2022-05-03_11-02-08,fp7d
2021-10-30,NW,6,5,0,5,2022-05-03_11-02-08,fp7d
2021-10-30,OW,0,0,0,0,2022-05-03_11-02-08,fp7d
2021-10-30,SG,54,40,1,39,2022-05-03_11-02-08,fp7d
2021-10-30,SH,8,8,0,8,2022-05-03_11-02-08,fp7d
2021-10-30,SO,17,18,1,17,2022-05-03_11-02-08,fp7d
2021-10-30,SZ,12,11,0,11,2022-05-03_11-02-08,fp7d
2021-10-30,TG,21,28,7,21,2022-05-03_11-02-08,fp7d
2021-10-30,TI,53,57,4,53,2022-05-03_11-02-08,fp7d
2021-10-30,UR,6,6,0,6,2022-05-03_11-02-08,fp7d
2021-10-30,VD,85,86,1,85,2022-05-03_11-02-08,fp7d
2021-10-30,VS,21,21,0,21,2022-05-03_11-02-08,fp7d
2021-10-30,ZG,8,8,0,8,2022-05-03_11-02-08,fp7d
2021-10-30,ZH,190,175,6,169,2022-05-03_11-02-08,fp7d
2021-10-31,AG,52,46,1,45,2022-05-03_11-02-08,fp7d
2021-10-31,AI,0,0,0,0,2022-05-03_11-02-08,fp7d
2021-10-31,AR,6,6,0,6,2022-05-03_11-02-08,fp7d
2021-10-31,BE,104,87,2,85,2022-05-03_11-02-08,fp7d
2021-10-31,BL,20,15,0,15,2022-05-03_11-02-08,fp7d
2021-10-31,BS,54,46,0,46,2022-05-03_11-02-08,fp7d
2021-10-31,FR,24,22,0,22,2022-05-03_11-02-08,fp7d
2021-10-31,GE,38,56,18,38,2022-05-03_11-02-08,fp7d
2021-10-31,GL,6,6,0,6,2022-05-03_11-02-08,fp7d
2021-10-31,GR,16,16,0,16,2022-05-03_11-02-08,fp7d
2021-10-31,JU,6,6,0,6,2022-05-03_11-02-08,fp7d
2021-10-31,LU,54,49,2,47,2022-05-03_11-02-08,fp7d
2021-10-31,NE,10,10,0,10,2022-05-03_11-02-08,fp7d
2021-10-31,NW,6,5,0,5,2022-05-03_11-02-08,fp7d
2021-10-31,OW,0,0,0,0,2022-05-03_11-02-08,fp7d
2021-10-31,SG,54,40,1,39,2022-05-03_11-02-08,fp7d
2021-10-31,SH,8,8,0,8,2022-05-03_11-02-08,fp7d
2021-10-31,SO,17,18,1,17,2022-05-03_11-02-08,fp7d
2021-10-31,SZ,12,11,0,11,2022-05-03_11-02-08,fp7d
2021-10-31,TG,21,28,7,21,2022-05-03_11-02-08,fp7d
2021-10-31,TI,53,57,4,53,2022-05-03_11-02-08,fp7d
2021-10-31,UR,6,6,0,6,2022-05-03_11-02-08,fp7d
2021-10-31,VD,85,86,1,85,2022-05-03_11-02-08,fp7d
2021-10-31,VS,21,21,0,21,2022-05-03_11-02-08,fp7d
2021-10-31,ZG,8,8,0,8,2022-05-03_11-02-08,fp7d
2021-10-31,ZH,190,176,6,170,2022-05-03_11-02-08,fp7d
2021-11-01,AG,52,46,1,45,2022-05-03_11-02-08,fp7d
2021-11-01,AI,0,0,0,0,2022-05-03_11-02-08,fp7d
2021-11-01,AR,6,6,0,6,2022-05-03_11-02-08,fp7d
2021-11-01,BE,104,90,2,88,2022-05-03_11-02-08,fp7d
2021-11-01,BL,20,15,0,15,2022-05-03_11-02-08,fp7d
2021-11-01,BS,54,50,0,50,2022-05-03_11-02-08,fp7d
2021-11-01,FR,24,22,0,22,2022-05-03_11-02-08,fp7d
2021-11-01,GE,38,56,18,38,2022-05-03_11-02-08,fp7d
2021-11-01,GL,6,6,0,6,2022-05-03_11-02-08,fp7d
2021-11-01,GR,16,16,0,16,2022-05-03_11-02-08,fp7d
2021-11-01,JU,6,6,0,6,2022-05-03_11-02-08,fp7d
2021-11-01,LU,54,49,2,47,2022-05-03_11-02-08,fp7d
2021-11-01,NE,10,10,0,10,2022-05-03_11-02-08,fp7d
2021-11-01,NW,6,5,0,5,2022-05-03_11-02-08,fp7d
2021-11-01,OW,0,0,0,0,2022-05-03_11-02-08,fp7d
2021-11-01,SG,54,40,1,39,2022-05-03_11-02-08,fp7d
2021-11-01,SH,8,8,0,8,2022-05-03_11-02-08,fp7d
2021-11-01,SO,17,19,2,17,2022-05-03_11-02-08,fp7d
2021-11-01,SZ,12,11,0,11,2022-05-03_11-02-08,fp7d
2021-11-01,TG,21,28,7,21,2022-05-03_11-02-08,fp7d
2021-11-01,TI,53,57,4,53,2022-05-03_11-02-08,fp7d
2021-11-01,UR,6,6,0,6,2022-05-03_11-02-08,fp7d
2021-11-01,VD,85,86,1,85,2022-05-03_11-02-08,fp7d
2021-11-01,VS,21,21,0,21,2022-05-03_11-02-08,fp7d
2021-11-01,ZG,8,8,0,8,2022-05-03_11-02-08,fp7d
2021-11-01,ZH,190,177,6,171,2022-05-03_11-02-08,fp7d
2021-11-02,AG,52,46,1,45,2022-05-03_11-02-08,fp7d
2021-11-02,AI,0,0,0,0,2022-05-03_11-02-08,fp7d
2021-11-02,AR,6,6,0,6,2022-05-03_11-02-08,fp7d
2021-11-02,BE,104,90,2,88,2022-05-03_11-02-08,fp7d
2021-11-02,BL,20,15,0,15,2022-05-03_11-02-08,fp7d
2021-11-02,BS,54,50,0,50,2022-05-03_11-02-08,fp7d
2021-11-02,FR,24,22,0,22,2022-05-03_11-02-08,fp7d
2021-11-02,GE,38,56,18,38,2022-05-03_11-02-08,fp7d
2021-11-02,GL,6,6,0,6,2022-05-03_11-02-08,fp7d
2021-11-02,GR,16,16,0,16,2022-05-03_11-02-08,fp7d
2021-11-02,JU,6,6,0,6,2022-05-03_11-02-08,fp7d
2021-11-02,LU,54,49,2,47,2022-05-03_11-02-08,fp7d
2021-11-02,NE,10,10,0,10,2022-05-03_11-02-08,fp7d
2021-11-02,NW,6,5,0,5,2022-05-03_11-02-08,fp7d
2021-11-02,OW,0,0,0,0,2022-05-03_11-02-08,fp7d
2021-11-02,SG,54,40,1,39,2022-05-03_11-02-08,fp7d
2021-11-02,SH,8,8,0,8,2022-05-03_11-02-08,fp7d
2021-11-02,SO,17,19,2,17,2022-05-03_11-02-08,fp7d
2021-11-02,SZ,12,11,0,11,2022-05-03_11-02-08,fp7d
2021-11-02,TG,21,28,7,21,2022-05-03_11-02-08,fp7d
2021-11-02,TI,53,57,4,53,2022-05-03_11-02-08,fp7d
2021-11-02,UR,6,6,0,6,2022-05-03_11-02-08,fp7d
2021-11-02,VD,85,86,1,85,2022-05-03_11-02-08,fp7d
2021-11-02,VS,21,21,0,21,2022-05-03_11-02-08,fp7d
2021-11-02,ZG,8,8,0,8,2022-05-03_11-02-08,fp7d
2021-11-02,ZH,190,176,6,170,2022-05-03_11-02-08,fp7d
2021-11-03,AG,52,46,1,45,2022-05-03_11-02-08,fp7d
2021-11-03,AI,0,0,0,0,2022-05-03_11-02-08,fp7d
2021-11-03,AR,6,6,0,6,2022-05-03_11-02-08,fp7d
2021-11-03,BE,104,90,2,88,2022-05-03_11-02-08,fp7d
2021-11-03,BL,20,15,0,15,2022-05-03_11-02-08,fp7d
2021-11-03,BS,54,50,0,50,2022-05-03_11-02-08,fp7d
2021-11-03,FR,24,22,0,22,2022-05-03_11-02-08,fp7d
2021-11-03,GE,38,56,18,38,2022-05-03_11-02-08,fp7d
2021-11-03,GL,6,6,0,6,2022-05-03_11-02-08,fp7d
2021-11-03,GR,16,16,0,16,2022-05-03_11-02-08,fp7d
2021-11-03,JU,6,6,0,6,2022-05-03_11-02-08,fp7d
2021-11-03,LU,54,49,2,47,2022-05-03_11-02-08,fp7d
2021-11-03,NE,10,10,0,10,2022-05-03_11-02-08,fp7d
2021-11-03,NW,6,5,0,5,2022-05-03_11-02-08,fp7d
2021-11-03,OW,0,0,0,0,2022-05-03_11-02-08,fp7d
2021-11-03,SG,54,40,1,39,2022-05-03_11-02-08,fp7d
2021-11-03,SH,8,8,0,8,2022-05-03_11-02-08,fp7d
2021-11-03,SO,17,19,2,17,2022-05-03_11-02-08,fp7d
2021-11-03,SZ,12,11,0,11,2022-05-03_11-02-08,fp7d
2021-11-03,TG,21,28,7,21,2022-05-03_11-02-08,fp7d
2021-11-03,TI,53,57,4,53,2022-05-03_11-02-08,fp7d
2021-11-03,UR,6,6,0,6,2022-05-03_11-02-08,fp7d
2021-11-03,VD,85,86,1,85,2022-05-03_11-02-08,fp7d
2021-11-03,VS,21,21,0,21,2022-05-03_11-02-08,fp7d
2021-11-03,ZG,8,8,0,8,2022-05-03_11-02-08,fp7d
2021-11-03,ZH,190,178,6,172,2022-05-03_11-02-08,fp7d
2021-11-04,AG,52,46,1,45,2022-05-03_11-02-08,fp7d
2021-11-04,AI,0,0,0,0,2022-05-03_11-02-08,fp7d
2021-11-04,AR,6,6,0,6,2022-05-03_11-02-08,fp7d
2021-11-04,BE,104,90,2,88,2022-05-03_11-02-08,fp7d
2021-11-04,BL,20,15,0,15,2022-05-03_11-02-08,fp7d
2021-11-04,BS,54,50,0,50,2022-05-03_11-02-08,fp7d
2021-11-04,FR,24,22,0,22,2022-05-03_11-02-08,fp7d
2021-11-04,GE,38,56,18,38,2022-05-03_11-02-08,fp7d
2021-11-04,GL,6,6,0,6,2022-05-03_11-02-08,fp7d
2021-11-04,GR,16,16,0,16,2022-05-03_11-02-08,fp7d
2021-11-04,JU,6,6,0,6,2022-05-03_11-02-08,fp7d
2021-11-04,LU,54,49,2,47,2022-05-03_11-02-08,fp7d
2021-11-04,NE,10,10,0,10,2022-05-03_11-02-08,fp7d
2021-11-04,NW,6,6,0,6,2022-05-03_11-02-08,fp7d
2021-11-04,OW,0,0,0,0,2022-05-03_11-02-08,fp7d
2021-11-04,SG,54,40,1,39,2022-05-03_11-02-08,fp7d
2021-11-04,SH,8,8,0,8,2022-05-03_11-02-08,fp7d
2021-11-04,SO,17,19,2,17,2022-05-03_11-02-08,fp7d
2021-11-04,SZ,12,11,0,11,2022-05-03_11-02-08,fp7d
2021-11-04,TG,21,28,7,21,2022-05-03_11-02-08,fp7d
2021-11-04,TI,53,57,4,53,2022-05-03_11-02-08,fp7d
2021-11-04,UR,6,6,0,6,2022-05-03_11-02-08,fp7d
2021-11-04,VD,85,86,1,85,2022-05-03_11-02-08,fp7d
2021-11-04,VS,21,21,0,21,2022-05-03_11-02-08,fp7d
2021-11-04,ZG,8,8,0,8,2022-05-03_11-02-08,fp7d
2021-11-04,ZH,190,178,6,172,2022-05-03_11-02-08,fp7d
2021-11-05,AG,52,46,1,45,2022-05-03_11-02-08,fp7d
2021-11-05,AI,0,0,0,0,2022-05-03_11-02-08,fp7d
2021-11-05,AR,6,6,0,6,2022-05-03_11-02-08,fp7d
2021-11-05,BE,104,90,2,88,2022-05-03_11-02-08,fp7d
2021-11-05,BL,20,15,0,15,2022-05-03_11-02-08,fp7d
2021-11-05,BS,54,50,0,50,2022-05-03_11-02-08,fp7d
2021-11-05,FR,24,22,0,22,2022-05-03_11-02-08,fp7d
2021-11-05,GE,38,56,18,38,2022-05-03_11-02-08,fp7d
2021-11-05,GL,6,6,0,6,2022-05-03_11-02-08,fp7d
2021-11-05,GR,16,16,0,16,2022-05-03_11-02-08,fp7d
2021-11-05,JU,6,6,0,6,2022-05-03_11-02-08,fp7d
2021-11-05,LU,54,49,2,47,2022-05-03_11-02-08,fp7d
2021-11-05,NE,10,10,0,10,2022-05-03_11-02-08,fp7d
2021-11-05,NW,6,5,0,5,2022-05-03_11-02-08,fp7d
2021-11-05,OW,0,0,0,0,2022-05-03_11-02-08,fp7d
2021-11-05,SG,54,40,1,39,2022-05-03_11-02-08,fp7d
2021-11-05,SH,8,8,0,8,2022-05-03_11-02-08,fp7d
2021-11-05,SO,17,19,2,17,2022-05-03_11-02-08,fp7d
2021-11-05,SZ,12,12,0,12,2022-05-03_11-02-08,fp7d
2021-11-05,TG,21,28,7,21,2022-05-03_11-02-08,fp7d
2021-11-05,TI,53,57,4,53,2022-05-03_11-02-08,fp7d
2021-11-05,UR,6,6,0,6,2022-05-03_11-02-08,fp7d
2021-11-05,VD,85,86,1,85,2022-05-03_11-02-08,fp7d
2021-11-05,VS,21,21,0,21,2022-05-03_11-02-08,fp7d
2021-11-05,ZG,8,8,0,8,2022-05-03_11-02-08,fp7d
2021-11-05,ZH,190,181,6,175,2022-05-03_11-02-08,fp7d
2021-11-06,AG,52,46,1,45,2022-05-03_11-02-08,fp7d
2021-11-06,AI,0,0,0,0,2022-05-03_11-02-08,fp7d
2021-11-06,AR,6,6,0,6,2022-05-03_11-02-08,fp7d
2021-11-06,BE,104,89,2,87,2022-05-03_11-02-08,fp7d
2021-11-06,BL,20,15,0,15,2022-05-03_11-02-08,fp7d
2021-11-06,BS,54,46,0,46,2022-05-03_11-02-08,fp7d
2021-11-06,FR,24,22,0,22,2022-05-03_11-02-08,fp7d
2021-11-06,GE,38,56,18,38,2022-05-03_11-02-08,fp7d
2021-11-06,GL,6,6,0,6,2022-05-03_11-02-08,fp7d
2021-11-06,GR,16,16,0,16,2022-05-03_11-02-08,fp7d
2021-11-06,JU,6,6,0,6,2022-05-03_11-02-08,fp7d
2021-11-06,LU,54,47,0,47,2022-05-03_11-02-08,fp7d
2021-11-06,NE,10,10,0,10,2022-05-03_11-02-08,fp7d
2021-11-06,NW,6,5,0,5,2022-05-03_11-02-08,fp7d
2021-11-06,OW,0,0,0,0,2022-05-03_11-02-08,fp7d
2021-11-06,SG,54,40,1,39,2022-05-03_11-02-08,fp7d
2021-11-06,SH,8,8,0,8,2022-05-03_11-02-08,fp7d
2021-11-06,SO,17,18,2,16,2022-05-03_11-02-08,fp7d
2021-11-06,SZ,12,12,0,12,2022-05-03_11-02-08,fp7d
2021-11-06,TG,21,28,7,21,2022-05-03_11-02-08,fp7d
2021-11-06,TI,53,57,4,53,2022-05-03_11-02-08,fp7d
2021-11-06,UR,6,6,0,6,2022-05-03_11-02-08,fp7d
2021-11-06,VD,85,86,1,85,2022-05-03_11-02-08,fp7d
2021-11-06,VS,21,21,0,21,2022-05-03_11-02-08,fp7d
2021-11-06,ZG,8,8,0,8,2022-05-03_11-02-08,fp7d
2021-11-06,ZH,190,180,6,174,2022-05-03_11-02-08,fp7d
2021-11-07,AG,52,44,1,43,2022-05-03_11-02-08,fp7d
2021-11-07,AI,0,0,0,0,2022-05-03_11-02-08,fp7d
2021-11-07,AR,6,6,0,6,2022-05-03_11-02-08,fp7d
2021-11-07,BE,104,90,2,88,2022-05-03_11-02-08,fp7d
2021-11-07,BL,20,15,0,15,2022-05-03_11-02-08,fp7d
2021-11-07,BS,54,46,0,46,2022-05-03_11-02-08,fp7d
2021-11-07,FR,24,22,0,22,2022-05-03_11-02-08,fp7d
2021-11-07,GE,38,56,18,38,2022-05-03_11-02-08,fp7d
2021-11-07,GL,6,6,0,6,2022-05-03_11-02-08,fp7d
2021-11-07,GR,16,16,0,16,2022-05-03_11-02-08,fp7d
2021-11-07,JU,6,6,0,6,2022-05-03_11-02-08,fp7d
2021-11-07,LU,54,47,0,47,2022-05-03_11-02-08,fp7d
2021-11-07,NE,10,10,0,10,2022-05-03_11-02-08,fp7d
2021-11-07,NW,6,5,0,5,2022-05-03_11-02-08,fp7d
2021-11-07,OW,0,0,0,0,2022-05-03_11-02-08,fp7d
2021-11-07,SG,54,40,1,39,2022-05-03_11-02-08,fp7d
2021-11-07,SH,8,8,0,8,2022-05-03_11-02-08,fp7d
2021-11-07,SO,17,18,2,16,2022-05-03_11-02-08,fp7d
2021-11-07,SZ,12,11,0,11,2022-05-03_11-02-08,fp7d
2021-11-07,TG,21,28,7,21,2022-05-03_11-02-08,fp7d
2021-11-07,TI,53,57,4,53,2022-05-03_11-02-08,fp7d
2021-11-07,UR,6,6,0,6,2022-05-03_11-02-08,fp7d
2021-11-07,VD,85,86,1,85,2022-05-03_11-02-08,fp7d
2021-11-07,VS,21,21,0,21,2022-05-03_11-02-08,fp7d
2021-11-07,ZG,8,8,0,8,2022-05-03_11-02-08,fp7d
2021-11-07,ZH,190,180,6,174,2022-05-03_11-02-08,fp7d
2021-11-08,AG,52,46,1,45,2022-05-03_11-02-08,fp7d
2021-11-08,AI,0,0,0,0,2022-05-03_11-02-08,fp7d
2021-11-08,AR,6,6,0,6,2022-05-03_11-02-08,fp7d
2021-11-08,BE,104,94,4,90,2022-05-03_11-02-08,fp7d
2021-11-08,BL,20,15,0,15,2022-05-03_11-02-08,fp7d
2021-11-08,BS,54,50,0,50,2022-05-03_11-02-08,fp7d
2021-11-08,FR,24,22,0,22,2022-05-03_11-02-08,fp7d
2021-11-08,GE,38,56,18,38,2022-05-03_11-02-08,fp7d
2021-11-08,GL,6,6,0,6,2022-05-03_11-02-08,fp7d
2021-11-08,GR,16,16,0,16,2022-05-03_11-02-08,fp7d
2021-11-08,JU,6,6,0,6,2022-05-03_11-02-08,fp7d
2021-11-08,LU,54,46,0,46,2022-05-03_11-02-08,fp7d
2021-11-08,NE,10,10,0,10,2022-05-03_11-02-08,fp7d
2021-11-08,NW,6,6,0,6,2022-05-03_11-02-08,fp7d
2021-11-08,OW,0,0,0,0,2022-05-03_11-02-08,fp7d
2021-11-08,SG,54,40,1,39,2022-05-03_11-02-08,fp7d
2021-11-08,SH,8,8,0,8,2022-05-03_11-02-08,fp7d
2021-11-08,SO,17,18,2,16,2022-05-03_11-02-08,fp7d
2021-11-08,SZ,12,11,0,11,2022-05-03_11-02-08,fp7d
2021-11-08,TG,21,28,7,21,2022-05-03_11-02-08,fp7d
2021-11-08,TI,53,57,4,53,2022-05-03_11-02-08,fp7d
2021-11-08,UR,6,6,0,6,2022-05-03_11-02-08,fp7d
2021-11-08,VD,85,86,1,85,2022-05-03_11-02-08,fp7d
2021-11-08,VS,21,21,0,21,2022-05-03_11-02-08,fp7d
2021-11-08,ZG,8,8,0,8,2022-05-03_11-02-08,fp7d
2021-11-08,ZH,190,183,7,176,2022-05-03_11-02-08,fp7d
2021-11-09,AG,52,46,1,45,2022-05-03_11-02-08,fp7d
2021-11-09,AI,0,0,0,0,2022-05-03_11-02-08,fp7d
2021-11-09,AR,6,6,0,6,2022-05-03_11-02-08,fp7d
2021-11-09,BE,104,94,4,90,2022-05-03_11-02-08,fp7d
2021-11-09,BL,20,15,0,15,2022-05-03_11-02-08,fp7d
2021-11-09,BS,54,50,0,50,2022-05-03_11-02-08,fp7d
2021-11-09,FR,24,23,0,23,2022-05-03_11-02-08,fp7d
2021-11-09,GE,38,56,18,38,2022-05-03_11-02-08,fp7d
2021-11-09,GL,6,6,0,6,2022-05-03_11-02-08,fp7d
2021-11-09,GR,16,16,0,16,2022-05-03_11-02-08,fp7d
2021-11-09,JU,6,6,0,6,2022-05-03_11-02-08,fp7d
2021-11-09,LU,54,46,0,46,2022-05-03_11-02-08,fp7d
2021-11-09,NE,10,10,0,10,2022-05-03_11-02-08,fp7d
2021-11-09,NW,6,6,0,6,2022-05-03_11-02-08,fp7d
2021-11-09,OW,0,0,0,0,2022-05-03_11-02-08,fp7d
2021-11-09,SG,54,40,1,39,2022-05-03_11-02-08,fp7d
2021-11-09,SH,8,8,0,8,2022-05-03_11-02-08,fp7d
2021-11-09,SO,17,19,2,17,2022-05-03_11-02-08,fp7d
2021-11-09,SZ,12,11,0,11,2022-05-03_11-02-08,fp7d
2021-11-09,TG,21,28,7,21,2022-05-03_11-02-08,fp7d
2021-11-09,TI,53,57,4,53,2022-05-03_11-02-08,fp7d
2021-11-09,UR,6,6,0,6,2022-05-03_11-02-08,fp7d
2021-11-09,VD,85,86,1,85,2022-05-03_11-02-08,fp7d
2021-11-09,VS,21,21,0,21,2022-05-03_11-02-08,fp7d
2021-11-09,ZG,8,8,0,8,2022-05-03_11-02-08,fp7d
2021-11-09,ZH,190,182,7,175,2022-05-03_11-02-08,fp7d
2021-11-10,AG,52,46,1,45,2022-05-03_11-02-08,fp7d
2021-11-10,AI,0,0,0,0,2022-05-03_11-02-08,fp7d
2021-11-10,AR,6,6,0,6,2022-05-03_11-02-08,fp7d
2021-11-10,BE,104,92,4,88,2022-05-03_11-02-08,fp7d
2021-11-10,BL,20,15,0,15,2022-05-03_11-02-08,fp7d
2021-11-10,BS,54,50,0,50,2022-05-03_11-02-08,fp7d
2021-11-10,FR,24,23,0,23,2022-05-03_11-02-08,fp7d
2021-11-10,GE,38,56,18,38,2022-05-03_11-02-08,fp7d
2021-11-10,GL,6,6,0,6,2022-05-03_11-02-08,fp7d
2021-11-10,GR,16,16,0,16,2022-05-03_11-02-08,fp7d
2021-11-10,JU,6,6,0,6,2022-05-03_11-02-08,fp7d
2021-11-10,LU,54,47,0,47,2022-05-03_11-02-08,fp7d
2021-11-10,NE,10,10,0,10,2022-05-03_11-02-08,fp7d
2021-11-10,NW,6,6,0,6,2022-05-03_11-02-08,fp7d
2021-11-10,OW,0,0,0,0,2022-05-03_11-02-08,fp7d
2021-11-10,SG,54,40,1,39,2022-05-03_11-02-08,fp7d
2021-11-10,SH,8,8,0,8,2022-05-03_11-02-08,fp7d
2021-11-10,SO,17,19,2,17,2022-05-03_11-02-08,fp7d
2021-11-10,SZ,12,12,0,12,2022-05-03_11-02-08,fp7d
2021-11-10,TG,21,28,7,21,2022-05-03_11-02-08,fp7d
2021-11-10,TI,53,57,4,53,2022-05-03_11-02-08,fp7d
2021-11-10,UR,6,6,0,6,2022-05-03_11-02-08,fp7d
2021-11-10,VD,85,86,1,85,2022-05-03_11-02-08,fp7d
2021-11-10,VS,21,21,0,21,2022-05-03_11-02-08,fp7d
2021-11-10,ZG,8,8,0,8,2022-05-03_11-02-08,fp7d
2021-11-10,ZH,190,180,7,173,2022-05-03_11-02-08,fp7d
2021-11-11,AG,52,46,1,45,2022-05-03_11-02-08,fp7d
2021-11-11,AI,0,0,0,0,2022-05-03_11-02-08,fp7d
2021-11-11,AR,6,6,0,6,2022-05-03_11-02-08,fp7d
2021-11-11,BE,104,92,4,88,2022-05-03_11-02-08,fp7d
2021-11-11,BL,20,15,0,15,2022-05-03_11-02-08,fp7d
2021-11-11,BS,54,50,0,50,2022-05-03_11-02-08,fp7d
2021-11-11,FR,24,23,0,23,2022-05-03_11-02-08,fp7d
2021-11-11,GE,38,56,18,38,2022-05-03_11-02-08,fp7d
2021-11-11,GL,6,6,0,6,2022-05-03_11-02-08,fp7d
2021-11-11,GR,16,16,0,16,2022-05-03_11-02-08,fp7d
2021-11-11,JU,6,6,0,6,2022-05-03_11-02-08,fp7d
2021-11-11,LU,54,49,2,47,2022-05-03_11-02-08,fp7d
2021-11-11,NE,10,10,0,10,2022-05-03_11-02-08,fp7d
2021-11-11,NW,6,6,0,6,2022-05-03_11-02-08,fp7d
2021-11-11,OW,0,0,0,0,2022-05-03_11-02-08,fp7d
2021-11-11,SG,54,40,1,39,2022-05-03_11-02-08,fp7d
2021-11-11,SH,8,8,0,8,2022-05-03_11-02-08,fp7d
2021-11-11,SO,17,17,0,17,2022-05-03_11-02-08,fp7d
2021-11-11,SZ,12,12,0,12,2022-05-03_11-02-08,fp7d
2021-11-11,TG,21,28,7,21,2022-05-03_11-02-08,fp7d
2021-11-11,TI,53,57,4,53,2022-05-03_11-02-08,fp7d
2021-11-11,UR,6,6,0,6,2022-05-03_11-02-08,fp7d
2021-11-11,VD,85,86,1,85,2022-05-03_11-02-08,fp7d
2021-11-11,VS,21,21,0,21,2022-05-03_11-02-08,fp7d
2021-11-11,ZG,8,8,0,8,2022-05-03_11-02-08,fp7d
2021-11-11,ZH,190,179,7,172,2022-05-03_11-02-08,fp7d
2021-11-12,AG,52,46,1,45,2022-05-03_11-02-08,fp7d
2021-11-12,AI,0,0,0,0,2022-05-03_11-02-08,fp7d
2021-11-12,AR,6,6,0,6,2022-05-03_11-02-08,fp7d
2021-11-12,BE,104,92,4,88,2022-05-03_11-02-08,fp7d
2021-11-12,BL,20,15,0,15,2022-05-03_11-02-08,fp7d
2021-11-12,BS,54,50,0,50,2022-05-03_11-02-08,fp7d
2021-11-12,FR,24,23,0,23,2022-05-03_11-02-08,fp7d
2021-11-12,GE,38,56,18,38,2022-05-03_11-02-08,fp7d
2021-11-12,GL,6,6,0,6,2022-05-03_11-02-08,fp7d
2021-11-12,GR,16,16,0,16,2022-05-03_11-02-08,fp7d
2021-11-12,JU,6,6,0,6,2022-05-03_11-02-08,fp7d
2021-11-12,LU,54,49,2,47,2022-05-03_11-02-08,fp7d
2021-11-12,NE,10,10,0,10,2022-05-03_11-02-08,fp7d
2021-11-12,NW,6,6,0,6,2022-05-03_11-02-08,fp7d
2021-11-12,OW,0,0,0,0,2022-05-03_11-02-08,fp7d
2021-11-12,SG,54,40,1,39,2022-05-03_11-02-08,fp7d
2021-11-12,SH,8,7,0,7,2022-05-03_11-02-08,fp7d
2021-11-12,SO,17,17,0,17,2022-05-03_11-02-08,fp7d
2021-11-12,SZ,12,12,0,12,2022-05-03_11-02-08,fp7d
2021-11-12,TG,21,28,7,21,2022-05-03_11-02-08,fp7d
2021-11-12,TI,53,58,5,53,2022-05-03_11-02-08,fp7d
2021-11-12,UR,6,6,0,6,2022-05-03_11-02-08,fp7d
2021-11-12,VD,85,86,1,85,2022-05-03_11-02-08,fp7d
2021-11-12,VS,21,21,0,21,2022-05-03_11-02-08,fp7d
2021-11-12,ZG,8,8,0,8,2022-05-03_11-02-08,fp7d
2021-11-12,ZH,190,181,7,174,2022-05-03_11-02-08,fp7d
2021-11-13,AG,52,46,1,45,2022-05-03_11-02-08,fp7d
2021-11-13,AI,0,0,0,0,2022-05-03_11-02-08,fp7d
2021-11-13,AR,6,6,0,6,2022-05-03_11-02-08,fp7d
2021-11-13,BE,104,89,4,85,2022-05-03_11-02-08,fp7d
2021-11-13,BL,20,15,0,15,2022-05-03_11-02-08,fp7d
2021-11-13,BS,54,46,0,46,2022-05-03_11-02-08,fp7d
2021-11-13,FR,24,23,0,23,2022-05-03_11-02-08,fp7d
2021-11-13,GE,38,56,18,38,2022-05-03_11-02-08,fp7d
2021-11-13,GL,6,6,0,6,2022-05-03_11-02-08,fp7d
2021-11-13,GR,16,16,0,16,2022-05-03_11-02-08,fp7d
2021-11-13,JU,6,6,0,6,2022-05-03_11-02-08,fp7d
2021-11-13,LU,54,49,2,47,2022-05-03_11-02-08,fp7d
2021-11-13,NE,10,10,0,10,2022-05-03_11-02-08,fp7d
2021-11-13,NW,6,6,0,6,2022-05-03_11-02-08,fp7d
2021-11-13,OW,0,0,0,0,2022-05-03_11-02-08,fp7d
2021-11-13,SG,54,40,1,39,2022-05-03_11-02-08,fp7d
2021-11-13,SH,8,7,0,7,2022-05-03_11-02-08,fp7d
2021-11-13,SO,17,17,0,17,2022-05-03_11-02-08,fp7d
2021-11-13,SZ,12,12,0,12,2022-05-03_11-02-08,fp7d
2021-11-13,TG,21,28,7,21,2022-05-03_11-02-08,fp7d
2021-11-13,TI,53,58,5,53,2022-05-03_11-02-08,fp7d
2021-11-13,UR,6,6,0,6,2022-05-03_11-02-08,fp7d
2021-11-13,VD,85,86,1,85,2022-05-03_11-02-08,fp7d
2021-11-13,VS,21,21,0,21,2022-05-03_11-02-08,fp7d
2021-11-13,ZG,8,8,0,8,2022-05-03_11-02-08,fp7d
2021-11-13,ZH,190,180,7,173,2022-05-03_11-02-08,fp7d
2021-11-14,AG,52,46,1,45,2022-05-03_11-02-08,fp7d
2021-11-14,AI,0,0,0,0,2022-05-03_11-02-08,fp7d
2021-11-14,AR,6,6,0,6,2022-05-03_11-02-08,fp7d
2021-11-14,BE,104,91,4,87,2022-05-03_11-02-08,fp7d
2021-11-14,BL,20,15,0,15,2022-05-03_11-02-08,fp7d
2021-11-14,BS,54,46,0,46,2022-05-03_11-02-08,fp7d
2021-11-14,FR,24,24,0,24,2022-05-03_11-02-08,fp7d
2021-11-14,GE,38,56,18,38,2022-05-03_11-02-08,fp7d
2021-11-14,GL,6,6,0,6,2022-05-03_11-02-08,fp7d
2021-11-14,GR,16,16,0,16,2022-05-03_11-02-08,fp7d
2021-11-14,JU,6,6,0,6,2022-05-03_11-02-08,fp7d
2021-11-14,LU,54,49,2,47,2022-05-03_11-02-08,fp7d
2021-11-14,NE,10,10,0,10,2022-05-03_11-02-08,fp7d
2021-11-14,NW,6,6,0,6,2022-05-03_11-02-08,fp7d
2021-11-14,OW,0,0,0,0,2022-05-03_11-02-08,fp7d
2021-11-14,SG,54,40,1,39,2022-05-03_11-02-08,fp7d
2021-11-14,SH,8,7,0,7,2022-05-03_11-02-08,fp7d
2021-11-14,SO,17,17,0,17,2022-05-03_11-02-08,fp7d
2021-11-14,SZ,12,11,0,11,2022-05-03_11-02-08,fp7d
2021-11-14,TG,21,28,7,21,2022-05-03_11-02-08,fp7d
2021-11-14,TI,53,58,5,53,2022-05-03_11-02-08,fp7d
2021-11-14,UR,6,6,0,6,2022-05-03_11-02-08,fp7d
2021-11-14,VD,85,86,1,85,2022-05-03_11-02-08,fp7d
2021-11-14,VS,21,21,0,21,2022-05-03_11-02-08,fp7d
2021-11-14,ZG,8,8,0,8,2022-05-03_11-02-08,fp7d
2021-11-14,ZH,190,178,7,171,2022-05-03_11-02-08,fp7d
2021-11-15,AG,52,46,1,45,2022-05-03_11-02-08,fp7d
2021-11-15,AI,0,0,0,0,2022-05-03_11-02-08,fp7d
2021-11-15,AR,6,6,0,6,2022-05-03_11-02-08,fp7d
2021-11-15,BE,104,94,4,90,2022-05-03_11-02-08,fp7d
2021-11-15,BL,20,15,0,15,2022-05-03_11-02-08,fp7d
2021-11-15,BS,54,50,0,50,2022-05-03_11-02-08,fp7d
2021-11-15,FR,24,24,0,24,2022-05-03_11-02-08,fp7d
2021-11-15,GE,38,56,18,38,2022-05-03_11-02-08,fp7d
2021-11-15,GL,6,6,0,6,2022-05-03_11-02-08,fp7d
2021-11-15,GR,16,16,0,16,2022-05-03_11-02-08,fp7d
2021-11-15,JU,6,6,0,6,2022-05-03_11-02-08,fp7d
2021-11-15,LU,54,48,2,46,2022-05-03_11-02-08,fp7d
2021-11-15,NE,10,10,0,10,2022-05-03_11-02-08,fp7d
2021-11-15,NW,6,6,0,6,2022-05-03_11-02-08,fp7d
2021-11-15,OW,0,0,0,0,2022-05-03_11-02-08,fp7d
2021-11-15,SG,54,40,1,39,2022-05-03_11-02-08,fp7d
2021-11-15,SH,8,7,0,7,2022-05-03_11-02-08,fp7d
2021-11-15,SO,17,17,0,17,2022-05-03_11-02-08,fp7d
2021-11-15,SZ,12,12,0,12,2022-05-03_11-02-08,fp7d
2021-11-15,TG,21,28,7,21,2022-05-03_11-02-08,fp7d
2021-11-15,TI,53,58,5,53,2022-05-03_11-02-08,fp7d
2021-11-15,UR,6,6,0,6,2022-05-03_11-02-08,fp7d
2021-11-15,VD,85,86,1,85,2022-05-03_11-02-08,fp7d
2021-11-15,VS,21,21,0,21,2022-05-03_11-02-08,fp7d
2021-11-15,ZG,8,8,0,8,2022-05-03_11-02-08,fp7d
2021-11-15,ZH,190,179,7,172,2022-05-03_11-02-08,fp7d
2021-11-16,AG,52,46,1,45,2022-05-03_11-02-08,fp7d
2021-11-16,AI,0,0,0,0,2022-05-03_11-02-08,fp7d
2021-11-16,AR,6,6,0,6,2022-05-03_11-02-08,fp7d
2021-11-16,BE,104,94,4,90,2022-05-03_11-02-08,fp7d
2021-11-16,BL,20,15,0,15,2022-05-03_11-02-08,fp7d
2021-11-16,BS,54,50,0,50,2022-05-03_11-02-08,fp7d
2021-11-16,FR,24,23,0,23,2022-05-03_11-02-08,fp7d
2021-11-16,GE,38,56,18,38,2022-05-03_11-02-08,fp7d
2021-11-16,GL,6,6,0,6,2022-05-03_11-02-08,fp7d
2021-11-16,GR,16,16,0,16,2022-05-03_11-02-08,fp7d
2021-11-16,JU,6,6,0,6,2022-05-03_11-02-08,fp7d
2021-11-16,LU,54,49,2,47,2022-05-03_11-02-08,fp7d
2021-11-16,NE,10,10,0,10,2022-05-03_11-02-08,fp7d
2021-11-16,NW,6,6,0,6,2022-05-03_11-02-08,fp7d
2021-11-16,OW,0,0,0,0,2022-05-03_11-02-08,fp7d
2021-11-16,SG,54,40,1,39,2022-05-03_11-02-08,fp7d
2021-11-16,SH,8,7,0,7,2022-05-03_11-02-08,fp7d
2021-11-16,SO,17,17,0,17,2022-05-03_11-02-08,fp7d
2021-11-16,SZ,12,12,0,12,2022-05-03_11-02-08,fp7d
2021-11-16,TG,21,28,7,21,2022-05-03_11-02-08,fp7d
2021-11-16,TI,53,58,5,53,2022-05-03_11-02-08,fp7d
2021-11-16,UR,6,6,0,6,2022-05-03_11-02-08,fp7d
2021-11-16,VD,85,86,1,85,2022-05-03_11-02-08,fp7d
2021-11-16,VS,21,21,0,21,2022-05-03_11-02-08,fp7d
2021-11-16,ZG,8,8,0,8,2022-05-03_11-02-08,fp7d
2021-11-16,ZH,190,181,7,174,2022-05-03_11-02-08,fp7d
2021-11-17,AG,52,47,1,46,2022-05-03_11-02-08,fp7d
2021-11-17,AI,0,0,0,0,2022-05-03_11-02-08,fp7d
2021-11-17,AR,6,6,0,6,2022-05-03_11-02-08,fp7d
2021-11-17,BE,104,94,4,90,2022-05-03_11-02-08,fp7d
2021-11-17,BL,20,15,0,15,2022-05-03_11-02-08,fp7d
2021-11-17,BS,54,50,0,50,2022-05-03_11-02-08,fp7d
2021-11-17,FR,24,23,0,23,2022-05-03_11-02-08,fp7d
2021-11-17,GE,38,56,18,38,2022-05-03_11-02-08,fp7d
2021-11-17,GL,6,6,0,6,2022-05-03_11-02-08,fp7d
2021-11-17,GR,16,16,0,16,2022-05-03_11-02-08,fp7d
2021-11-17,JU,6,6,0,6,2022-05-03_11-02-08,fp7d
2021-11-17,LU,54,49,2,47,2022-05-03_11-02-08,fp7d
2021-11-17,NE,10,10,0,10,2022-05-03_11-02-08,fp7d
2021-11-17,NW,6,5,0,5,2022-05-03_11-02-08,fp7d
2021-11-17,OW,0,0,0,0,2022-05-03_11-02-08,fp7d
2021-11-17,SG,54,40,1,39,2022-05-03_11-02-08,fp7d
2021-11-17,SH,8,7,0,7,2022-05-03_11-02-08,fp7d
2021-11-17,SO,17,17,0,17,2022-05-03_11-02-08,fp7d
2021-11-17,SZ,12,11,0,11,2022-05-03_11-02-08,fp7d
2021-11-17,TG,21,28,7,21,2022-05-03_11-02-08,fp7d
2021-11-17,TI,53,58,5,53,2022-05-03_11-02-08,fp7d
2021-11-17,UR,6,6,0,6,2022-05-03_11-02-08,fp7d
2021-11-17,VD,85,86,1,85,2022-05-03_11-02-08,fp7d
2021-11-17,VS,21,21,0,21,2022-05-03_11-02-08,fp7d
2021-11-17,ZG,8,8,0,8,2022-05-03_11-02-08,fp7d
2021-11-17,ZH,190,183,7,176,2022-05-03_11-02-08,fp7d
2021-11-18,AG,52,47,1,46,2022-05-03_11-02-08,fp7d
2021-11-18,AI,0,0,0,0,2022-05-03_11-02-08,fp7d
2021-11-18,AR,6,6,0,6,2022-05-03_11-02-08,fp7d
2021-11-18,BE,104,92,4,88,2022-05-03_11-02-08,fp7d
2021-11-18,BL,20,15,0,15,2022-05-03_11-02-08,fp7d
2021-11-18,BS,54,50,0,50,2022-05-03_11-02-08,fp7d
2021-11-18,FR,24,23,0,23,2022-05-03_11-02-08,fp7d
2021-11-18,GE,38,56,18,38,2022-05-03_11-02-08,fp7d
2021-11-18,GL,6,6,0,6,2022-05-03_11-02-08,fp7d
2021-11-18,GR,16,16,0,16,2022-05-03_11-02-08,fp7d
2021-11-18,JU,6,6,0,6,2022-05-03_11-02-08,fp7d
2021-11-18,LU,54,49,2,47,2022-05-03_11-02-08,fp7d
2021-11-18,NE,10,10,0,10,2022-05-03_11-02-08,fp7d
2021-11-18,NW,6,5,0,5,2022-05-03_11-02-08,fp7d
2021-11-18,OW,0,0,0,0,2022-05-03_11-02-08,fp7d
2021-11-18,SG,54,40,1,39,2022-05-03_11-02-08,fp7d
2021-11-18,SH,8,7,0,7,2022-05-03_11-02-08,fp7d
2021-11-18,SO,17,17,0,17,2022-05-03_11-02-08,fp7d
2021-11-18,SZ,12,12,0,12,2022-05-03_11-02-08,fp7d
2021-11-18,TG,21,28,7,21,2022-05-03_11-02-08,fp7d
2021-11-18,TI,54,58,4,54,2022-05-03_11-02-08,fp7d
2021-11-18,UR,6,6,0,6,2022-05-03_11-02-08,fp7d
2021-11-18,VD,85,86,1,85,2022-05-03_11-02-08,fp7d
2021-11-18,VS,21,21,0,21,2022-05-03_11-02-08,fp7d
2021-11-18,ZG,8,8,0,8,2022-05-03_11-02-08,fp7d
2021-11-18,ZH,190,185,7,178,2022-05-03_11-02-08,fp7d
2021-11-19,AG,52,47,1,46,2022-05-03_11-02-08,fp7d
2021-11-19,AI,0,0,0,0,2022-05-03_11-02-08,fp7d
2021-11-19,AR,6,6,0,6,2022-05-03_11-02-08,fp7d
2021-11-19,BE,104,90,4,86,2022-05-03_11-02-08,fp7d
2021-11-19,BL,20,15,0,15,2022-05-03_11-02-08,fp7d
2021-11-19,BS,54,50,0,50,2022-05-03_11-02-08,fp7d
2021-11-19,FR,24,23,0,23,2022-05-03_11-02-08,fp7d
2021-11-19,GE,38,56,18,38,2022-05-03_11-02-08,fp7d
2021-11-19,GL,6,6,0,6,2022-05-03_11-02-08,fp7d
2021-11-19,GR,16,16,0,16,2022-05-03_11-02-08,fp7d
2021-11-19,JU,6,6,0,6,2022-05-03_11-02-08,fp7d
2021-11-19,LU,54,49,2,47,2022-05-03_11-02-08,fp7d
2021-11-19,NE,10,10,0,10,2022-05-03_11-02-08,fp7d
2021-11-19,NW,6,5,0,5,2022-05-03_11-02-08,fp7d
2021-11-19,OW,0,0,0,0,2022-05-03_11-02-08,fp7d
2021-11-19,SG,54,40,1,39,2022-05-03_11-02-08,fp7d
2021-11-19,SH,8,7,0,7,2022-05-03_11-02-08,fp7d
2021-11-19,SO,17,17,0,17,2022-05-03_11-02-08,fp7d
2021-11-19,SZ,12,12,0,12,2022-05-03_11-02-08,fp7d
2021-11-19,TG,21,28,7,21,2022-05-03_11-02-08,fp7d
2021-11-19,TI,54,58,4,54,2022-05-03_11-02-08,fp7d
2021-11-19,UR,6,6,0,6,2022-05-03_11-02-08,fp7d
2021-11-19,VD,85,86,1,85,2022-05-03_11-02-08,fp7d
2021-11-19,VS,21,21,0,21,2022-05-03_11-02-08,fp7d
2021-11-19,ZG,8,8,0,8,2022-05-03_11-02-08,fp7d
2021-11-19,ZH,190,183,7,176,2022-05-03_11-02-08,fp7d
2021-11-20,AG,52,47,1,46,2022-05-03_11-02-08,fp7d
2021-11-20,AI,0,0,0,0,2022-05-03_11-02-08,fp7d
2021-11-20,AR,6,6,0,6,2022-05-03_11-02-08,fp7d
2021-11-20,BE,104,88,4,84,2022-05-03_11-02-08,fp7d
2021-11-20,BL,20,15,0,15,2022-05-03_11-02-08,fp7d
2021-11-20,BS,54,46,0,46,2022-05-03_11-02-08,fp7d
2021-11-20,FR,24,23,0,23,2022-05-03_11-02-08,fp7d
2021-11-20,GE,38,56,18,38,2022-05-03_11-02-08,fp7d
2021-11-20,GL,6,6,0,6,2022-05-03_11-02-08,fp7d
2021-11-20,GR,16,16,0,16,2022-05-03_11-02-08,fp7d
2021-11-20,JU,6,6,0,6,2022-05-03_11-02-08,fp7d
2021-11-20,LU,54,47,0,47,2022-05-03_11-02-08,fp7d
2021-11-20,NE,10,10,0,10,2022-05-03_11-02-08,fp7d
2021-11-20,NW,6,5,0,5,2022-05-03_11-02-08,fp7d
2021-11-20,OW,0,0,0,0,2022-05-03_11-02-08,fp7d
2021-11-20,SG,54,40,1,39,2022-05-03_11-02-08,fp7d
2021-11-20,SH,8,7,0,7,2022-05-03_11-02-08,fp7d
2021-11-20,SO,17,17,0,17,2022-05-03_11-02-08,fp7d
2021-11-20,SZ,12,11,0,11,2022-05-03_11-02-08,fp7d
2021-11-20,TG,21,28,7,21,2022-05-03_11-02-08,fp7d
2021-11-20,TI,54,58,4,54,2022-05-03_11-02-08,fp7d
2021-11-20,UR,6,6,0,6,2022-05-03_11-02-08,fp7d
2021-11-20,VD,85,86,1,85,2022-05-03_11-02-08,fp7d
2021-11-20,VS,21,21,0,21,2022-05-03_11-02-08,fp7d
2021-11-20,ZG,8,8,0,8,2022-05-03_11-02-08,fp7d
2021-11-20,ZH,190,183,7,176,2022-05-03_11-02-08,fp7d
2021-11-21,AG,52,47,1,46,2022-05-03_11-02-08,fp7d
2021-11-21,AI,0,0,0,0,2022-05-03_11-02-08,fp7d
2021-11-21,AR,6,6,0,6,2022-05-03_11-02-08,fp7d
2021-11-21,BE,104,87,4,83,2022-05-03_11-02-08,fp7d
2021-11-21,BL,20,15,0,15,2022-05-03_11-02-08,fp7d
2021-11-21,BS,54,46,0,46,2022-05-03_11-02-08,fp7d
2021-11-21,FR,24,23,0,23,2022-05-03_11-02-08,fp7d
2021-11-21,GE,38,56,18,38,2022-05-03_11-02-08,fp7d
2021-11-21,GL,6,6,0,6,2022-05-03_11-02-08,fp7d
2021-11-21,GR,16,16,0,16,2022-05-03_11-02-08,fp7d
2021-11-21,JU,6,6,0,6,2022-05-03_11-02-08,fp7d
2021-11-21,LU,54,47,0,47,2022-05-03_11-02-08,fp7d
2021-11-21,NE,10,10,0,10,2022-05-03_11-02-08,fp7d
2021-11-21,NW,6,6,0,6,2022-05-03_11-02-08,fp7d
2021-11-21,OW,0,0,0,0,2022-05-03_11-02-08,fp7d
2021-11-21,SG,54,40,1,39,2022-05-03_11-02-08,fp7d
2021-11-21,SH,8,7,0,7,2022-05-03_11-02-08,fp7d
2021-11-21,SO,17,17,0,17,2022-05-03_11-02-08,fp7d
2021-11-21,SZ,12,11,0,11,2022-05-03_11-02-08,fp7d
2021-11-21,TG,21,28,7,21,2022-05-03_11-02-08,fp7d
2021-11-21,TI,54,58,4,54,2022-05-03_11-02-08,fp7d
2021-11-21,UR,6,6,0,6,2022-05-03_11-02-08,fp7d
2021-11-21,VD,85,86,1,85,2022-05-03_11-02-08,fp7d
2021-11-21,VS,21,21,0,21,2022-05-03_11-02-08,fp7d
2021-11-21,ZG,8,8,0,8,2022-05-03_11-02-08,fp7d
2021-11-21,ZH,190,184,6,178,2022-05-03_11-02-08,fp7d
2021-11-22,AG,52,47,1,46,2022-05-03_11-02-08,fp7d
2021-11-22,AI,0,0,0,0,2022-05-03_11-02-08,fp7d
2021-11-22,AR,6,6,0,6,2022-05-03_11-02-08,fp7d
2021-11-22,BE,104,91,5,86,2022-05-03_11-02-08,fp7d
2021-11-22,BL,20,15,0,15,2022-05-03_11-02-08,fp7d
2021-11-22,BS,54,50,0,50,2022-05-03_11-02-08,fp7d
2021-11-22,FR,24,23,0,23,2022-05-03_11-02-08,fp7d
2021-11-22,GE,38,56,18,38,2022-05-03_11-02-08,fp7d
2021-11-22,GL,6,6,0,6,2022-05-03_11-02-08,fp7d
2021-11-22,GR,16,16,0,16,2022-05-03_11-02-08,fp7d
2021-11-22,JU,6,6,0,6,2022-05-03_11-02-08,fp7d
2021-11-22,LU,54,47,0,47,2022-05-03_11-02-08,fp7d
2021-11-22,NE,10,10,0,10,2022-05-03_11-02-08,fp7d
2021-11-22,NW,6,6,0,6,2022-05-03_11-02-08,fp7d
2021-11-22,OW,0,0,0,0,2022-05-03_11-02-08,fp7d
2021-11-22,SG,54,40,1,39,2022-05-03_11-02-08,fp7d
2021-11-22,SH,8,7,0,7,2022-05-03_11-02-08,fp7d
2021-11-22,SO,17,17,0,17,2022-05-03_11-02-08,fp7d
2021-11-22,SZ,12,12,0,12,2022-05-03_11-02-08,fp7d
2021-11-22,TG,21,28,7,21,2022-05-03_11-02-08,fp7d
2021-11-22,TI,54,58,4,54,2022-05-03_11-02-08,fp7d
2021-11-22,UR,6,6,0,6,2022-05-03_11-02-08,fp7d
2021-11-22,VD,85,86,1,85,2022-05-03_11-02-08,fp7d
2021-11-22,VS,21,21,0,21,2022-05-03_11-02-08,fp7d
2021-11-22,ZG,8,8,0,8,2022-05-03_11-02-08,fp7d
2021-11-22,ZH,190,183,6,177,2022-05-03_11-02-08,fp7d
2021-11-23,AG,52,47,1,46,2022-05-03_11-02-08,fp7d
2021-11-23,AI,0,0,0,0,2022-05-03_11-02-08,fp7d
2021-11-23,AR,6,6,0,6,2022-05-03_11-02-08,fp7d
2021-11-23,BE,106,91,3,88,2022-05-03_11-02-08,fp7d
2021-11-23,BL,20,15,0,15,2022-05-03_11-02-08,fp7d
2021-11-23,BS,54,50,0,50,2022-05-03_11-02-08,fp7d
2021-11-23,FR,24,23,0,23,2022-05-03_11-02-08,fp7d
2021-11-23,GE,38,56,18,38,2022-05-03_11-02-08,fp7d
2021-11-23,GL,6,6,0,6,2022-05-03_11-02-08,fp7d
2021-11-23,GR,16,16,0,16,2022-05-03_11-02-08,fp7d
2021-11-23,JU,6,6,0,6,2022-05-03_11-02-08,fp7d
2021-11-23,LU,54,49,2,47,2022-05-03_11-02-08,fp7d
2021-11-23,NE,10,10,0,10,2022-05-03_11-02-08,fp7d
2021-11-23,NW,6,6,0,6,2022-05-03_11-02-08,fp7d
2021-11-23,OW,0,0,0,0,2022-05-03_11-02-08,fp7d
2021-11-23,SG,54,40,1,39,2022-05-03_11-02-08,fp7d
2021-11-23,SH,8,7,0,7,2022-05-03_11-02-08,fp7d
2021-11-23,SO,17,17,0,17,2022-05-03_11-02-08,fp7d
2021-11-23,SZ,12,12,0,12,2022-05-03_11-02-08,fp7d
2021-11-23,TG,21,28,7,21,2022-05-03_11-02-08,fp7d
2021-11-23,TI,54,58,4,54,2022-05-03_11-02-08,fp7d
2021-11-23,UR,6,6,0,6,2022-05-03_11-02-08,fp7d
2021-11-23,VD,85,86,1,85,2022-05-03_11-02-08,fp7d
2021-11-23,VS,21,21,0,21,2022-05-03_11-02-08,fp7d
2021-11-23,ZG,8,8,0,8,2022-05-03_11-02-08,fp7d
2021-11-23,ZH,190,185,9,176,2022-05-03_11-02-08,fp7d
2021-11-24,AG,52,47,1,46,2022-05-03_11-02-08,fp7d
2021-11-24,AI,0,0,0,0,2022-05-03_11-02-08,fp7d
2021-11-24,AR,6,6,0,6,2022-05-03_11-02-08,fp7d
2021-11-24,BE,106,93,3,90,2022-05-03_11-02-08,fp7d
2021-11-24,BL,20,15,0,15,2022-05-03_11-02-08,fp7d
2021-11-24,BS,54,50,0,50,2022-05-03_11-02-08,fp7d
2021-11-24,FR,24,23,0,23,2022-05-03_11-02-08,fp7d
2021-11-24,GE,38,56,18,38,2022-05-03_11-02-08,fp7d
2021-11-24,GL,6,6,0,6,2022-05-03_11-02-08,fp7d
2021-11-24,GR,16,16,0,16,2022-05-03_11-02-08,fp7d
2021-11-24,JU,6,6,0,6,2022-05-03_11-02-08,fp7d
2021-11-24,LU,54,49,2,47,2022-05-03_11-02-08,fp7d
2021-11-24,NE,10,10,0,10,2022-05-03_11-02-08,fp7d
2021-11-24,NW,6,6,0,6,2022-05-03_11-02-08,fp7d
2021-11-24,OW,0,0,0,0,2022-05-03_11-02-08,fp7d
2021-11-24,SG,54,40,1,39,2022-05-03_11-02-08,fp7d
2021-11-24,SH,8,7,0,7,2022-05-03_11-02-08,fp7d
2021-11-24,SO,17,17,0,17,2022-05-03_11-02-08,fp7d
2021-11-24,SZ,12,12,0,12,2022-05-03_11-02-08,fp7d
2021-11-24,TG,21,28,7,21,2022-05-03_11-02-08,fp7d
2021-11-24,TI,54,58,4,54,2022-05-03_11-02-08,fp7d
2021-11-24,UR,6,6,0,6,2022-05-03_11-02-08,fp7d
2021-11-24,VD,85,86,1,85,2022-05-03_11-02-08,fp7d
2021-11-24,VS,21,21,0,21,2022-05-03_11-02-08,fp7d
2021-11-24,ZG,8,8,0,8,2022-05-03_11-02-08,fp7d
2021-11-24,ZH,190,184,7,177,2022-05-03_11-02-08,fp7d
2021-11-25,AG,52,47,1,46,2022-05-03_11-02-08,fp7d
2021-11-25,AI,0,0,0,0,2022-05-03_11-02-08,fp7d
2021-11-25,AR,6,6,0,6,2022-05-03_11-02-08,fp7d
2021-11-25,BE,106,92,2,90,2022-05-03_11-02-08,fp7d
2021-11-25,BL,20,15,0,15,2022-05-03_11-02-08,fp7d
2021-11-25,BS,54,50,0,50,2022-05-03_11-02-08,fp7d
2021-11-25,FR,24,23,0,23,2022-05-03_11-02-08,fp7d
2021-11-25,GE,38,56,18,38,2022-05-03_11-02-08,fp7d
2021-11-25,GL,6,6,0,6,2022-05-03_11-02-08,fp7d
2021-11-25,GR,16,16,0,16,2022-05-03_11-02-08,fp7d
2021-11-25,JU,6,6,0,6,2022-05-03_11-02-08,fp7d
2021-11-25,LU,54,49,2,47,2022-05-03_11-02-08,fp7d
2021-11-25,NE,10,10,0,10,2022-05-03_11-02-08,fp7d
2021-11-25,NW,6,5,0,5,2022-05-03_11-02-08,fp7d
2021-11-25,OW,0,0,0,0,2022-05-03_11-02-08,fp7d
2021-11-25,SG,54,40,1,39,2022-05-03_11-02-08,fp7d
2021-11-25,SH,8,7,0,7,2022-05-03_11-02-08,fp7d
2021-11-25,SO,17,17,0,17,2022-05-03_11-02-08,fp7d
2021-11-25,SZ,12,11,0,11,2022-05-03_11-02-08,fp7d
2021-11-25,TG,21,27,6,21,2022-05-03_11-02-08,fp7d
2021-11-25,TI,54,58,4,54,2022-05-03_11-02-08,fp7d
2021-11-25,UR,6,6,0,6,2022-05-03_11-02-08,fp7d
2021-11-25,VD,85,86,1,85,2022-05-03_11-02-08,fp7d
2021-11-25,VS,21,21,0,21,2022-05-03_11-02-08,fp7d
2021-11-25,ZG,8,8,0,8,2022-05-03_11-02-08,fp7d
2021-11-25,ZH,190,184,7,177,2022-05-03_11-02-08,fp7d
2021-11-26,AG,52,47,1,46,2022-05-03_11-02-08,fp7d
2021-11-26,AI,0,0,0,0,2022-05-03_11-02-08,fp7d
2021-11-26,AR,6,6,0,6,2022-05-03_11-02-08,fp7d
2021-11-26,BE,106,93,3,90,2022-05-03_11-02-08,fp7d
2021-11-26,BL,20,15,0,15,2022-05-03_11-02-08,fp7d
2021-11-26,BS,54,50,0,50,2022-05-03_11-02-08,fp7d
2021-11-26,FR,24,23,0,23,2022-05-03_11-02-08,fp7d
2021-11-26,GE,38,56,18,38,2022-05-03_11-02-08,fp7d
2021-11-26,GL,6,6,0,6,2022-05-03_11-02-08,fp7d
2021-11-26,GR,16,16,0,16,2022-05-03_11-02-08,fp7d
2021-11-26,JU,6,6,0,6,2022-05-03_11-02-08,fp7d
2021-11-26,LU,54,49,2,47,2022-05-03_11-02-08,fp7d
2021-11-26,NE,10,10,0,10,2022-05-03_11-02-08,fp7d
2021-11-26,NW,6,5,0,5,2022-05-03_11-02-08,fp7d
2021-11-26,OW,0,0,0,0,2022-05-03_11-02-08,fp7d
2021-11-26,SG,54,40,1,39,2022-05-03_11-02-08,fp7d
2021-11-26,SH,8,7,0,7,2022-05-03_11-02-08,fp7d
2021-11-26,SO,17,17,0,17,2022-05-03_11-02-08,fp7d
2021-11-26,SZ,12,11,0,11,2022-05-03_11-02-08,fp7d
2021-11-26,TG,21,27,6,21,2022-05-03_11-02-08,fp7d
2021-11-26,TI,54,58,4,54,2022-05-03_11-02-08,fp7d
2021-11-26,UR,6,6,0,6,2022-05-03_11-02-08,fp7d
2021-11-26,VD,85,86,1,85,2022-05-03_11-02-08,fp7d
2021-11-26,VS,21,21,0,21,2022-05-03_11-02-08,fp7d
2021-11-26,ZG,8,8,0,8,2022-05-03_11-02-08,fp7d
2021-11-26,ZH,190,179,6,173,2022-05-03_11-02-08,fp7d
2021-11-27,AG,52,47,1,46,2022-05-03_11-02-08,fp7d
2021-11-27,AI,0,0,0,0,2022-05-03_11-02-08,fp7d
2021-11-27,AR,6,6,0,6,2022-05-03_11-02-08,fp7d
2021-11-27,BE,106,90,3,87,2022-05-03_11-02-08,fp7d
2021-11-27,BL,20,15,0,15,2022-05-03_11-02-08,fp7d
2021-11-27,BS,54,46,0,46,2022-05-03_11-02-08,fp7d
2021-11-27,FR,24,23,0,23,2022-05-03_11-02-08,fp7d
2021-11-27,GE,38,56,18,38,2022-05-03_11-02-08,fp7d
2021-11-27,GL,6,6,0,6,2022-05-03_11-02-08,fp7d
2021-11-27,GR,16,16,0,16,2022-05-03_11-02-08,fp7d
2021-11-27,JU,6,6,0,6,2022-05-03_11-02-08,fp7d
2021-11-27,LU,54,47,0,47,2022-05-03_11-02-08,fp7d
2021-11-27,NE,10,10,0,10,2022-05-03_11-02-08,fp7d
2021-11-27,NW,6,5,0,5,2022-05-03_11-02-08,fp7d
2021-11-27,OW,0,0,0,0,2022-05-03_11-02-08,fp7d
2021-11-27,SG,54,40,1,39,2022-05-03_11-02-08,fp7d
2021-11-27,SH,8,7,0,7,2022-05-03_11-02-08,fp7d
2021-11-27,SO,17,17,0,17,2022-05-03_11-02-08,fp7d
2021-11-27,SZ,12,11,0,11,2022-05-03_11-02-08,fp7d
2021-11-27,TG,21,27,6,21,2022-05-03_11-02-08,fp7d
2021-11-27,TI,54,58,4,54,2022-05-03_11-02-08,fp7d
2021-11-27,UR,6,6,0,6,2022-05-03_11-02-08,fp7d
2021-11-27,VD,85,86,1,85,2022-05-03_11-02-08,fp7d
2021-11-27,VS,21,21,0,21,2022-05-03_11-02-08,fp7d
2021-11-27,ZG,8,8,0,8,2022-05-03_11-02-08,fp7d
2021-11-27,ZH,190,181,9,172,2022-05-03_11-02-08,fp7d
2021-11-28,AG,52,47,1,46,2022-05-03_11-02-08,fp7d
2021-11-28,AI,0,0,0,0,2022-05-03_11-02-08,fp7d
2021-11-28,AR,6,6,0,6,2022-05-03_11-02-08,fp7d
2021-11-28,BE,106,89,2,87,2022-05-03_11-02-08,fp7d
2021-11-28,BL,20,15,0,15,2022-05-03_11-02-08,fp7d
2021-11-28,BS,54,46,0,46,2022-05-03_11-02-08,fp7d
2021-11-28,FR,24,23,0,23,2022-05-03_11-02-08,fp7d
2021-11-28,GE,38,56,18,38,2022-05-03_11-02-08,fp7d
2021-11-28,GL,6,6,0,6,2022-05-03_11-02-08,fp7d
2021-11-28,GR,16,16,0,16,2022-05-03_11-02-08,fp7d
2021-11-28,JU,6,6,0,6,2022-05-03_11-02-08,fp7d
2021-11-28,LU,54,47,0,47,2022-05-03_11-02-08,fp7d
2021-11-28,NE,10,10,0,10,2022-05-03_11-02-08,fp7d
2021-11-28,NW,6,5,0,5,2022-05-03_11-02-08,fp7d
2021-11-28,OW,0,0,0,0,2022-05-03_11-02-08,fp7d
2021-11-28,SG,54,40,1,39,2022-05-03_11-02-08,fp7d
2021-11-28,SH,8,7,0,7,2022-05-03_11-02-08,fp7d
2021-11-28,SO,17,17,0,17,2022-05-03_11-02-08,fp7d
2021-11-28,SZ,12,11,0,11,2022-05-03_11-02-08,fp7d
2021-11-28,TG,21,27,6,21,2022-05-03_11-02-08,fp7d
2021-11-28,TI,54,58,4,54,2022-05-03_11-02-08,fp7d
2021-11-28,UR,6,6,0,6,2022-05-03_11-02-08,fp7d
2021-11-28,VD,85,86,1,85,2022-05-03_11-02-08,fp7d
2021-11-28,VS,21,21,0,21,2022-05-03_11-02-08,fp7d
2021-11-28,ZG,8,8,0,8,2022-05-03_11-02-08,fp7d
2021-11-28,ZH,190,179,7,172,2022-05-03_11-02-08,fp7d
2021-11-29,AG,52,47,1,46,2022-05-03_11-02-08,fp7d
2021-11-29,AI,0,0,0,0,2022-05-03_11-02-08,fp7d
2021-11-29,AR,6,6,0,6,2022-05-03_11-02-08,fp7d
2021-11-29,BE,106,89,2,87,2022-05-03_11-02-08,fp7d
2021-11-29,BL,20,15,0,15,2022-05-03_11-02-08,fp7d
2021-11-29,BS,54,50,0,50,2022-05-03_11-02-08,fp7d
2021-11-29,FR,24,23,0,23,2022-05-03_11-02-08,fp7d
2021-11-29,GE,38,56,18,38,2022-05-03_11-02-08,fp7d
2021-11-29,GL,6,6,0,6,2022-05-03_11-02-08,fp7d
2021-11-29,GR,16,16,0,16,2022-05-03_11-02-08,fp7d
2021-11-29,JU,6,6,0,6,2022-05-03_11-02-08,fp7d
2021-11-29,LU,54,47,0,47,2022-05-03_11-02-08,fp7d
2021-11-29,NE,10,10,0,10,2022-05-03_11-02-08,fp7d
2021-11-29,NW,6,5,0,5,2022-05-03_11-02-08,fp7d
2021-11-29,OW,0,0,0,0,2022-05-03_11-02-08,fp7d
2021-11-29,SG,54,40,1,39,2022-05-03_11-02-08,fp7d
2021-11-29,SH,8,7,0,7,2022-05-03_11-02-08,fp7d
2021-11-29,SO,17,17,0,17,2022-05-03_11-02-08,fp7d
2021-11-29,SZ,12,11,0,11,2022-05-03_11-02-08,fp7d
2021-11-29,TG,21,27,6,21,2022-05-03_11-02-08,fp7d
2021-11-29,TI,54,58,4,54,2022-05-03_11-02-08,fp7d
2021-11-29,UR,6,6,0,6,2022-05-03_11-02-08,fp7d
2021-11-29,VD,85,86,1,85,2022-05-03_11-02-08,fp7d
2021-11-29,VS,21,21,0,21,2022-05-03_11-02-08,fp7d
2021-11-29,ZG,8,8,0,8,2022-05-03_11-02-08,fp7d
2021-11-29,ZH,190,179,7,172,2022-05-03_11-02-08,fp7d
2021-11-30,AG,52,48,1,47,2022-05-03_11-02-08,fp7d
2021-11-30,AI,0,0,0,0,2022-05-03_11-02-08,fp7d
2021-11-30,AR,6,6,0,6,2022-05-03_11-02-08,fp7d
2021-11-30,BE,106,91,2,89,2022-05-03_11-02-08,fp7d
2021-11-30,BL,20,17,1,16,2022-05-03_11-02-08,fp7d
2021-11-30,BS,54,50,0,50,2022-05-03_11-02-08,fp7d
2021-11-30,FR,24,23,0,23,2022-05-03_11-02-08,fp7d
2021-11-30,GE,38,56,18,38,2022-05-03_11-02-08,fp7d
2021-11-30,GL,6,6,0,6,2022-05-03_11-02-08,fp7d
2021-11-30,GR,16,16,0,16,2022-05-03_11-02-08,fp7d
2021-11-30,JU,6,6,0,6,2022-05-03_11-02-08,fp7d
2021-11-30,LU,54,49,2,47,2022-05-03_11-02-08,fp7d
2021-11-30,NE,10,10,0,10,2022-05-03_11-02-08,fp7d
2021-11-30,NW,6,5,0,5,2022-05-03_11-02-08,fp7d
2021-11-30,OW,0,0,0,0,2022-05-03_11-02-08,fp7d
2021-11-30,SG,54,40,1,39,2022-05-03_11-02-08,fp7d
2021-11-30,SH,8,7,0,7,2022-05-03_11-02-08,fp7d
2021-11-30,SO,17,17,0,17,2022-05-03_11-02-08,fp7d
2021-11-30,SZ,12,11,0,11,2022-05-03_11-02-08,fp7d
2021-11-30,TG,21,27,6,21,2022-05-03_11-02-08,fp7d
2021-11-30,TI,54,58,4,54,2022-05-03_11-02-08,fp7d
2021-11-30,UR,6,6,0,6,2022-05-03_11-02-08,fp7d
2021-11-30,VD,85,86,1,85,2022-05-03_11-02-08,fp7d
2021-11-30,VS,21,21,0,21,2022-05-03_11-02-08,fp7d
2021-11-30,ZG,8,8,0,8,2022-05-03_11-02-08,fp7d
2021-11-30,ZH,190,183,7,176,2022-05-03_11-02-08,fp7d
2021-12-01,AG,52,47,1,46,2022-05-03_11-02-08,fp7d
2021-12-01,AI,0,0,0,0,2022-05-03_11-02-08,fp7d
2021-12-01,AR,6,6,0,6,2022-05-03_11-02-08,fp7d
2021-12-01,BE,106,89,3,86,2022-05-03_11-02-08,fp7d
2021-12-01,BL,20,17,1,16,2022-05-03_11-02-08,fp7d
2021-12-01,BS,54,50,0,50,2022-05-03_11-02-08,fp7d
2021-12-01,FR,24,23,0,23,2022-05-03_11-02-08,fp7d
2021-12-01,GE,38,56,18,38,2022-05-03_11-02-08,fp7d
2021-12-01,GL,6,6,0,6,2022-05-03_11-02-08,fp7d
2021-12-01,GR,16,15,0,15,2022-05-03_11-02-08,fp7d
2021-12-01,JU,6,6,0,6,2022-05-03_11-02-08,fp7d
2021-12-01,LU,54,49,2,47,2022-05-03_11-02-08,fp7d
2021-12-01,NE,10,10,0,10,2022-05-03_11-02-08,fp7d
2021-12-01,NW,5,5,0,5,2022-05-03_11-02-08,fp7d
2021-12-01,OW,0,0,0,0,2022-05-03_11-02-08,fp7d
2021-12-01,SG,54,40,1,39,2022-05-03_11-02-08,fp7d
2021-12-01,SH,8,7,0,7,2022-05-03_11-02-08,fp7d
2021-12-01,SO,17,17,0,17,2022-05-03_11-02-08,fp7d
2021-12-01,SZ,12,11,0,11,2022-05-03_11-02-08,fp7d
2021-12-01,TG,21,27,6,21,2022-05-03_11-02-08,fp7d
2021-12-01,TI,55,58,3,55,2022-05-03_11-02-08,fp7d
2021-12-01,UR,6,6,0,6,2022-05-03_11-02-08,fp7d
2021-12-01,VD,85,86,1,85,2022-05-03_11-02-08,fp7d
2021-12-01,VS,21,21,0,21,2022-05-03_11-02-08,fp7d
2021-12-01,ZG,8,8,0,8,2022-05-03_11-02-08,fp7d
2021-12-01,ZH,190,183,7,176,2022-05-03_11-02-08,fp7d
2021-12-02,AG,52,47,1,46,2022-05-03_11-02-08,fp7d
2021-12-02,AI,0,0,0,0,2022-05-03_11-02-08,fp7d
2021-12-02,AR,6,6,0,6,2022-05-03_11-02-08,fp7d
2021-12-02,BE,106,90,3,87,2022-05-03_11-02-08,fp7d
2021-12-02,BL,20,17,1,16,2022-05-03_11-02-08,fp7d
2021-12-02,BS,54,50,0,50,2022-05-03_11-02-08,fp7d
2021-12-02,FR,24,23,0,23,2022-05-03_11-02-08,fp7d
2021-12-02,GE,38,56,18,38,2022-05-03_11-02-08,fp7d
2021-12-02,GL,6,6,0,6,2022-05-03_11-02-08,fp7d
2021-12-02,GR,16,15,0,15,2022-05-03_11-02-08,fp7d
2021-12-02,JU,6,6,0,6,2022-05-03_11-02-08,fp7d
2021-12-02,LU,54,49,2,47,2022-05-03_11-02-08,fp7d
2021-12-02,NE,10,10,0,10,2022-05-03_11-02-08,fp7d
2021-12-02,NW,5,5,0,5,2022-05-03_11-02-08,fp7d
2021-12-02,OW,0,0,0,0,2022-05-03_11-02-08,fp7d
2021-12-02,SG,54,40,1,39,2022-05-03_11-02-08,fp7d
2021-12-02,SH,8,7,0,7,2022-05-03_11-02-08,fp7d
2021-12-02,SO,17,17,0,17,2022-05-03_11-02-08,fp7d
2021-12-02,SZ,12,11,0,11,2022-05-03_11-02-08,fp7d
2021-12-02,TG,21,27,6,21,2022-05-03_11-02-08,fp7d
2021-12-02,TI,55,58,3,55,2022-05-03_11-02-08,fp7d
2021-12-02,UR,6,6,0,6,2022-05-03_11-02-08,fp7d
2021-12-02,VD,85,86,1,85,2022-05-03_11-02-08,fp7d
2021-12-02,VS,21,21,0,21,2022-05-03_11-02-08,fp7d
2021-12-02,ZG,8,8,0,8,2022-05-03_11-02-08,fp7d
2021-12-02,ZH,190,183,7,176,2022-05-03_11-02-08,fp7d
2021-12-03,AG,50,47,3,44,2022-05-03_11-02-08,fp7d
2021-12-03,AI,0,0,0,0,2022-05-03_11-02-08,fp7d
2021-12-03,AR,6,6,0,6,2022-05-03_11-02-08,fp7d
2021-12-03,BE,106,90,3,87,2022-05-03_11-02-08,fp7d
2021-12-03,BL,20,16,0,16,2022-05-03_11-02-08,fp7d
2021-12-03,BS,54,50,0,50,2022-05-03_11-02-08,fp7d
2021-12-03,FR,24,23,0,23,2022-05-03_11-02-08,fp7d
2021-12-03,GE,38,56,18,38,2022-05-03_11-02-08,fp7d
2021-12-03,GL,6,6,0,6,2022-05-03_11-02-08,fp7d
2021-12-03,GR,16,16,0,16,2022-05-03_11-02-08,fp7d
2021-12-03,JU,6,6,0,6,2022-05-03_11-02-08,fp7d
2021-12-03,LU,54,49,2,47,2022-05-03_11-02-08,fp7d
2021-12-03,NE,10,10,0,10,2022-05-03_11-02-08,fp7d
2021-12-03,NW,5,5,0,5,2022-05-03_11-02-08,fp7d
2021-12-03,OW,0,0,0,0,2022-05-03_11-02-08,fp7d
2021-12-03,SG,54,40,1,39,2022-05-03_11-02-08,fp7d
2021-12-03,SH,8,7,0,7,2022-05-03_11-02-08,fp7d
2021-12-03,SO,17,16,0,16,2022-05-03_11-02-08,fp7d
2021-12-03,SZ,12,11,0,11,2022-05-03_11-02-08,fp7d
2021-12-03,TG,21,27,6,21,2022-05-03_11-02-08,fp7d
2021-12-03,TI,55,58,3,55,2022-05-03_11-02-08,fp7d
2021-12-03,UR,6,6,0,6,2022-05-03_11-02-08,fp7d
2021-12-03,VD,85,86,1,85,2022-05-03_11-02-08,fp7d
2021-12-03,VS,21,21,0,21,2022-05-03_11-02-08,fp7d
2021-12-03,ZG,8,8,0,8,2022-05-03_11-02-08,fp7d
2021-12-03,ZH,190,184,7,177,2022-05-03_11-02-08,fp7d
2021-12-04,AG,50,47,3,44,2022-05-03_11-02-08,fp7d
2021-12-04,AI,0,0,0,0,2022-05-03_11-02-08,fp7d
2021-12-04,AR,6,6,0,6,2022-05-03_11-02-08,fp7d
2021-12-04,BE,106,88,3,85,2022-05-03_11-02-08,fp7d
2021-12-04,BL,20,16,0,16,2022-05-03_11-02-08,fp7d
2021-12-04,BS,54,46,0,46,2022-05-03_11-02-08,fp7d
2021-12-04,FR,24,23,0,23,2022-05-03_11-02-08,fp7d
2021-12-04,GE,38,56,18,38,2022-05-03_11-02-08,fp7d
2021-12-04,GL,6,6,0,6,2022-05-03_11-02-08,fp7d
2021-12-04,GR,16,16,0,16,2022-05-03_11-02-08,fp7d
2021-12-04,JU,6,6,0,6,2022-05-03_11-02-08,fp7d
2021-12-04,LU,54,49,2,47,2022-05-03_11-02-08,fp7d
2021-12-04,NE,10,10,0,10,2022-05-03_11-02-08,fp7d
2021-12-04,NW,5,5,0,5,2022-05-03_11-02-08,fp7d
2021-12-04,OW,0,0,0,0,2022-05-03_11-02-08,fp7d
2021-12-04,SG,54,40,1,39,2022-05-03_11-02-08,fp7d
2021-12-04,SH,8,7,0,7,2022-05-03_11-02-08,fp7d
2021-12-04,SO,17,16,0,16,2022-05-03_11-02-08,fp7d
2021-12-04,SZ,12,11,0,11,2022-05-03_11-02-08,fp7d
2021-12-04,TG,21,27,6,21,2022-05-03_11-02-08,fp7d
2021-12-04,TI,55,58,3,55,2022-05-03_11-02-08,fp7d
2021-12-04,UR,6,6,0,6,2022-05-03_11-02-08,fp7d
2021-12-04,VD,85,86,1,85,2022-05-03_11-02-08,fp7d
2021-12-04,VS,21,21,0,21,2022-05-03_11-02-08,fp7d
2021-12-04,ZG,8,8,0,8,2022-05-03_11-02-08,fp7d
2021-12-04,ZH,190,183,7,176,2022-05-03_11-02-08,fp7d
2021-12-05,AG,50,47,3,44,2022-05-03_11-02-08,fp7d
2021-12-05,AI,0,0,0,0,2022-05-03_11-02-08,fp7d
2021-12-05,AR,6,6,0,6,2022-05-03_11-02-08,fp7d
2021-12-05,BE,106,88,3,85,2022-05-03_11-02-08,fp7d
2021-12-05,BL,20,16,0,16,2022-05-03_11-02-08,fp7d
2021-12-05,BS,54,46,0,46,2022-05-03_11-02-08,fp7d
2021-12-05,FR,24,23,0,23,2022-05-03_11-02-08,fp7d
2021-12-05,GE,38,56,18,38,2022-05-03_11-02-08,fp7d
2021-12-05,GL,6,6,0,6,2022-05-03_11-02-08,fp7d
2021-12-05,GR,16,16,0,16,2022-05-03_11-02-08,fp7d
2021-12-05,JU,6,6,0,6,2022-05-03_11-02-08,fp7d
2021-12-05,LU,54,47,0,47,2022-05-03_11-02-08,fp7d
2021-12-05,NE,10,10,0,10,2022-05-03_11-02-08,fp7d
2021-12-05,NW,5,5,0,5,2022-05-03_11-02-08,fp7d
2021-12-05,OW,0,0,0,0,2022-05-03_11-02-08,fp7d
2021-12-05,SG,54,40,1,39,2022-05-03_11-02-08,fp7d
2021-12-05,SH,8,7,0,7,2022-05-03_11-02-08,fp7d
2021-12-05,SO,17,17,0,17,2022-05-03_11-02-08,fp7d
2021-12-05,SZ,12,11,0,11,2022-05-03_11-02-08,fp7d
2021-12-05,TG,21,27,6,21,2022-05-03_11-02-08,fp7d
2021-12-05,TI,55,58,3,55,2022-05-03_11-02-08,fp7d
2021-12-05,UR,6,6,0,6,2022-05-03_11-02-08,fp7d
2021-12-05,VD,85,86,1,85,2022-05-03_11-02-08,fp7d
2021-12-05,VS,21,21,0,21,2022-05-03_11-02-08,fp7d
2021-12-05,ZG,8,8,0,8,2022-05-03_11-02-08,fp7d
2021-12-05,ZH,190,184,7,177,2022-05-03_11-02-08,fp7d
2021-12-06,AG,50,49,3,46,2022-05-03_11-02-08,fp7d
2021-12-06,AI,0,0,0,0,2022-05-03_11-02-08,fp7d
2021-12-06,AR,6,6,0,6,2022-05-03_11-02-08,fp7d
2021-12-06,BE,106,90,3,87,2022-05-03_11-02-08,fp7d
2021-12-06,BL,20,16,0,16,2022-05-03_11-02-08,fp7d
2021-12-06,BS,54,50,0,50,2022-05-03_11-02-08,fp7d
2021-12-06,FR,24,23,0,23,2022-05-03_11-02-08,fp7d
2021-12-06,GE,38,56,18,38,2022-05-03_11-02-08,fp7d
2021-12-06,GL,6,6,0,6,2022-05-03_11-02-08,fp7d
2021-12-06,GR,16,16,0,16,2022-05-03_11-02-08,fp7d
2021-12-06,JU,6,6,0,6,2022-05-03_11-02-08,fp7d
2021-12-06,LU,54,45,0,45,2022-05-03_11-02-08,fp7d
2021-12-06,NE,10,10,0,10,2022-05-03_11-02-08,fp7d
2021-12-06,NW,5,5,0,5,2022-05-03_11-02-08,fp7d
2021-12-06,OW,0,0,0,0,2022-05-03_11-02-08,fp7d
2021-12-06,SG,54,42,1,41,2022-05-03_11-02-08,fp7d
2021-12-06,SH,8,7,0,7,2022-05-03_11-02-08,fp7d
2021-12-06,SO,17,17,0,17,2022-05-03_11-02-08,fp7d
2021-12-06,SZ,12,10,0,10,2022-05-03_11-02-08,fp7d
2021-12-06,TG,21,27,6,21,2022-05-03_11-02-08,fp7d
2021-12-06,TI,55,58,3,55,2022-05-03_11-02-08,fp7d
2021-12-06,UR,6,6,0,6,2022-05-03_11-02-08,fp7d
2021-12-06,VD,85,86,1,85,2022-05-03_11-02-08,fp7d
2021-12-06,VS,21,21,0,21,2022-05-03_11-02-08,fp7d
2021-12-06,ZG,8,8,0,8,2022-05-03_11-02-08,fp7d
2021-12-06,ZH,190,184,7,177,2022-05-03_11-02-08,fp7d
2021-12-07,AG,50,49,3,46,2022-05-03_11-02-08,fp7d
2021-12-07,AI,0,0,0,0,2022-05-03_11-02-08,fp7d
2021-12-07,AR,6,6,0,6,2022-05-03_11-02-08,fp7d
2021-12-07,BE,106,90,3,87,2022-05-03_11-02-08,fp7d
2021-12-07,BL,20,16,0,16,2022-05-03_11-02-08,fp7d
2021-12-07,BS,54,50,0,50,2022-05-03_11-02-08,fp7d
2021-12-07,FR,24,23,0,23,2022-05-03_11-02-08,fp7d
2021-12-07,GE,38,56,18,38,2022-05-03_11-02-08,fp7d
2021-12-07,GL,6,6,0,6,2022-05-03_11-02-08,fp7d
2021-12-07,GR,16,16,0,16,2022-05-03_11-02-08,fp7d
2021-12-07,JU,6,6,0,6,2022-05-03_11-02-08,fp7d
2021-12-07,LU,54,45,0,45,2022-05-03_11-02-08,fp7d
2021-12-07,NE,10,10,0,10,2022-05-03_11-02-08,fp7d
2021-12-07,NW,5,5,0,5,2022-05-03_11-02-08,fp7d
2021-12-07,OW,0,0,0,0,2022-05-03_11-02-08,fp7d
2021-12-07,SG,54,42,1,41,2022-05-03_11-02-08,fp7d
2021-12-07,SH,8,7,0,7,2022-05-03_11-02-08,fp7d
2021-12-07,SO,17,16,0,16,2022-05-03_11-02-08,fp7d
2021-12-07,SZ,12,11,0,11,2022-05-03_11-02-08,fp7d
2021-12-07,TG,21,27,6,21,2022-05-03_11-02-08,fp7d
2021-12-07,TI,55,58,3,55,2022-05-03_11-02-08,fp7d
2021-12-07,UR,6,6,0,6,2022-05-03_11-02-08,fp7d
2021-12-07,VD,85,86,1,85,2022-05-03_11-02-08,fp7d
2021-12-07,VS,21,21,0,21,2022-05-03_11-02-08,fp7d
2021-12-07,ZG,8,8,0,8,2022-05-03_11-02-08,fp7d
2021-12-07,ZH,190,184,7,177,2022-05-03_11-02-08,fp7d
2021-12-08,AG,50,49,3,46,2022-05-03_11-02-08,fp7d
2021-12-08,AI,0,0,0,0,2022-05-03_11-02-08,fp7d
2021-12-08,AR,6,6,0,6,2022-05-03_11-02-08,fp7d
2021-12-08,BE,106,91,4,87,2022-05-03_11-02-08,fp7d
2021-12-08,BL,20,15,0,15,2022-05-03_11-02-08,fp7d
2021-12-08,BS,54,50,0,50,2022-05-03_11-02-08,fp7d
2021-12-08,FR,24,23,0,23,2022-05-03_11-02-08,fp7d
2021-12-08,GE,38,56,18,38,2022-05-03_11-02-08,fp7d
2021-12-08,GL,6,6,0,6,2022-05-03_11-02-08,fp7d
2021-12-08,GR,16,16,0,16,2022-05-03_11-02-08,fp7d
2021-12-08,JU,6,6,0,6,2022-05-03_11-02-08,fp7d
2021-12-08,LU,54,45,0,45,2022-05-03_11-02-08,fp7d
2021-12-08,NE,10,10,0,10,2022-05-03_11-02-08,fp7d
2021-12-08,NW,6,6,0,6,2022-05-03_11-02-08,fp7d
2021-12-08,OW,0,0,0,0,2022-05-03_11-02-08,fp7d
2021-12-08,SG,54,40,1,39,2022-05-03_11-02-08,fp7d
2021-12-08,SH,8,7,0,7,2022-05-03_11-02-08,fp7d
2021-12-08,SO,17,16,0,16,2022-05-03_11-02-08,fp7d
2021-12-08,SZ,12,11,0,11,2022-05-03_11-02-08,fp7d
2021-12-08,TG,21,27,6,21,2022-05-03_11-02-08,fp7d
2021-12-08,TI,55,58,3,55,2022-05-03_11-02-08,fp7d
2021-12-08,UR,6,6,0,6,2022-05-03_11-02-08,fp7d
2021-12-08,VD,85,86,1,85,2022-05-03_11-02-08,fp7d
2021-12-08,VS,21,21,0,21,2022-05-03_11-02-08,fp7d
2021-12-08,ZG,8,8,0,8,2022-05-03_11-02-08,fp7d
2021-12-08,ZH,190,182,7,175,2022-05-03_11-02-08,fp7d
2021-12-09,AG,50,49,3,46,2022-05-03_11-02-08,fp7d
2021-12-09,AI,0,0,0,0,2022-05-03_11-02-08,fp7d
2021-12-09,AR,6,6,0,6,2022-05-03_11-02-08,fp7d
2021-12-09,BE,106,91,4,87,2022-05-03_11-02-08,fp7d
2021-12-09,BL,20,16,0,16,2022-05-03_11-02-08,fp7d
2021-12-09,BS,54,50,0,50,2022-05-03_11-02-08,fp7d
2021-12-09,FR,24,23,0,23,2022-05-03_11-02-08,fp7d
2021-12-09,GE,38,56,18,38,2022-05-03_11-02-08,fp7d
2021-12-09,GL,6,6,0,6,2022-05-03_11-02-08,fp7d
2021-12-09,GR,16,16,0,16,2022-05-03_11-02-08,fp7d
2021-12-09,JU,6,6,0,6,2022-05-03_11-02-08,fp7d
2021-12-09,LU,54,45,0,45,2022-05-03_11-02-08,fp7d
2021-12-09,NE,10,10,0,10,2022-05-03_11-02-08,fp7d
2021-12-09,NW,6,6,0,6,2022-05-03_11-02-08,fp7d
2021-12-09,OW,0,0,0,0,2022-05-03_11-02-08,fp7d
2021-12-09,SG,55,40,0,40,2022-05-03_11-02-08,fp7d
2021-12-09,SH,8,7,0,7,2022-05-03_11-02-08,fp7d
2021-12-09,SO,17,17,0,17,2022-05-03_11-02-08,fp7d
2021-12-09,SZ,12,11,0,11,2022-05-03_11-02-08,fp7d
2021-12-09,TG,21,28,7,21,2022-05-03_11-02-08,fp7d
2021-12-09,TI,55,58,3,55,2022-05-03_11-02-08,fp7d
2021-12-09,UR,6,6,0,6,2022-05-03_11-02-08,fp7d
2021-12-09,VD,85,86,1,85,2022-05-03_11-02-08,fp7d
2021-12-09,VS,21,21,0,21,2022-05-03_11-02-08,fp7d
2021-12-09,ZG,8,8,0,8,2022-05-03_11-02-08,fp7d
2021-12-09,ZH,190,181,7,174,2022-05-03_11-02-08,fp7d
2021-12-10,AG,50,49,3,46,2022-05-03_11-02-08,fp7d
2021-12-10,AI,0,0,0,0,2022-05-03_11-02-08,fp7d
2021-12-10,AR,6,6,0,6,2022-05-03_11-02-08,fp7d
2021-12-10,BE,104,92,6,86,2022-05-03_11-02-08,fp7d
2021-12-10,BL,20,16,0,16,2022-05-03_11-02-08,fp7d
2021-12-10,BS,54,50,0,50,2022-05-03_11-02-08,fp7d
2021-12-10,FR,24,23,0,23,2022-05-03_11-02-08,fp7d
2021-12-10,GE,38,56,18,38,2022-05-03_11-02-08,fp7d
2021-12-10,GL,6,6,0,6,2022-05-03_11-02-08,fp7d
2021-12-10,GR,16,16,0,16,2022-05-03_11-02-08,fp7d
2021-12-10,JU,6,6,0,6,2022-05-03_11-02-08,fp7d
2021-12-10,LU,54,45,0,45,2022-05-03_11-02-08,fp7d
2021-12-10,NE,10,10,0,10,2022-05-03_11-02-08,fp7d
2021-12-10,NW,6,5,0,5,2022-05-03_11-02-08,fp7d
2021-12-10,OW,0,0,0,0,2022-05-03_11-02-08,fp7d
2021-12-10,SG,54,39,0,39,2022-05-03_11-02-08,fp7d
2021-12-10,SH,8,7,0,7,2022-05-03_11-02-08,fp7d
2021-12-10,SO,17,16,0,16,2022-05-03_11-02-08,fp7d
2021-12-10,SZ,12,11,0,11,2022-05-03_11-02-08,fp7d
2021-12-10,TG,21,28,7,21,2022-05-03_11-02-08,fp7d
2021-12-10,TI,55,58,3,55,2022-05-03_11-02-08,fp7d
2021-12-10,UR,6,6,0,6,2022-05-03_11-02-08,fp7d
2021-12-10,VD,85,86,1,85,2022-05-03_11-02-08,fp7d
2021-12-10,VS,21,23,2,21,2022-05-03_11-02-08,fp7d
2021-12-10,ZG,8,8,0,8,2022-05-03_11-02-08,fp7d
2021-12-10,ZH,190,181,7,174,2022-05-03_11-02-08,fp7d
2021-12-11,AG,50,48,2,46,2022-05-03_11-02-08,fp7d
2021-12-11,AI,0,0,0,0,2022-05-03_11-02-08,fp7d
2021-12-11,AR,6,6,0,6,2022-05-03_11-02-08,fp7d
2021-12-11,BE,104,93,6,87,2022-05-03_11-02-08,fp7d
2021-12-11,BL,20,16,0,16,2022-05-03_11-02-08,fp7d
2021-12-11,BS,54,46,0,46,2022-05-03_11-02-08,fp7d
2021-12-11,FR,24,23,0,23,2022-05-03_11-02-08,fp7d
2021-12-11,GE,38,56,18,38,2022-05-03_11-02-08,fp7d
2021-12-11,GL,6,6,0,6,2022-05-03_11-02-08,fp7d
2021-12-11,GR,16,16,0,16,2022-05-03_11-02-08,fp7d
2021-12-11,JU,6,6,0,6,2022-05-03_11-02-08,fp7d
2021-12-11,LU,54,45,0,45,2022-05-03_11-02-08,fp7d
2021-12-11,NE,10,10,0,10,2022-05-03_11-02-08,fp7d
2021-12-11,NW,6,5,0,5,2022-05-03_11-02-08,fp7d
2021-12-11,OW,0,0,0,0,2022-05-03_11-02-08,fp7d
2021-12-11,SG,54,39,0,39,2022-05-03_11-02-08,fp7d
2021-12-11,SH,8,7,0,7,2022-05-03_11-02-08,fp7d
2021-12-11,SO,17,16,0,16,2022-05-03_11-02-08,fp7d
2021-12-11,SZ,12,11,0,11,2022-05-03_11-02-08,fp7d
2021-12-11,TG,21,28,7,21,2022-05-03_11-02-08,fp7d
2021-12-11,TI,55,58,3,55,2022-05-03_11-02-08,fp7d
2021-12-11,UR,6,6,0,6,2022-05-03_11-02-08,fp7d
2021-12-11,VD,85,85,1,84,2022-05-03_11-02-08,fp7d
2021-12-11,VS,21,23,2,21,2022-05-03_11-02-08,fp7d
2021-12-11,ZG,8,8,0,8,2022-05-03_11-02-08,fp7d
2021-12-11,ZH,190,181,7,174,2022-05-03_11-02-08,fp7d
2021-12-12,AG,50,48,2,46,2022-05-03_11-02-08,fp7d
2021-12-12,AI,0,0,0,0,2022-05-03_11-02-08,fp7d
2021-12-12,AR,6,6,0,6,2022-05-03_11-02-08,fp7d
2021-12-12,BE,103,93,6,87,2022-05-03_11-02-08,fp7d
2021-12-12,BL,20,16,0,16,2022-05-03_11-02-08,fp7d
2021-12-12,BS,54,46,0,46,2022-05-03_11-02-08,fp7d
2021-12-12,FR,24,23,0,23,2022-05-03_11-02-08,fp7d
2021-12-12,GE,38,56,18,38,2022-05-03_11-02-08,fp7d
2021-12-12,GL,6,6,0,6,2022-05-03_11-02-08,fp7d
2021-12-12,GR,16,16,0,16,2022-05-03_11-02-08,fp7d
2021-12-12,JU,6,6,0,6,2022-05-03_11-02-08,fp7d
2021-12-12,LU,54,45,0,45,2022-05-03_11-02-08,fp7d
2021-12-12,NE,18,10,0,10,2022-05-03_11-02-08,fp7d
2021-12-12,NW,6,5,0,5,2022-05-03_11-02-08,fp7d
2021-12-12,OW,0,0,0,0,2022-05-03_11-02-08,fp7d
2021-12-12,SG,54,39,0,39,2022-05-03_11-02-08,fp7d
2021-12-12,SH,8,7,0,7,2022-05-03_11-02-08,fp7d
2021-12-12,SO,17,16,0,16,2022-05-03_11-02-08,fp7d
2021-12-12,SZ,12,11,0,11,2022-05-03_11-02-08,fp7d
2021-12-12,TG,21,28,7,21,2022-05-03_11-02-08,fp7d
2021-12-12,TI,55,58,3,55,2022-05-03_11-02-08,fp7d
2021-12-12,UR,6,6,0,6,2022-05-03_11-02-08,fp7d
2021-12-12,VD,85,85,1,84,2022-05-03_11-02-08,fp7d
2021-12-12,VS,21,25,4,21,2022-05-03_11-02-08,fp7d
2021-12-12,ZG,8,8,0,8,2022-05-03_11-02-08,fp7d
2021-12-12,ZH,190,179,7,172,2022-05-03_11-02-08,fp7d
2021-12-13,AG,50,49,3,46,2022-05-03_11-02-08,fp7d
2021-12-13,AI,0,0,0,0,2022-05-03_11-02-08,fp7d
2021-12-13,AR,6,6,0,6,2022-05-03_11-02-08,fp7d
2021-12-13,BE,103,96,6,90,2022-05-03_11-02-08,fp7d
2021-12-13,BL,20,16,0,16,2022-05-03_11-02-08,fp7d
2021-12-13,BS,54,50,0,50,2022-05-03_11-02-08,fp7d
2021-12-13,FR,24,23,0,23,2022-05-03_11-02-08,fp7d
2021-12-13,GE,38,56,18,38,2022-05-03_11-02-08,fp7d
2021-12-13,GL,6,6,0,6,2022-05-03_11-02-08,fp7d
2021-12-13,GR,16,16,0,16,2022-05-03_11-02-08,fp7d
2021-12-13,JU,6,6,0,6,2022-05-03_11-02-08,fp7d
2021-12-13,LU,54,45,0,45,2022-05-03_11-02-08,fp7d
2021-12-13,NE,18,10,0,10,2022-05-03_11-02-08,fp7d
2021-12-13,NW,6,5,0,5,2022-05-03_11-02-08,fp7d
2021-12-13,OW,0,0,0,0,2022-05-03_11-02-08,fp7d
2021-12-13,SG,54,40,1,39,2022-05-03_11-02-08,fp7d
2021-12-13,SH,8,7,0,7,2022-05-03_11-02-08,fp7d
2021-12-13,SO,17,16,0,16,2022-05-03_11-02-08,fp7d
2021-12-13,SZ,12,11,0,11,2022-05-03_11-02-08,fp7d
2021-12-13,TG,21,28,7,21,2022-05-03_11-02-08,fp7d
2021-12-13,TI,57,60,3,57,2022-05-03_11-02-08,fp7d
2021-12-13,UR,6,6,0,6,2022-05-03_11-02-08,fp7d
2021-12-13,VD,91,93,2,91,2022-05-03_11-02-08,fp7d
2021-12-13,VS,21,25,4,21,2022-05-03_11-02-08,fp7d
2021-12-13,ZG,8,8,0,8,2022-05-03_11-02-08,fp7d
2021-12-13,ZH,190,181,7,174,2022-05-03_11-02-08,fp7d
2021-12-14,AG,50,49,3,46,2022-05-03_11-02-08,fp7d
2021-12-14,AI,0,0,0,0,2022-05-03_11-02-08,fp7d
2021-12-14,AR,6,6,0,6,2022-05-03_11-02-08,fp7d
2021-12-14,BE,102,95,8,87,2022-05-03_11-02-08,fp7d
2021-12-14,BL,20,16,0,16,2022-05-03_11-02-08,fp7d
2021-12-14,BS,54,50,0,50,2022-05-03_11-02-08,fp7d
2021-12-14,FR,24,23,0,23,2022-05-03_11-02-08,fp7d
2021-12-14,GE,38,56,18,38,2022-05-03_11-02-08,fp7d
2021-12-14,GL,6,6,0,6,2022-05-03_11-02-08,fp7d
2021-12-14,GR,16,16,0,16,2022-05-03_11-02-08,fp7d
2021-12-14,JU,6,6,0,6,2022-05-03_11-02-08,fp7d
2021-12-14,LU,54,47,2,45,2022-05-03_11-02-08,fp7d
2021-12-14,NE,18,10,0,10,2022-05-03_11-02-08,fp7d
2021-12-14,NW,6,5,0,5,2022-05-03_11-02-08,fp7d
2021-12-14,OW,0,0,0,0,2022-05-03_11-02-08,fp7d
2021-12-14,SG,54,40,1,39,2022-05-03_11-02-08,fp7d
2021-12-14,SH,8,7,0,7,2022-05-03_11-02-08,fp7d
2021-12-14,SO,17,16,0,16,2022-05-03_11-02-08,fp7d
2021-12-14,SZ,12,11,0,11,2022-05-03_11-02-08,fp7d
2021-12-14,TG,21,28,7,21,2022-05-03_11-02-08,fp7d
2021-12-14,TI,58,61,3,58,2022-05-03_11-02-08,fp7d
2021-12-14,UR,6,6,0,6,2022-05-03_11-02-08,fp7d
2021-12-14,VD,91,93,2,91,2022-05-03_11-02-08,fp7d
2021-12-14,VS,21,25,4,21,2022-05-03_11-02-08,fp7d
2021-12-14,ZG,8,8,0,8,2022-05-03_11-02-08,fp7d
2021-12-14,ZH,190,183,7,176,2022-05-03_11-02-08,fp7d
2021-12-15,AG,50,49,3,46,2022-05-03_11-02-08,fp7d
2021-12-15,AI,0,0,0,0,2022-05-03_11-02-08,fp7d
2021-12-15,AR,6,6,0,6,2022-05-03_11-02-08,fp7d
2021-12-15,BE,103,95,8,87,2022-05-03_11-02-08,fp7d
2021-12-15,BL,20,16,0,16,2022-05-03_11-02-08,fp7d
2021-12-15,BS,54,50,0,50,2022-05-03_11-02-08,fp7d
2021-12-15,FR,24,23,0,23,2022-05-03_11-02-08,fp7d
2021-12-15,GE,38,56,18,38,2022-05-03_11-02-08,fp7d
2021-12-15,GL,6,5,0,5,2022-05-03_11-02-08,fp7d
2021-12-15,GR,16,16,0,16,2022-05-03_11-02-08,fp7d
2021-12-15,JU,6,6,0,6,2022-05-03_11-02-08,fp7d
2021-12-15,LU,54,47,2,45,2022-05-03_11-02-08,fp7d
2021-12-15,NE,10,10,0,10,2022-05-03_11-02-08,fp7d
2021-12-15,NW,6,5,0,5,2022-05-03_11-02-08,fp7d
2021-12-15,OW,0,0,0,0,2022-05-03_11-02-08,fp7d
2021-12-15,SG,54,40,1,39,2022-05-03_11-02-08,fp7d
2021-12-15,SH,8,7,0,7,2022-05-03_11-02-08,fp7d
2021-12-15,SO,17,16,0,16,2022-05-03_11-02-08,fp7d
2021-12-15,SZ,12,10,0,10,2022-05-03_11-02-08,fp7d
2021-12-15,TG,21,27,6,21,2022-05-03_11-02-08,fp7d
2021-12-15,TI,58,61,3,58,2022-05-03_11-02-08,fp7d
2021-12-15,UR,6,6,0,6,2022-05-03_11-02-08,fp7d
2021-12-15,VD,91,93,2,91,2022-05-03_11-02-08,fp7d
2021-12-15,VS,21,25,4,21,2022-05-03_11-02-08,fp7d
2021-12-15,ZG,8,8,0,8,2022-05-03_11-02-08,fp7d
2021-12-15,ZH,190,180,7,173,2022-05-03_11-02-08,fp7d
2021-12-16,AG,50,49,3,46,2022-05-03_11-02-08,fp7d
2021-12-16,AI,0,0,0,0,2022-05-03_11-02-08,fp7d
2021-12-16,AR,6,6,0,6,2022-05-03_11-02-08,fp7d
2021-12-16,BE,105,91,6,85,2022-05-03_11-02-08,fp7d
2021-12-16,BL,20,16,0,16,2022-05-03_11-02-08,fp7d
2021-12-16,BS,54,50,0,50,2022-05-03_11-02-08,fp7d
2021-12-16,FR,24,23,0,23,2022-05-03_11-02-08,fp7d
2021-12-16,GE,38,56,18,38,2022-05-03_11-02-08,fp7d
2021-12-16,GL,6,5,0,5,2022-05-03_11-02-08,fp7d
2021-12-16,GR,16,16,0,16,2022-05-03_11-02-08,fp7d
2021-12-16,JU,6,6,0,6,2022-05-03_11-02-08,fp7d
2021-12-16,LU,54,46,2,44,2022-05-03_11-02-08,fp7d
2021-12-16,NE,10,10,0,10,2022-05-03_11-02-08,fp7d
2021-12-16,NW,6,5,0,5,2022-05-03_11-02-08,fp7d
2021-12-16,OW,0,0,0,0,2022-05-03_11-02-08,fp7d
2021-12-16,SG,54,40,1,39,2022-05-03_11-02-08,fp7d
2021-12-16,SH,8,7,0,7,2022-05-03_11-02-08,fp7d
2021-12-16,SO,17,16,0,16,2022-05-03_11-02-08,fp7d
2021-12-16,SZ,12,11,0,11,2022-05-03_11-02-08,fp7d
2021-12-16,TG,21,27,6,21,2022-05-03_11-02-08,fp7d
2021-12-16,TI,54,65,11,54,2022-05-03_11-02-08,fp7d
2021-12-16,UR,6,6,0,6,2022-05-03_11-02-08,fp7d
2021-12-16,VD,91,93,2,91,2022-05-03_11-02-08,fp7d
2021-12-16,VS,21,25,4,21,2022-05-03_11-02-08,fp7d
2021-12-16,ZG,8,8,0,8,2022-05-03_11-02-08,fp7d
2021-12-16,ZH,190,182,7,175,2022-05-03_11-02-08,fp7d
2021-12-17,AG,50,46,2,44,2022-05-03_11-02-08,fp7d
2021-12-17,AI,0,0,0,0,2022-05-03_11-02-08,fp7d
2021-12-17,AR,6,6,0,6,2022-05-03_11-02-08,fp7d
2021-12-17,BE,105,93,6,87,2022-05-03_11-02-08,fp7d
2021-12-17,BL,20,16,0,16,2022-05-03_11-02-08,fp7d
2021-12-17,BS,54,50,0,50,2022-05-03_11-02-08,fp7d
2021-12-17,FR,24,23,0,23,2022-05-03_11-02-08,fp7d
2021-12-17,GE,38,56,18,38,2022-05-03_11-02-08,fp7d
2021-12-17,GL,6,5,0,5,2022-05-03_11-02-08,fp7d
2021-12-17,GR,16,16,0,16,2022-05-03_11-02-08,fp7d
2021-12-17,JU,6,6,0,6,2022-05-03_11-02-08,fp7d
2021-12-17,LU,56,46,0,46,2022-05-03_11-02-08,fp7d
2021-12-17,NE,10,10,0,10,2022-05-03_11-02-08,fp7d
2021-12-17,NW,6,5,0,5,2022-05-03_11-02-08,fp7d
2021-12-17,OW,0,0,0,0,2022-05-03_11-02-08,fp7d
2021-12-17,SG,54,40,1,39,2022-05-03_11-02-08,fp7d
2021-12-17,SH,8,7,0,7,2022-05-03_11-02-08,fp7d
2021-12-17,SO,17,16,0,16,2022-05-03_11-02-08,fp7d
2021-12-17,SZ,12,10,0,10,2022-05-03_11-02-08,fp7d
2021-12-17,TG,21,27,6,21,2022-05-03_11-02-08,fp7d
2021-12-17,TI,54,67,13,54,2022-05-03_11-02-08,fp7d
2021-12-17,UR,6,6,0,6,2022-05-03_11-02-08,fp7d
2021-12-17,VD,91,93,2,91,2022-05-03_11-02-08,fp7d
2021-12-17,VS,21,25,4,21,2022-05-03_11-02-08,fp7d
2021-12-17,ZG,8,8,0,8,2022-05-03_11-02-08,fp7d
2021-12-17,ZH,190,180,6,174,2022-05-03_11-02-08,fp7d
2021-12-18,AG,50,46,2,44,2022-05-03_11-02-08,fp7d
2021-12-18,AI,0,0,0,0,2022-05-03_11-02-08,fp7d
2021-12-18,AR,6,6,0,6,2022-05-03_11-02-08,fp7d
2021-12-18,BE,105,93,6,87,2022-05-03_11-02-08,fp7d
2021-12-18,BL,20,16,0,16,2022-05-03_11-02-08,fp7d
2021-12-18,BS,54,46,0,46,2022-05-03_11-02-08,fp7d
2021-12-18,FR,24,23,0,23,2022-05-03_11-02-08,fp7d
2021-12-18,GE,38,56,18,38,2022-05-03_11-02-08,fp7d
2021-12-18,GL,6,5,0,5,2022-05-03_11-02-08,fp7d
2021-12-18,GR,16,16,0,16,2022-05-03_11-02-08,fp7d
2021-12-18,JU,6,6,0,6,2022-05-03_11-02-08,fp7d
2021-12-18,LU,56,44,0,44,2022-05-03_11-02-08,fp7d
2021-12-18,NE,10,10,0,10,2022-05-03_11-02-08,fp7d
2021-12-18,NW,6,5,0,5,2022-05-03_11-02-08,fp7d
2021-12-18,OW,0,0,0,0,2022-05-03_11-02-08,fp7d
2021-12-18,SG,54,40,1,39,2022-05-03_11-02-08,fp7d
2021-12-18,SH,8,7,0,7,2022-05-03_11-02-08,fp7d
2021-12-18,SO,17,16,0,16,2022-05-03_11-02-08,fp7d
2021-12-18,SZ,12,10,0,10,2022-05-03_11-02-08,fp7d
2021-12-18,TG,21,27,6,21,2022-05-03_11-02-08,fp7d
2021-12-18,TI,54,67,13,54,2022-05-03_11-02-08,fp7d
2021-12-18,UR,6,6,0,6,2022-05-03_11-02-08,fp7d
2021-12-18,VD,91,93,2,91,2022-05-03_11-02-08,fp7d
2021-12-18,VS,21,25,4,21,2022-05-03_11-02-08,fp7d
2021-12-18,ZG,8,8,0,8,2022-05-03_11-02-08,fp7d
2021-12-18,ZH,190,182,7,175,2022-05-03_11-02-08,fp7d
2021-12-19,AG,50,46,2,44,2022-05-03_11-02-08,fp7d
2021-12-19,AI,0,0,0,0,2022-05-03_11-02-08,fp7d
2021-12-19,AR,6,6,0,6,2022-05-03_11-02-08,fp7d
2021-12-19,BE,105,93,6,87,2022-05-03_11-02-08,fp7d
2021-12-19,BL,20,16,0,16,2022-05-03_11-02-08,fp7d
2021-12-19,BS,54,46,0,46,2022-05-03_11-02-08,fp7d
2021-12-19,FR,24,23,0,23,2022-05-03_11-02-08,fp7d
2021-12-19,GE,38,56,18,38,2022-05-03_11-02-08,fp7d
2021-12-19,GL,6,5,0,5,2022-05-03_11-02-08,fp7d
2021-12-19,GR,16,16,0,16,2022-05-03_11-02-08,fp7d
2021-12-19,JU,6,6,0,6,2022-05-03_11-02-08,fp7d
2021-12-19,LU,56,44,0,44,2022-05-03_11-02-08,fp7d
2021-12-19,NE,10,10,0,10,2022-05-03_11-02-08,fp7d
2021-12-19,NW,6,5,0,5,2022-05-03_11-02-08,fp7d
2021-12-19,OW,0,0,0,0,2022-05-03_11-02-08,fp7d
2021-12-19,SG,54,40,1,39,2022-05-03_11-02-08,fp7d
2021-12-19,SH,8,7,0,7,2022-05-03_11-02-08,fp7d
2021-12-19,SO,17,16,0,16,2022-05-03_11-02-08,fp7d
2021-12-19,SZ,12,10,0,10,2022-05-03_11-02-08,fp7d
2021-12-19,TG,21,27,6,21,2022-05-03_11-02-08,fp7d
2021-12-19,TI,54,67,13,54,2022-05-03_11-02-08,fp7d
2021-12-19,UR,6,6,0,6,2022-05-03_11-02-08,fp7d
2021-12-19,VD,91,93,2,91,2022-05-03_11-02-08,fp7d
2021-12-19,VS,21,25,4,21,2022-05-03_11-02-08,fp7d
2021-12-19,ZG,8,8,0,8,2022-05-03_11-02-08,fp7d
2021-12-19,ZH,190,183,7,176,2022-05-03_11-02-08,fp7d
2021-12-20,AG,50,46,2,44,2022-05-03_11-02-08,fp7d
2021-12-20,AI,0,0,0,0,2022-05-03_11-02-08,fp7d
2021-12-20,AR,6,6,0,6,2022-05-03_11-02-08,fp7d
2021-12-20,BE,105,93,6,87,2022-05-03_11-02-08,fp7d
2021-12-20,BL,20,16,0,16,2022-05-03_11-02-08,fp7d
2021-12-20,BS,54,50,0,50,2022-05-03_11-02-08,fp7d
2021-12-20,FR,24,23,0,23,2022-05-03_11-02-08,fp7d
2021-12-20,GE,38,56,18,38,2022-05-03_11-02-08,fp7d
2021-12-20,GL,6,6,0,6,2022-05-03_11-02-08,fp7d
2021-12-20,GR,16,18,2,16,2022-05-03_11-02-08,fp7d
2021-12-20,JU,6,6,0,6,2022-05-03_11-02-08,fp7d
2021-12-20,LU,56,43,0,43,2022-05-03_11-02-08,fp7d
2021-12-20,NE,10,10,0,10,2022-05-03_11-02-08,fp7d
2021-12-20,NW,6,5,0,5,2022-05-03_11-02-08,fp7d
2021-12-20,OW,0,0,0,0,2022-05-03_11-02-08,fp7d
2021-12-20,SG,54,40,1,39,2022-05-03_11-02-08,fp7d
2021-12-20,SH,8,7,0,7,2022-05-03_11-02-08,fp7d
2021-12-20,SO,17,16,0,16,2022-05-03_11-02-08,fp7d
2021-12-20,SZ,12,10,0,10,2022-05-03_11-02-08,fp7d
2021-12-20,TG,21,27,6,21,2022-05-03_11-02-08,fp7d
2021-12-20,TI,54,67,13,54,2022-05-03_11-02-08,fp7d
2021-12-20,UR,6,6,0,6,2022-05-03_11-02-08,fp7d
2021-12-20,VD,91,93,2,91,2022-05-03_11-02-08,fp7d
2021-12-20,VS,21,25,4,21,2022-05-03_11-02-08,fp7d
2021-12-20,ZG,8,8,0,8,2022-05-03_11-02-08,fp7d
2021-12-20,ZH,190,181,7,174,2022-05-03_11-02-08,fp7d
2021-12-21,AG,50,46,2,44,2022-05-03_11-02-08,fp7d
2021-12-21,AI,0,0,0,0,2022-05-03_11-02-08,fp7d
2021-12-21,AR,6,6,0,6,2022-05-03_11-02-08,fp7d
2021-12-21,BE,105,94,6,88,2022-05-03_11-02-08,fp7d
2021-12-21,BL,20,16,0,16,2022-05-03_11-02-08,fp7d
2021-12-21,BS,54,50,0,50,2022-05-03_11-02-08,fp7d
2021-12-21,FR,24,23,0,23,2022-05-03_11-02-08,fp7d
2021-12-21,GE,38,56,18,38,2022-05-03_11-02-08,fp7d
2021-12-21,GL,6,6,0,6,2022-05-03_11-02-08,fp7d
2021-12-21,GR,16,18,2,16,2022-05-03_11-02-08,fp7d
2021-12-21,JU,6,7,1,6,2022-05-03_11-02-08,fp7d
2021-12-21,LU,56,45,0,45,2022-05-03_11-02-08,fp7d
2021-12-21,NE,10,10,0,10,2022-05-03_11-02-08,fp7d
2021-12-21,NW,6,5,0,5,2022-05-03_11-02-08,fp7d
2021-12-21,OW,0,0,0,0,2022-05-03_11-02-08,fp7d
2021-12-21,SG,54,40,1,39,2022-05-03_11-02-08,fp7d
2021-12-21,SH,8,7,0,7,2022-05-03_11-02-08,fp7d
2021-12-21,SO,17,16,0,16,2022-05-03_11-02-08,fp7d
2021-12-21,SZ,12,10,0,10,2022-05-03_11-02-08,fp7d
2021-12-21,TG,21,28,7,21,2022-05-03_11-02-08,fp7d
2021-12-21,TI,54,69,15,54,2022-05-03_11-02-08,fp7d
2021-12-21,UR,6,6,0,6,2022-05-03_11-02-08,fp7d
2021-12-21,VD,91,93,2,91,2022-05-03_11-02-08,fp7d
2021-12-21,VS,21,25,4,21,2022-05-03_11-02-08,fp7d
2021-12-21,ZG,8,8,0,8,2022-05-03_11-02-08,fp7d
2021-12-21,ZH,190,181,7,174,2022-05-03_11-02-08,fp7d
2021-12-22,AG,50,46,2,44,2022-05-03_11-02-08,fp7d
2021-12-22,AI,0,0,0,0,2022-05-03_11-02-08,fp7d
2021-12-22,AR,6,6,0,6,2022-05-03_11-02-08,fp7d
2021-12-22,BE,105,94,6,88,2022-05-03_11-02-08,fp7d
2021-12-22,BL,21,17,0,17,2022-05-03_11-02-08,fp7d
2021-12-22,BS,54,50,0,50,2022-05-03_11-02-08,fp7d
2021-12-22,FR,24,23,0,23,2022-05-03_11-02-08,fp7d
2021-12-22,GE,38,56,18,38,2022-05-03_11-02-08,fp7d
2021-12-22,GL,6,6,0,6,2022-05-03_11-02-08,fp7d
2021-12-22,GR,16,18,2,16,2022-05-03_11-02-08,fp7d
2021-12-22,JU,6,7,1,6,2022-05-03_11-02-08,fp7d
2021-12-22,LU,56,45,0,45,2022-05-03_11-02-08,fp7d
2021-12-22,NE,10,10,0,10,2022-05-03_11-02-08,fp7d
2021-12-22,NW,5,5,0,5,2022-05-03_11-02-08,fp7d
2021-12-22,OW,0,0,0,0,2022-05-03_11-02-08,fp7d
2021-12-22,SG,54,40,1,39,2022-05-03_11-02-08,fp7d
2021-12-22,SH,8,6,0,6,2022-05-03_11-02-08,fp7d
2021-12-22,SO,17,16,0,16,2022-05-03_11-02-08,fp7d
2021-12-22,SZ,12,10,0,10,2022-05-03_11-02-08,fp7d
2021-12-22,TG,21,28,7,21,2022-05-03_11-02-08,fp7d
2021-12-22,TI,54,69,15,54,2022-05-03_11-02-08,fp7d
2021-12-22,UR,6,6,0,6,2022-05-03_11-02-08,fp7d
2021-12-22,VD,91,93,2,91,2022-05-03_11-02-08,fp7d
2021-12-22,VS,21,25,4,21,2022-05-03_11-02-08,fp7d
2021-12-22,ZG,8,8,0,8,2022-05-03_11-02-08,fp7d
2021-12-22,ZH,190,182,7,175,2022-05-03_11-02-08,fp7d
2021-12-23,AG,50,46,2,44,2022-05-03_11-02-08,fp7d
2021-12-23,AI,0,0,0,0,2022-05-03_11-02-08,fp7d
2021-12-23,AR,6,6,0,6,2022-05-03_11-02-08,fp7d
2021-12-23,BE,105,94,6,88,2022-05-03_11-02-08,fp7d
2021-12-23,BL,20,16,0,16,2022-05-03_11-02-08,fp7d
2021-12-23,BS,54,50,0,50,2022-05-03_11-02-08,fp7d
2021-12-23,FR,24,23,0,23,2022-05-03_11-02-08,fp7d
2021-12-23,GE,38,56,18,38,2022-05-03_11-02-08,fp7d
2021-12-23,GL,6,6,0,6,2022-05-03_11-02-08,fp7d
2021-12-23,GR,16,18,2,16,2022-05-03_11-02-08,fp7d
2021-12-23,JU,6,7,1,6,2022-05-03_11-02-08,fp7d
2021-12-23,LU,56,46,0,46,2022-05-03_11-02-08,fp7d
2021-12-23,NE,10,10,0,10,2022-05-03_11-02-08,fp7d
2021-12-23,NW,5,5,0,5,2022-05-03_11-02-08,fp7d
2021-12-23,OW,0,0,0,0,2022-05-03_11-02-08,fp7d
2021-12-23,SG,54,40,1,39,2022-05-03_11-02-08,fp7d
2021-12-23,SH,8,6,0,6,2022-05-03_11-02-08,fp7d
2021-12-23,SO,17,16,0,16,2022-05-03_11-02-08,fp7d
2021-12-23,SZ,12,10,0,10,2022-05-03_11-02-08,fp7d
2021-12-23,TG,21,28,7,21,2022-05-03_11-02-08,fp7d
2021-12-23,TI,55,69,14,55,2022-05-03_11-02-08,fp7d
2021-12-23,UR,6,6,0,6,2022-05-03_11-02-08,fp7d
2021-12-23,VD,91,93,2,91,2022-05-03_11-02-08,fp7d
2021-12-23,VS,21,25,4,21,2022-05-03_11-02-08,fp7d
2021-12-23,ZG,8,8,0,8,2022-05-03_11-02-08,fp7d
2021-12-23,ZH,190,178,7,171,2022-05-03_11-02-08,fp7d
2021-12-24,AG,50,46,2,44,2022-05-03_11-02-08,fp7d
2021-12-24,AI,0,0,0,0,2022-05-03_11-02-08,fp7d
2021-12-24,AR,6,6,0,6,2022-05-03_11-02-08,fp7d
2021-12-24,BE,105,91,6,85,2022-05-03_11-02-08,fp7d
2021-12-24,BL,20,16,0,16,2022-05-03_11-02-08,fp7d
2021-12-24,BS,54,50,0,50,2022-05-03_11-02-08,fp7d
2021-12-24,FR,24,23,0,23,2022-05-03_11-02-08,fp7d
2021-12-24,GE,38,56,18,38,2022-05-03_11-02-08,fp7d
2021-12-24,GL,6,6,0,6,2022-05-03_11-02-08,fp7d
2021-12-24,GR,16,18,2,16,2022-05-03_11-02-08,fp7d
2021-12-24,JU,6,7,1,6,2022-05-03_11-02-08,fp7d
2021-12-24,LU,56,44,0,44,2022-05-03_11-02-08,fp7d
2021-12-24,NE,10,10,0,10,2022-05-03_11-02-08,fp7d
2021-12-24,NW,5,5,0,5,2022-05-03_11-02-08,fp7d
2021-12-24,OW,0,0,0,0,2022-05-03_11-02-08,fp7d
2021-12-24,SG,54,40,1,39,2022-05-03_11-02-08,fp7d
2021-12-24,SH,8,6,0,6,2022-05-03_11-02-08,fp7d
2021-12-24,SO,17,16,0,16,2022-05-03_11-02-08,fp7d
2021-12-24,SZ,12,10,0,10,2022-05-03_11-02-08,fp7d
2021-12-24,TG,21,28,7,21,2022-05-03_11-02-08,fp7d
2021-12-24,TI,56,69,13,56,2022-05-03_11-02-08,fp7d
2021-12-24,UR,6,6,0,6,2022-05-03_11-02-08,fp7d
2021-12-24,VD,91,93,2,91,2022-05-03_11-02-08,fp7d
2021-12-24,VS,21,25,4,21,2022-05-03_11-02-08,fp7d
2021-12-24,ZG,8,8,0,8,2022-05-03_11-02-08,fp7d
2021-12-24,ZH,190,173,6,167,2022-05-03_11-02-08,fp7d
2021-12-25,AG,50,46,2,44,2022-05-03_11-02-08,fp7d
2021-12-25,AI,0,0,0,0,2022-05-03_11-02-08,fp7d
2021-12-25,AR,6,6,0,6,2022-05-03_11-02-08,fp7d
2021-12-25,BE,105,91,6,85,2022-05-03_11-02-08,fp7d
2021-12-25,BL,20,16,0,16,2022-05-03_11-02-08,fp7d
2021-12-25,BS,54,48,0,48,2022-05-03_11-02-08,fp7d
2021-12-25,FR,24,23,0,23,2022-05-03_11-02-08,fp7d
2021-12-25,GE,38,56,18,38,2022-05-03_11-02-08,fp7d
2021-12-25,GL,6,6,0,6,2022-05-03_11-02-08,fp7d
2021-12-25,GR,16,18,2,16,2022-05-03_11-02-08,fp7d
2021-12-25,JU,6,7,1,6,2022-05-03_11-02-08,fp7d
2021-12-25,LU,56,43,0,43,2022-05-03_11-02-08,fp7d
2021-12-25,NE,10,10,0,10,2022-05-03_11-02-08,fp7d
2021-12-25,NW,5,5,0,5,2022-05-03_11-02-08,fp7d
2021-12-25,OW,0,0,0,0,2022-05-03_11-02-08,fp7d
2021-12-25,SG,54,40,1,39,2022-05-03_11-02-08,fp7d
2021-12-25,SH,8,6,0,6,2022-05-03_11-02-08,fp7d
2021-12-25,SO,17,16,0,16,2022-05-03_11-02-08,fp7d
2021-12-25,SZ,12,10,0,10,2022-05-03_11-02-08,fp7d
2021-12-25,TG,21,28,7,21,2022-05-03_11-02-08,fp7d
2021-12-25,TI,56,69,13,56,2022-05-03_11-02-08,fp7d
2021-12-25,UR,6,6,0,6,2022-05-03_11-02-08,fp7d
2021-12-25,VD,86,93,7,86,2022-05-03_11-02-08,fp7d
2021-12-25,VS,21,25,4,21,2022-05-03_11-02-08,fp7d
2021-12-25,ZG,8,8,0,8,2022-05-03_11-02-08,fp7d
2021-12-25,ZH,190,170,6,164,2022-05-03_11-02-08,fp7d
2021-12-26,AG,50,46,2,44,2022-05-03_11-02-08,fp7d
2021-12-26,AI,0,0,0,0,2022-05-03_11-02-08,fp7d
2021-12-26,AR,6,6,0,6,2022-05-03_11-02-08,fp7d
2021-12-26,BE,106,93,8,85,2022-05-03_11-02-08,fp7d
2021-12-26,BL,20,16,0,16,2022-05-03_11-02-08,fp7d
2021-12-26,BS,54,48,0,48,2022-05-03_11-02-08,fp7d
2021-12-26,FR,24,23,0,23,2022-05-03_11-02-08,fp7d
2021-12-26,GE,38,56,18,38,2022-05-03_11-02-08,fp7d
2021-12-26,GL,6,6,0,6,2022-05-03_11-02-08,fp7d
2021-12-26,GR,16,18,2,16,2022-05-03_11-02-08,fp7d
2021-12-26,JU,6,7,1,6,2022-05-03_11-02-08,fp7d
2021-12-26,LU,56,43,0,43,2022-05-03_11-02-08,fp7d
2021-12-26,NE,10,10,0,10,2022-05-03_11-02-08,fp7d
2021-12-26,NW,5,5,0,5,2022-05-03_11-02-08,fp7d
2021-12-26,OW,0,0,0,0,2022-05-03_11-02-08,fp7d
2021-12-26,SG,54,40,1,39,2022-05-03_11-02-08,fp7d
2021-12-26,SH,8,6,0,6,2022-05-03_11-02-08,fp7d
2021-12-26,SO,17,17,0,17,2022-05-03_11-02-08,fp7d
2021-12-26,SZ,12,10,0,10,2022-05-03_11-02-08,fp7d
2021-12-26,TG,21,28,7,21,2022-05-03_11-02-08,fp7d
2021-12-26,TI,56,69,13,56,2022-05-03_11-02-08,fp7d
2021-12-26,UR,6,6,0,6,2022-05-03_11-02-08,fp7d
2021-12-26,VD,86,93,7,86,2022-05-03_11-02-08,fp7d
2021-12-26,VS,21,25,4,21,2022-05-03_11-02-08,fp7d
2021-12-26,ZG,8,8,0,8,2022-05-03_11-02-08,fp7d
2021-12-26,ZH,190,174,6,168,2022-05-03_11-02-08,fp7d
2021-12-27,AG,50,47,3,44,2022-05-03_11-02-08,fp7d
2021-12-27,AI,0,0,0,0,2022-05-03_11-02-08,fp7d
2021-12-27,AR,6,6,0,6,2022-05-03_11-02-08,fp7d
2021-12-27,BE,106,96,9,87,2022-05-03_11-02-08,fp7d
2021-12-27,BL,20,16,0,16,2022-05-03_11-02-08,fp7d
2021-12-27,BS,54,48,0,48,2022-05-03_11-02-08,fp7d
2021-12-27,FR,24,22,0,22,2022-05-03_11-02-08,fp7d
2021-12-27,GE,38,56,18,38,2022-05-03_11-02-08,fp7d
2021-12-27,GL,6,6,0,6,2022-05-03_11-02-08,fp7d
2021-12-27,GR,16,18,2,16,2022-05-03_11-02-08,fp7d
2021-12-27,JU,6,8,2,6,2022-05-03_11-02-08,fp7d
2021-12-27,LU,56,44,0,44,2022-05-03_11-02-08,fp7d
2021-12-27,NE,10,10,0,10,2022-05-03_11-02-08,fp7d
2021-12-27,NW,5,5,0,5,2022-05-03_11-02-08,fp7d
2021-12-27,OW,0,0,0,0,2022-05-03_11-02-08,fp7d
2021-12-27,SG,54,40,1,39,2022-05-03_11-02-08,fp7d
2021-12-27,SH,8,6,0,6,2022-05-03_11-02-08,fp7d
2021-12-27,SO,17,16,0,16,2022-05-03_11-02-08,fp7d
2021-12-27,SZ,12,11,0,11,2022-05-03_11-02-08,fp7d
2021-12-27,TG,21,27,6,21,2022-05-03_11-02-08,fp7d
2021-12-27,TI,56,69,13,56,2022-05-03_11-02-08,fp7d
2021-12-27,UR,6,6,0,6,2022-05-03_11-02-08,fp7d
2021-12-27,VD,86,93,7,86,2022-05-03_11-02-08,fp7d
2021-12-27,VS,21,25,4,21,2022-05-03_11-02-08,fp7d
2021-12-27,ZG,8,8,0,8,2022-05-03_11-02-08,fp7d
2021-12-27,ZH,190,175,6,169,2022-05-03_11-02-08,fp7d
2021-12-28,AG,50,47,3,44,2022-05-03_11-02-08,fp7d
2021-12-28,AI,0,0,0,0,2022-05-03_11-02-08,fp7d
2021-12-28,AR,6,6,0,6,2022-05-03_11-02-08,fp7d
2021-12-28,BE,105,97,10,87,2022-05-03_11-02-08,fp7d
2021-12-28,BL,20,16,0,16,2022-05-03_11-02-08,fp7d
2021-12-28,BS,54,50,0,50,2022-05-03_11-02-08,fp7d
2021-12-28,FR,24,22,0,22,2022-05-03_11-02-08,fp7d
2021-12-28,GE,38,56,18,38,2022-05-03_11-02-08,fp7d
2021-12-28,GL,6,6,0,6,2022-05-03_11-02-08,fp7d
2021-12-28,GR,16,18,2,16,2022-05-03_11-02-08,fp7d
2021-12-28,JU,6,8,2,6,2022-05-03_11-02-08,fp7d
2021-12-28,LU,54,44,2,42,2022-05-03_11-02-08,fp7d
2021-12-28,NE,10,10,0,10,2022-05-03_11-02-08,fp7d
2021-12-28,NW,5,5,0,5,2022-05-03_11-02-08,fp7d
2021-12-28,OW,0,0,0,0,2022-05-03_11-02-08,fp7d
2021-12-28,SG,54,40,1,39,2022-05-03_11-02-08,fp7d
2021-12-28,SH,8,6,0,6,2022-05-03_11-02-08,fp7d
2021-12-28,SO,17,16,0,16,2022-05-03_11-02-08,fp7d
2021-12-28,SZ,12,11,0,11,2022-05-03_11-02-08,fp7d
2021-12-28,TG,21,27,6,21,2022-05-03_11-02-08,fp7d
2021-12-28,TI,56,69,13,56,2022-05-03_11-02-08,fp7d
2021-12-28,UR,6,6,0,6,2022-05-03_11-02-08,fp7d
2021-12-28,VD,86,93,7,86,2022-05-03_11-02-08,fp7d
2021-12-28,VS,21,25,4,21,2022-05-03_11-02-08,fp7d
2021-12-28,ZG,8,8,0,8,2022-05-03_11-02-08,fp7d
2021-12-28,ZH,190,178,6,172,2022-05-03_11-02-08,fp7d
2021-12-29,AG,50,47,3,44,2022-05-03_11-02-08,fp7d
2021-12-29,AI,0,0,0,0,2022-05-03_11-02-08,fp7d
2021-12-29,AR,6,6,0,6,2022-05-03_11-02-08,fp7d
2021-12-29,BE,105,95,10,85,2022-05-03_11-02-08,fp7d
2021-12-29,BL,20,16,0,16,2022-05-03_11-02-08,fp7d
2021-12-29,BS,54,50,0,50,2022-05-03_11-02-08,fp7d
2021-12-29,FR,24,22,0,22,2022-05-03_11-02-08,fp7d
2021-12-29,GE,38,56,18,38,2022-05-03_11-02-08,fp7d
2021-12-29,GL,6,6,0,6,2022-05-03_11-02-08,fp7d
2021-12-29,GR,16,18,2,16,2022-05-03_11-02-08,fp7d
2021-12-29,JU,6,8,2,6,2022-05-03_11-02-08,fp7d
2021-12-29,LU,54,44,2,42,2022-05-03_11-02-08,fp7d
2021-12-29,NE,10,10,0,10,2022-05-03_11-02-08,fp7d
2021-12-29,NW,5,5,0,5,2022-05-03_11-02-08,fp7d
2021-12-29,OW,0,0,0,0,2022-05-03_11-02-08,fp7d
2021-12-29,SG,54,40,1,39,2022-05-03_11-02-08,fp7d
2021-12-29,SH,8,6,0,6,2022-05-03_11-02-08,fp7d
2021-12-29,SO,17,17,0,17,2022-05-03_11-02-08,fp7d
2021-12-29,SZ,12,11,0,11,2022-05-03_11-02-08,fp7d
2021-12-29,TG,21,27,6,21,2022-05-03_11-02-08,fp7d
2021-12-29,TI,56,69,13,56,2022-05-03_11-02-08,fp7d
2021-12-29,UR,6,6,0,6,2022-05-03_11-02-08,fp7d
2021-12-29,VD,86,93,7,86,2022-05-03_11-02-08,fp7d
2021-12-29,VS,21,25,4,21,2022-05-03_11-02-08,fp7d
2021-12-29,ZG,8,8,0,8,2022-05-03_11-02-08,fp7d
2021-12-29,ZH,190,177,6,171,2022-05-03_11-02-08,fp7d
2021-12-30,AG,50,47,3,44,2022-05-03_11-02-08,fp7d
2021-12-30,AI,0,0,0,0,2022-05-03_11-02-08,fp7d
2021-12-30,AR,6,6,0,6,2022-05-03_11-02-08,fp7d
2021-12-30,BE,105,95,10,85,2022-05-03_11-02-08,fp7d
2021-12-30,BL,20,16,0,16,2022-05-03_11-02-08,fp7d
2021-12-30,BS,54,50,0,50,2022-05-03_11-02-08,fp7d
2021-12-30,FR,24,22,0,22,2022-05-03_11-02-08,fp7d
2021-12-30,GE,38,56,18,38,2022-05-03_11-02-08,fp7d
2021-12-30,GL,6,6,0,6,2022-05-03_11-02-08,fp7d
2021-12-30,GR,16,18,2,16,2022-05-03_11-02-08,fp7d
2021-12-30,JU,6,8,2,6,2022-05-03_11-02-08,fp7d
2021-12-30,LU,54,44,2,42,2022-05-03_11-02-08,fp7d
2021-12-30,NE,10,10,0,10,2022-05-03_11-02-08,fp7d
2021-12-30,NW,5,5,0,5,2022-05-03_11-02-08,fp7d
2021-12-30,OW,0,0,0,0,2022-05-03_11-02-08,fp7d
2021-12-30,SG,54,40,1,39,2022-05-03_11-02-08,fp7d
2021-12-30,SH,8,6,0,6,2022-05-03_11-02-08,fp7d
2021-12-30,SO,17,16,0,16,2022-05-03_11-02-08,fp7d
2021-12-30,SZ,12,11,0,11,2022-05-03_11-02-08,fp7d
2021-12-30,TG,21,27,6,21,2022-05-03_11-02-08,fp7d
2021-12-30,TI,56,69,13,56,2022-05-03_11-02-08,fp7d
2021-12-30,UR,6,6,0,6,2022-05-03_11-02-08,fp7d
2021-12-30,VD,86,93,7,86,2022-05-03_11-02-08,fp7d
2021-12-30,VS,21,25,4,21,2022-05-03_11-02-08,fp7d
2021-12-30,ZG,8,8,0,8,2022-05-03_11-02-08,fp7d
2021-12-30,ZH,190,176,6,170,2022-05-03_11-02-08,fp7d
2021-12-31,AG,50,47,3,44,2022-05-03_11-02-08,fp7d
2021-12-31,AI,0,0,0,0,2022-05-03_11-02-08,fp7d
2021-12-31,AR,6,6,0,6,2022-05-03_11-02-08,fp7d
2021-12-31,BE,105,95,10,85,2022-05-03_11-02-08,fp7d
2021-12-31,BL,20,16,0,16,2022-05-03_11-02-08,fp7d
2021-12-31,BS,54,50,0,50,2022-05-03_11-02-08,fp7d
2021-12-31,FR,24,20,0,20,2022-05-03_11-02-08,fp7d
2021-12-31,GE,38,56,18,38,2022-05-03_11-02-08,fp7d
2021-12-31,GL,6,6,0,6,2022-05-03_11-02-08,fp7d
2021-12-31,GR,16,18,2,16,2022-05-03_11-02-08,fp7d
2021-12-31,JU,6,8,2,6,2022-05-03_11-02-08,fp7d
2021-12-31,LU,54,44,2,42,2022-05-03_11-02-08,fp7d
2021-12-31,NE,10,10,0,10,2022-05-03_11-02-08,fp7d
2021-12-31,NW,5,5,0,5,2022-05-03_11-02-08,fp7d
2021-12-31,OW,0,0,0,0,2022-05-03_11-02-08,fp7d
2021-12-31,SG,54,40,1,39,2022-05-03_11-02-08,fp7d
2021-12-31,SH,8,6,0,6,2022-05-03_11-02-08,fp7d
2021-12-31,SO,17,17,0,17,2022-05-03_11-02-08,fp7d
2021-12-31,SZ,12,11,0,11,2022-05-03_11-02-08,fp7d
2021-12-31,TG,21,27,6,21,2022-05-03_11-02-08,fp7d
2021-12-31,TI,56,69,13,56,2022-05-03_11-02-08,fp7d
2021-12-31,UR,6,6,0,6,2022-05-03_11-02-08,fp7d
2021-12-31,VD,86,93,7,86,2022-05-03_11-02-08,fp7d
2021-12-31,VS,21,25,4,21,2022-05-03_11-02-08,fp7d
2021-12-31,ZG,8,8,0,8,2022-05-03_11-02-08,fp7d
2021-12-31,ZH,190,177,7,170,2022-05-03_11-02-08,fp7d
2022-01-01,AG,50,44,2,42,2022-05-03_11-02-08,fp7d
2022-01-01,AI,0,0,0,0,2022-05-03_11-02-08,fp7d
2022-01-01,AR,6,6,0,6,2022-05-03_11-02-08,fp7d
2022-01-01,BE,105,95,10,85,2022-05-03_11-02-08,fp7d
2022-01-01,BL,20,16,0,16,2022-05-03_11-02-08,fp7d
2022-01-01,BS,54,46,0,46,2022-05-03_11-02-08,fp7d
2022-01-01,FR,24,20,0,20,2022-05-03_11-02-08,fp7d
2022-01-01,GE,38,56,18,38,2022-05-03_11-02-08,fp7d
2022-01-01,GL,6,6,0,6,2022-05-03_11-02-08,fp7d
2022-01-01,GR,16,18,2,16,2022-05-03_11-02-08,fp7d
2022-01-01,JU,6,8,2,6,2022-05-03_11-02-08,fp7d
2022-01-01,LU,54,44,2,42,2022-05-03_11-02-08,fp7d
2022-01-01,NE,10,10,0,10,2022-05-03_11-02-08,fp7d
2022-01-01,NW,5,5,0,5,2022-05-03_11-02-08,fp7d
2022-01-01,OW,0,0,0,0,2022-05-03_11-02-08,fp7d
2022-01-01,SG,54,40,1,39,2022-05-03_11-02-08,fp7d
2022-01-01,SH,8,6,0,6,2022-05-03_11-02-08,fp7d
2022-01-01,SO,17,17,0,17,2022-05-03_11-02-08,fp7d
2022-01-01,SZ,12,11,0,11,2022-05-03_11-02-08,fp7d
2022-01-01,TG,21,27,6,21,2022-05-03_11-02-08,fp7d
2022-01-01,TI,56,69,13,56,2022-05-03_11-02-08,fp7d
2022-01-01,UR,6,6,0,6,2022-05-03_11-02-08,fp7d
2022-01-01,VD,86,93,7,86,2022-05-03_11-02-08,fp7d
2022-01-01,VS,21,25,4,21,2022-05-03_11-02-08,fp7d
2022-01-01,ZG,8,8,0,8,2022-05-03_11-02-08,fp7d
2022-01-01,ZH,190,178,6,172,2022-05-03_11-02-08,fp7d
2022-01-02,AG,50,45,3,42,2022-05-03_11-02-08,fp7d
2022-01-02,AI,0,0,0,0,2022-05-03_11-02-08,fp7d
2022-01-02,AR,6,6,0,6,2022-05-03_11-02-08,fp7d
2022-01-02,BE,105,95,10,85,2022-05-03_11-02-08,fp7d
2022-01-02,BL,20,16,0,16,2022-05-03_11-02-08,fp7d
2022-01-02,BS,54,46,0,46,2022-05-03_11-02-08,fp7d
2022-01-02,FR,24,22,0,22,2022-05-03_11-02-08,fp7d
2022-01-02,GE,38,56,18,38,2022-05-03_11-02-08,fp7d
2022-01-02,GL,6,6,0,6,2022-05-03_11-02-08,fp7d
2022-01-02,GR,16,18,2,16,2022-05-03_11-02-08,fp7d
2022-01-02,JU,6,8,2,6,2022-05-03_11-02-08,fp7d
2022-01-02,LU,54,44,2,42,2022-05-03_11-02-08,fp7d
2022-01-02,NE,10,10,0,10,2022-05-03_11-02-08,fp7d
2022-01-02,NW,5,2,0,2,2022-05-03_11-02-08,fp7d
2022-01-02,OW,0,0,0,0,2022-05-03_11-02-08,fp7d
2022-01-02,SG,54,40,1,39,2022-05-03_11-02-08,fp7d
2022-01-02,SH,8,6,0,6,2022-05-03_11-02-08,fp7d
2022-01-02,SO,17,17,0,17,2022-05-03_11-02-08,fp7d
2022-01-02,SZ,12,11,0,11,2022-05-03_11-02-08,fp7d
2022-01-02,TG,21,27,6,21,2022-05-03_11-02-08,fp7d
2022-01-02,TI,56,69,13,56,2022-05-03_11-02-08,fp7d
2022-01-02,UR,6,6,0,6,2022-05-03_11-02-08,fp7d
2022-01-02,VD,86,93,7,86,2022-05-03_11-02-08,fp7d
2022-01-02,VS,21,25,4,21,2022-05-03_11-02-08,fp7d
2022-01-02,ZG,8,8,0,8,2022-05-03_11-02-08,fp7d
2022-01-02,ZH,190,176,6,170,2022-05-03_11-02-08,fp7d
2022-01-03,AG,50,50,4,46,2022-05-03_11-02-08,fp7d
2022-01-03,AI,0,0,0,0,2022-05-03_11-02-08,fp7d
2022-01-03,AR,6,6,0,6,2022-05-03_11-02-08,fp7d
2022-01-03,BE,105,97,10,87,2022-05-03_11-02-08,fp7d
2022-01-03,BL,20,16,0,16,2022-05-03_11-02-08,fp7d
2022-01-03,BS,54,50,0,50,2022-05-03_11-02-08,fp7d
2022-01-03,FR,24,23,0,23,2022-05-03_11-02-08,fp7d
2022-01-03,GE,38,56,18,38,2022-05-03_11-02-08,fp7d
2022-01-03,GL,6,6,0,6,2022-05-03_11-02-08,fp7d
2022-01-03,GR,16,18,2,16,2022-05-03_11-02-08,fp7d
2022-01-03,JU,6,8,2,6,2022-05-03_11-02-08,fp7d
2022-01-03,LU,56,44,0,44,2022-05-03_11-02-08,fp7d
2022-01-03,NE,10,10,0,10,2022-05-03_11-02-08,fp7d
2022-01-03,NW,5,2,0,2,2022-05-03_11-02-08,fp7d
2022-01-03,OW,0,0,0,0,2022-05-03_11-02-08,fp7d
2022-01-03,SG,54,40,1,39,2022-05-03_11-02-08,fp7d
2022-01-03,SH,8,6,0,6,2022-05-03_11-02-08,fp7d
2022-01-03,SO,17,18,1,17,2022-05-03_11-02-08,fp7d
2022-01-03,SZ,12,11,0,11,2022-05-03_11-02-08,fp7d
2022-01-03,TG,21,27,6,21,2022-05-03_11-02-08,fp7d
2022-01-03,TI,56,69,13,56,2022-05-03_11-02-08,fp7d
2022-01-03,UR,6,6,0,6,2022-05-03_11-02-08,fp7d
2022-01-03,VD,86,93,7,86,2022-05-03_11-02-08,fp7d
2022-01-03,VS,21,25,4,21,2022-05-03_11-02-08,fp7d
2022-01-03,ZG,8,8,0,8,2022-05-03_11-02-08,fp7d
2022-01-03,ZH,190,177,6,171,2022-05-03_11-02-08,fp7d
2022-01-04,AG,50,50,4,46,2022-05-03_11-02-08,fp7d
2022-01-04,AI,0,0,0,0,2022-05-03_11-02-08,fp7d
2022-01-04,AR,6,6,0,6,2022-05-03_11-02-08,fp7d
2022-01-04,BE,105,96,10,86,2022-05-03_11-02-08,fp7d
2022-01-04,BL,20,16,0,16,2022-05-03_11-02-08,fp7d
2022-01-04,BS,56,51,0,51,2022-05-03_11-02-08,fp7d
2022-01-04,FR,24,23,0,23,2022-05-03_11-02-08,fp7d
2022-01-04,GE,38,56,18,38,2022-05-03_11-02-08,fp7d
2022-01-04,GL,6,6,0,6,2022-05-03_11-02-08,fp7d
2022-01-04,GR,16,18,2,16,2022-05-03_11-02-08,fp7d
2022-01-04,JU,6,8,2,6,2022-05-03_11-02-08,fp7d
2022-01-04,LU,56,43,0,43,2022-05-03_11-02-08,fp7d
2022-01-04,NE,10,10,0,10,2022-05-03_11-02-08,fp7d
2022-01-04,NW,5,5,0,5,2022-05-03_11-02-08,fp7d
2022-01-04,OW,0,0,0,0,2022-05-03_11-02-08,fp7d
2022-01-04,SG,54,40,1,39,2022-05-03_11-02-08,fp7d
2022-01-04,SH,8,6,0,6,2022-05-03_11-02-08,fp7d
2022-01-04,SO,17,17,0,17,2022-05-03_11-02-08,fp7d
2022-01-04,SZ,12,10,0,10,2022-05-03_11-02-08,fp7d
2022-01-04,TG,21,27,6,21,2022-05-03_11-02-08,fp7d
2022-01-04,TI,56,69,13,56,2022-05-03_11-02-08,fp7d
2022-01-04,UR,6,6,0,6,2022-05-03_11-02-08,fp7d
2022-01-04,VD,86,92,7,85,2022-05-03_11-02-08,fp7d
2022-01-04,VS,21,25,4,21,2022-05-03_11-02-08,fp7d
2022-01-04,ZG,8,8,0,8,2022-05-03_11-02-08,fp7d
2022-01-04,ZH,190,179,7,172,2022-05-03_11-02-08,fp7d
2022-01-05,AG,50,50,4,46,2022-05-03_11-02-08,fp7d
2022-01-05,AI,0,0,0,0,2022-05-03_11-02-08,fp7d
2022-01-05,AR,6,6,0,6,2022-05-03_11-02-08,fp7d
2022-01-05,BE,105,97,10,87,2022-05-03_11-02-08,fp7d
2022-01-05,BL,20,16,0,16,2022-05-03_11-02-08,fp7d
2022-01-05,BS,56,52,0,52,2022-05-03_11-02-08,fp7d
2022-01-05,FR,24,23,0,23,2022-05-03_11-02-08,fp7d
2022-01-05,GE,38,56,18,38,2022-05-03_11-02-08,fp7d
2022-01-05,GL,6,6,0,6,2022-05-03_11-02-08,fp7d
2022-01-05,GR,16,18,2,16,2022-05-03_11-02-08,fp7d
2022-01-05,JU,6,8,2,6,2022-05-03_11-02-08,fp7d
2022-01-05,LU,56,45,0,45,2022-05-03_11-02-08,fp7d
2022-01-05,NE,10,10,0,10,2022-05-03_11-02-08,fp7d
2022-01-05,NW,5,5,0,5,2022-05-03_11-02-08,fp7d
2022-01-05,OW,0,0,0,0,2022-05-03_11-02-08,fp7d
2022-01-05,SG,54,40,1,39,2022-05-03_11-02-08,fp7d
2022-01-05,SH,8,6,0,6,2022-05-03_11-02-08,fp7d
2022-01-05,SO,17,16,0,16,2022-05-03_11-02-08,fp7d
2022-01-05,SZ,12,11,0,11,2022-05-03_11-02-08,fp7d
2022-01-05,TG,21,27,6,21,2022-05-03_11-02-08,fp7d
2022-01-05,TI,56,69,13,56,2022-05-03_11-02-08,fp7d
2022-01-05,UR,6,6,0,6,2022-05-03_11-02-08,fp7d
2022-01-05,VD,86,93,7,86,2022-05-03_11-02-08,fp7d
2022-01-05,VS,21,25,4,21,2022-05-03_11-02-08,fp7d
2022-01-05,ZG,8,8,0,8,2022-05-03_11-02-08,fp7d
2022-01-05,ZH,190,189,9,180,2022-05-03_11-02-08,fp7d
2022-01-06,AG,50,50,4,46,2022-05-03_11-02-08,fp7d
2022-01-06,AI,0,0,0,0,2022-05-03_11-02-08,fp7d
2022-01-06,AR,6,6,0,6,2022-05-03_11-02-08,fp7d
2022-01-06,BE,105,96,8,88,2022-05-03_11-02-08,fp7d
2022-01-06,BL,20,16,0,16,2022-05-03_11-02-08,fp7d
2022-01-06,BS,56,52,0,52,2022-05-03_11-02-08,fp7d
2022-01-06,FR,24,23,0,23,2022-05-03_11-02-08,fp7d
2022-01-06,GE,38,56,18,38,2022-05-03_11-02-08,fp7d
2022-01-06,GL,6,6,0,6,2022-05-03_11-02-08,fp7d
2022-01-06,GR,16,18,2,16,2022-05-03_11-02-08,fp7d
2022-01-06,JU,6,8,2,6,2022-05-03_11-02-08,fp7d
2022-01-06,LU,56,43,0,43,2022-05-03_11-02-08,fp7d
2022-01-06,NE,10,10,0,10,2022-05-03_11-02-08,fp7d
2022-01-06,NW,5,5,0,5,2022-05-03_11-02-08,fp7d
2022-01-06,OW,0,0,0,0,2022-05-03_11-02-08,fp7d
2022-01-06,SG,54,40,1,39,2022-05-03_11-02-08,fp7d
2022-01-06,SH,8,6,0,6,2022-05-03_11-02-08,fp7d
2022-01-06,SO,17,17,0,17,2022-05-03_11-02-08,fp7d
2022-01-06,SZ,12,10,0,10,2022-05-03_11-02-08,fp7d
2022-01-06,TG,21,27,6,21,2022-05-03_11-02-08,fp7d
2022-01-06,TI,56,69,13,56,2022-05-03_11-02-08,fp7d
2022-01-06,UR,6,6,0,6,2022-05-03_11-02-08,fp7d
2022-01-06,VD,86,93,7,86,2022-05-03_11-02-08,fp7d
2022-01-06,VS,21,25,4,21,2022-05-03_11-02-08,fp7d
2022-01-06,ZG,8,8,0,8,2022-05-03_11-02-08,fp7d
2022-01-06,ZH,190,186,8,178,2022-05-03_11-02-08,fp7d
2022-01-07,AG,50,50,4,46,2022-05-03_11-02-08,fp7d
2022-01-07,AI,0,0,0,0,2022-05-03_11-02-08,fp7d
2022-01-07,AR,6,6,0,6,2022-05-03_11-02-08,fp7d
2022-01-07,BE,105,96,8,88,2022-05-03_11-02-08,fp7d
2022-01-07,BL,20,16,0,16,2022-05-03_11-02-08,fp7d
2022-01-07,BS,54,50,0,50,2022-05-03_11-02-08,fp7d
2022-01-07,FR,24,23,0,23,2022-05-03_11-02-08,fp7d
2022-01-07,GE,38,56,18,38,2022-05-03_11-02-08,fp7d
2022-01-07,GL,6,6,0,6,2022-05-03_11-02-08,fp7d
2022-01-07,GR,16,18,2,16,2022-05-03_11-02-08,fp7d
2022-01-07,JU,6,8,2,6,2022-05-03_11-02-08,fp7d
2022-01-07,LU,59,43,0,43,2022-05-03_11-02-08,fp7d
2022-01-07,NE,10,10,0,10,2022-05-03_11-02-08,fp7d
2022-01-07,NW,5,5,0,5,2022-05-03_11-02-08,fp7d
2022-01-07,OW,0,0,0,0,2022-05-03_11-02-08,fp7d
2022-01-07,SG,54,40,1,39,2022-05-03_11-02-08,fp7d
2022-01-07,SH,8,6,0,6,2022-05-03_11-02-08,fp7d
2022-01-07,SO,17,16,0,16,2022-05-03_11-02-08,fp7d
2022-01-07,SZ,12,10,0,10,2022-05-03_11-02-08,fp7d
2022-01-07,TG,21,27,6,21,2022-05-03_11-02-08,fp7d
2022-01-07,TI,56,69,13,56,2022-05-03_11-02-08,fp7d
2022-01-07,UR,6,6,0,6,2022-05-03_11-02-08,fp7d
2022-01-07,VD,86,92,7,85,2022-05-03_11-02-08,fp7d
2022-01-07,VS,21,25,4,21,2022-05-03_11-02-08,fp7d
2022-01-07,ZG,8,8,0,8,2022-05-03_11-02-08,fp7d
2022-01-07,ZH,190,186,8,178,2022-05-03_11-02-08,fp7d
2022-01-08,AG,50,50,4,46,2022-05-03_11-02-08,fp7d
2022-01-08,AI,0,0,0,0,2022-05-03_11-02-08,fp7d
2022-01-08,AR,6,6,0,6,2022-05-03_11-02-08,fp7d
2022-01-08,BE,105,99,10,89,2022-05-03_11-02-08,fp7d
2022-01-08,BL,20,16,0,16,2022-05-03_11-02-08,fp7d
2022-01-08,BS,54,46,0,46,2022-05-03_11-02-08,fp7d
2022-01-08,FR,24,23,0,23,2022-05-03_11-02-08,fp7d
2022-01-08,GE,38,56,18,38,2022-05-03_11-02-08,fp7d
2022-01-08,GL,6,6,0,6,2022-05-03_11-02-08,fp7d
2022-01-08,GR,16,18,2,16,2022-05-03_11-02-08,fp7d
2022-01-08,JU,6,8,2,6,2022-05-03_11-02-08,fp7d
2022-01-08,LU,59,43,0,43,2022-05-03_11-02-08,fp7d
2022-01-08,NE,10,10,0,10,2022-05-03_11-02-08,fp7d
2022-01-08,NW,5,5,0,5,2022-05-03_11-02-08,fp7d
2022-01-08,OW,0,0,0,0,2022-05-03_11-02-08,fp7d
2022-01-08,SG,54,40,1,39,2022-05-03_11-02-08,fp7d
2022-01-08,SH,8,6,0,6,2022-05-03_11-02-08,fp7d
2022-01-08,SO,17,16,0,16,2022-05-03_11-02-08,fp7d
2022-01-08,SZ,12,11,0,11,2022-05-03_11-02-08,fp7d
2022-01-08,TG,21,27,6,21,2022-05-03_11-02-08,fp7d
2022-01-08,TI,56,69,13,56,2022-05-03_11-02-08,fp7d
2022-01-08,UR,6,6,0,6,2022-05-03_11-02-08,fp7d
2022-01-08,VD,86,93,7,86,2022-05-03_11-02-08,fp7d
2022-01-08,VS,21,25,4,21,2022-05-03_11-02-08,fp7d
2022-01-08,ZG,8,8,0,8,2022-05-03_11-02-08,fp7d
2022-01-08,ZH,190,188,8,180,2022-05-03_11-02-08,fp7d
2022-01-09,AG,50,50,4,46,2022-05-03_11-02-08,fp7d
2022-01-09,AI,0,0,0,0,2022-05-03_11-02-08,fp7d
2022-01-09,AR,6,6,0,6,2022-05-03_11-02-08,fp7d
2022-01-09,BE,105,97,10,87,2022-05-03_11-02-08,fp7d
2022-01-09,BL,20,16,0,16,2022-05-03_11-02-08,fp7d
2022-01-09,BS,54,46,0,46,2022-05-03_11-02-08,fp7d
2022-01-09,FR,24,23,0,23,2022-05-03_11-02-08,fp7d
2022-01-09,GE,38,56,18,38,2022-05-03_11-02-08,fp7d
2022-01-09,GL,6,6,0,6,2022-05-03_11-02-08,fp7d
2022-01-09,GR,16,18,2,16,2022-05-03_11-02-08,fp7d
2022-01-09,JU,6,8,2,6,2022-05-03_11-02-08,fp7d
2022-01-09,LU,59,53,5,48,2022-05-03_11-02-08,fp7d
2022-01-09,NE,10,10,0,10,2022-05-03_11-02-08,fp7d
2022-01-09,NW,5,5,0,5,2022-05-03_11-02-08,fp7d
2022-01-09,OW,0,0,0,0,2022-05-03_11-02-08,fp7d
2022-01-09,SG,54,40,1,39,2022-05-03_11-02-08,fp7d
2022-01-09,SH,8,6,0,6,2022-05-03_11-02-08,fp7d
2022-01-09,SO,17,16,0,16,2022-05-03_11-02-08,fp7d
2022-01-09,SZ,12,11,0,11,2022-05-03_11-02-08,fp7d
2022-01-09,TG,21,27,6,21,2022-05-03_11-02-08,fp7d
2022-01-09,TI,56,69,13,56,2022-05-03_11-02-08,fp7d
2022-01-09,UR,6,6,0,6,2022-05-03_11-02-08,fp7d
2022-01-09,VD,86,93,7,86,2022-05-03_11-02-08,fp7d
2022-01-09,VS,21,25,4,21,2022-05-03_11-02-08,fp7d
2022-01-09,ZG,8,8,0,8,2022-05-03_11-02-08,fp7d
2022-01-09,ZH,190,186,7,179,2022-05-03_11-02-08,fp7d
2022-01-10,AG,50,50,4,46,2022-05-03_11-02-08,fp7d
2022-01-10,AI,0,0,0,0,2022-05-03_11-02-08,fp7d
2022-01-10,AR,6,6,0,6,2022-05-03_11-02-08,fp7d
2022-01-10,BE,105,95,8,87,2022-05-03_11-02-08,fp7d
2022-01-10,BL,20,16,0,16,2022-05-03_11-02-08,fp7d
2022-01-10,BS,54,50,0,50,2022-05-03_11-02-08,fp7d
2022-01-10,FR,24,23,0,23,2022-05-03_11-02-08,fp7d
2022-01-10,GE,38,56,18,38,2022-05-03_11-02-08,fp7d
2022-01-10,GL,6,6,0,6,2022-05-03_11-02-08,fp7d
2022-01-10,GR,16,18,2,16,2022-05-03_11-02-08,fp7d
2022-01-10,JU,6,8,2,6,2022-05-03_11-02-08,fp7d
2022-01-10,LU,59,62,14,48,2022-05-03_11-02-08,fp7d
2022-01-10,NE,10,10,0,10,2022-05-03_11-02-08,fp7d
2022-01-10,NW,5,5,0,5,2022-05-03_11-02-08,fp7d
2022-01-10,OW,0,0,0,0,2022-05-03_11-02-08,fp7d
2022-01-10,SG,54,40,1,39,2022-05-03_11-02-08,fp7d
2022-01-10,SH,8,6,0,6,2022-05-03_11-02-08,fp7d
2022-01-10,SO,17,16,0,16,2022-05-03_11-02-08,fp7d
2022-01-10,SZ,12,11,0,11,2022-05-03_11-02-08,fp7d
2022-01-10,TG,21,27,6,21,2022-05-03_11-02-08,fp7d
2022-01-10,TI,56,69,13,56,2022-05-03_11-02-08,fp7d
2022-01-10,UR,6,6,0,6,2022-05-03_11-02-08,fp7d
2022-01-10,VD,86,93,7,86,2022-05-03_11-02-08,fp7d
2022-01-10,VS,21,25,4,21,2022-05-03_11-02-08,fp7d
2022-01-10,ZG,8,8,0,8,2022-05-03_11-02-08,fp7d
2022-01-10,ZH,190,189,10,179,2022-05-03_11-02-08,fp7d
2022-01-11,AG,50,50,4,46,2022-05-03_11-02-08,fp7d
2022-01-11,AI,0,0,0,0,2022-05-03_11-02-08,fp7d
2022-01-11,AR,6,6,0,6,2022-05-03_11-02-08,fp7d
2022-01-11,BE,105,95,8,87,2022-05-03_11-02-08,fp7d
2022-01-11,BL,20,16,0,16,2022-05-03_11-02-08,fp7d
2022-01-11,BS,54,50,0,50,2022-05-03_11-02-08,fp7d
2022-01-11,FR,24,23,0,23,2022-05-03_11-02-08,fp7d
2022-01-11,GE,38,56,18,38,2022-05-03_11-02-08,fp7d
2022-01-11,GL,6,6,0,6,2022-05-03_11-02-08,fp7d
2022-01-11,GR,16,18,2,16,2022-05-03_11-02-08,fp7d
2022-01-11,JU,6,8,2,6,2022-05-03_11-02-08,fp7d
2022-01-11,LU,59,62,14,48,2022-05-03_11-02-08,fp7d
2022-01-11,NE,10,10,0,10,2022-05-03_11-02-08,fp7d
2022-01-11,NW,5,5,0,5,2022-05-03_11-02-08,fp7d
2022-01-11,OW,0,0,0,0,2022-05-03_11-02-08,fp7d
2022-01-11,SG,54,40,1,39,2022-05-03_11-02-08,fp7d
2022-01-11,SH,8,6,0,6,2022-05-03_11-02-08,fp7d
2022-01-11,SO,17,16,0,16,2022-05-03_11-02-08,fp7d
2022-01-11,SZ,12,11,0,11,2022-05-03_11-02-08,fp7d
2022-01-11,TG,21,29,8,21,2022-05-03_11-02-08,fp7d
2022-01-11,TI,56,69,13,56,2022-05-03_11-02-08,fp7d
2022-01-11,UR,6,6,0,6,2022-05-03_11-02-08,fp7d
2022-01-11,VD,86,93,7,86,2022-05-03_11-02-08,fp7d
2022-01-11,VS,21,25,4,21,2022-05-03_11-02-08,fp7d
2022-01-11,ZG,8,8,0,8,2022-05-03_11-02-08,fp7d
2022-01-11,ZH,190,190,11,179,2022-05-03_11-02-08,fp7d
2022-01-12,AG,50,48,3,45,2022-05-03_11-02-08,fp7d
2022-01-12,AI,0,0,0,0,2022-05-03_11-02-08,fp7d
2022-01-12,AR,6,6,0,6,2022-05-03_11-02-08,fp7d
2022-01-12,BE,105,96,9,87,2022-05-03_11-02-08,fp7d
2022-01-12,BL,20,16,0,16,2022-05-03_11-02-08,fp7d
2022-01-12,BS,54,50,0,50,2022-05-03_11-02-08,fp7d
2022-01-12,FR,24,23,0,23,2022-05-03_11-02-08,fp7d
2022-01-12,GE,38,56,18,38,2022-05-03_11-02-08,fp7d
2022-01-12,GL,6,6,0,6,2022-05-03_11-02-08,fp7d
2022-01-12,GR,16,18,2,16,2022-05-03_11-02-08,fp7d
2022-01-12,JU,6,8,2,6,2022-05-03_11-02-08,fp7d
2022-01-12,LU,59,62,14,48,2022-05-03_11-02-08,fp7d
2022-01-12,NE,10,10,0,10,2022-05-03_11-02-08,fp7d
2022-01-12,NW,5,5,0,5,2022-05-03_11-02-08,fp7d
2022-01-12,OW,0,0,0,0,2022-05-03_11-02-08,fp7d
2022-01-12,SG,54,40,1,39,2022-05-03_11-02-08,fp7d
2022-01-12,SH,8,6,0,6,2022-05-03_11-02-08,fp7d
2022-01-12,SO,17,16,0,16,2022-05-03_11-02-08,fp7d
2022-01-12,SZ,12,11,0,11,2022-05-03_11-02-08,fp7d
2022-01-12,TG,21,29,8,21,2022-05-03_11-02-08,fp7d
2022-01-12,TI,56,69,13,56,2022-05-03_11-02-08,fp7d
2022-01-12,UR,6,6,0,6,2022-05-03_11-02-08,fp7d
2022-01-12,VD,86,93,7,86,2022-05-03_11-02-08,fp7d
2022-01-12,VS,21,25,4,21,2022-05-03_11-02-08,fp7d
2022-01-12,ZG,8,8,0,8,2022-05-03_11-02-08,fp7d
2022-01-12,ZH,190,191,11,180,2022-05-03_11-02-08,fp7d
2022-01-13,AG,50,50,4,46,2022-05-03_11-02-08,fp7d
2022-01-13,AI,0,0,0,0,2022-05-03_11-02-08,fp7d
2022-01-13,AR,6,6,0,6,2022-05-03_11-02-08,fp7d
2022-01-13,BE,105,97,9,88,2022-05-03_11-02-08,fp7d
2022-01-13,BL,20,16,0,16,2022-05-03_11-02-08,fp7d
2022-01-13,BS,54,50,0,50,2022-05-03_11-02-08,fp7d
2022-01-13,FR,24,23,0,23,2022-05-03_11-02-08,fp7d
2022-01-13,GE,38,56,18,38,2022-05-03_11-02-08,fp7d
2022-01-13,GL,6,6,0,6,2022-05-03_11-02-08,fp7d
2022-01-13,GR,16,18,2,16,2022-05-03_11-02-08,fp7d
2022-01-13,JU,6,8,2,6,2022-05-03_11-02-08,fp7d
2022-01-13,LU,59,45,0,45,2022-05-03_11-02-08,fp7d
2022-01-13,NE,10,10,0,10,2022-05-03_11-02-08,fp7d
2022-01-13,NW,6,6,0,6,2022-05-03_11-02-08,fp7d
2022-01-13,OW,0,0,0,0,2022-05-03_11-02-08,fp7d
2022-01-13,SG,54,40,1,39,2022-05-03_11-02-08,fp7d
2022-01-13,SH,8,6,0,6,2022-05-03_11-02-08,fp7d
2022-01-13,SO,17,16,0,16,2022-05-03_11-02-08,fp7d
2022-01-13,SZ,12,11,0,11,2022-05-03_11-02-08,fp7d
2022-01-13,TG,21,27,6,21,2022-05-03_11-02-08,fp7d
2022-01-13,TI,57,69,12,57,2022-05-03_11-02-08,fp7d
2022-01-13,UR,6,6,0,6,2022-05-03_11-02-08,fp7d
2022-01-13,VD,86,93,7,86,2022-05-03_11-02-08,fp7d
2022-01-13,VS,21,25,4,21,2022-05-03_11-02-08,fp7d
2022-01-13,ZG,8,8,0,8,2022-05-03_11-02-08,fp7d
2022-01-13,ZH,190,191,10,181,2022-05-03_11-02-08,fp7d
2022-01-14,AG,50,50,4,46,2022-05-03_11-02-08,fp7d
2022-01-14,AI,0,0,0,0,2022-05-03_11-02-08,fp7d
2022-01-14,AR,6,6,0,6,2022-05-03_11-02-08,fp7d
2022-01-14,BE,105,96,8,88,2022-05-03_11-02-08,fp7d
2022-01-14,BL,20,16,0,16,2022-05-03_11-02-08,fp7d
2022-01-14,BS,54,50,0,50,2022-05-03_11-02-08,fp7d
2022-01-14,FR,24,23,0,23,2022-05-03_11-02-08,fp7d
2022-01-14,GE,38,56,18,38,2022-05-03_11-02-08,fp7d
2022-01-14,GL,6,6,0,6,2022-05-03_11-02-08,fp7d
2022-01-14,GR,16,18,2,16,2022-05-03_11-02-08,fp7d
2022-01-14,JU,6,8,2,6,2022-05-03_11-02-08,fp7d
2022-01-14,LU,59,45,0,45,2022-05-03_11-02-08,fp7d
2022-01-14,NE,10,10,0,10,2022-05-03_11-02-08,fp7d
2022-01-14,NW,6,6,0,6,2022-05-03_11-02-08,fp7d
2022-01-14,OW,0,0,0,0,2022-05-03_11-02-08,fp7d
2022-01-14,SG,54,40,1,39,2022-05-03_11-02-08,fp7d
2022-01-14,SH,8,6,0,6,2022-05-03_11-02-08,fp7d
2022-01-14,SO,17,16,0,16,2022-05-03_11-02-08,fp7d
2022-01-14,SZ,12,11,0,11,2022-05-03_11-02-08,fp7d
2022-01-14,TG,21,27,6,21,2022-05-03_11-02-08,fp7d
2022-01-14,TI,57,69,12,57,2022-05-03_11-02-08,fp7d
2022-01-14,UR,6,6,0,6,2022-05-03_11-02-08,fp7d
2022-01-14,VD,86,93,7,86,2022-05-03_11-02-08,fp7d
2022-01-14,VS,21,25,4,21,2022-05-03_11-02-08,fp7d
2022-01-14,ZG,8,8,0,8,2022-05-03_11-02-08,fp7d
2022-01-14,ZH,190,189,9,180,2022-05-03_11-02-08,fp7d
2022-01-15,AG,50,50,4,46,2022-05-03_11-02-08,fp7d
2022-01-15,AI,0,0,0,0,2022-05-03_11-02-08,fp7d
2022-01-15,AR,6,6,0,6,2022-05-03_11-02-08,fp7d
2022-01-15,BE,105,93,7,86,2022-05-03_11-02-08,fp7d
2022-01-15,BL,20,16,0,16,2022-05-03_11-02-08,fp7d
2022-01-15,BS,54,46,0,46,2022-05-03_11-02-08,fp7d
2022-01-15,FR,24,23,0,23,2022-05-03_11-02-08,fp7d
2022-01-15,GE,38,56,18,38,2022-05-03_11-02-08,fp7d
2022-01-15,GL,6,6,0,6,2022-05-03_11-02-08,fp7d
2022-01-15,GR,16,18,2,16,2022-05-03_11-02-08,fp7d
2022-01-15,JU,6,8,2,6,2022-05-03_11-02-08,fp7d
2022-01-15,LU,59,44,0,44,2022-05-03_11-02-08,fp7d
2022-01-15,NE,10,10,0,10,2022-05-03_11-02-08,fp7d
2022-01-15,NW,6,6,0,6,2022-05-03_11-02-08,fp7d
2022-01-15,OW,0,0,0,0,2022-05-03_11-02-08,fp7d
2022-01-15,SG,54,40,1,39,2022-05-03_11-02-08,fp7d
2022-01-15,SH,8,6,0,6,2022-05-03_11-02-08,fp7d
2022-01-15,SO,17,16,0,16,2022-05-03_11-02-08,fp7d
2022-01-15,SZ,12,11,0,11,2022-05-03_11-02-08,fp7d
2022-01-15,TG,21,27,6,21,2022-05-03_11-02-08,fp7d
2022-01-15,TI,57,69,12,57,2022-05-03_11-02-08,fp7d
2022-01-15,UR,6,6,0,6,2022-05-03_11-02-08,fp7d
2022-01-15,VD,86,93,7,86,2022-05-03_11-02-08,fp7d
2022-01-15,VS,21,25,4,21,2022-05-03_11-02-08,fp7d
2022-01-15,ZG,8,8,0,8,2022-05-03_11-02-08,fp7d
2022-01-15,ZH,190,188,9,179,2022-05-03_11-02-08,fp7d
2022-01-16,AG,50,50,4,46,2022-05-03_11-02-08,fp7d
2022-01-16,AI,0,0,0,0,2022-05-03_11-02-08,fp7d
2022-01-16,AR,6,6,0,6,2022-05-03_11-02-08,fp7d
2022-01-16,BE,105,93,7,86,2022-05-03_11-02-08,fp7d
2022-01-16,BL,20,16,0,16,2022-05-03_11-02-08,fp7d
2022-01-16,BS,54,46,0,46,2022-05-03_11-02-08,fp7d
2022-01-16,FR,24,23,0,23,2022-05-03_11-02-08,fp7d
2022-01-16,GE,38,56,18,38,2022-05-03_11-02-08,fp7d
2022-01-16,GL,6,6,0,6,2022-05-03_11-02-08,fp7d
2022-01-16,GR,16,16,0,16,2022-05-03_11-02-08,fp7d
2022-01-16,JU,6,8,2,6,2022-05-03_11-02-08,fp7d
2022-01-16,LU,59,42,0,42,2022-05-03_11-02-08,fp7d
2022-01-16,NE,10,10,0,10,2022-05-03_11-02-08,fp7d
2022-01-16,NW,6,6,0,6,2022-05-03_11-02-08,fp7d
2022-01-16,OW,0,0,0,0,2022-05-03_11-02-08,fp7d
2022-01-16,SG,54,40,1,39,2022-05-03_11-02-08,fp7d
2022-01-16,SH,8,6,0,6,2022-05-03_11-02-08,fp7d
2022-01-16,SO,17,16,0,16,2022-05-03_11-02-08,fp7d
2022-01-16,SZ,12,11,0,11,2022-05-03_11-02-08,fp7d
2022-01-16,TG,21,27,6,21,2022-05-03_11-02-08,fp7d
2022-01-16,TI,57,69,12,57,2022-05-03_11-02-08,fp7d
2022-01-16,UR,6,6,0,6,2022-05-03_11-02-08,fp7d
2022-01-16,VD,86,93,7,86,2022-05-03_11-02-08,fp7d
2022-01-16,VS,21,25,4,21,2022-05-03_11-02-08,fp7d
2022-01-16,ZG,8,8,0,8,2022-05-03_11-02-08,fp7d
2022-01-16,ZH,190,187,9,178,2022-05-03_11-02-08,fp7d
2022-01-17,AG,50,50,4,46,2022-05-03_11-02-08,fp7d
2022-01-17,AI,0,0,0,0,2022-05-03_11-02-08,fp7d
2022-01-17,AR,6,6,0,6,2022-05-03_11-02-08,fp7d
2022-01-17,BE,106,96,7,89,2022-05-03_11-02-08,fp7d
2022-01-17,BL,20,16,0,16,2022-05-03_11-02-08,fp7d
2022-01-17,BS,54,52,2,50,2022-05-03_11-02-08,fp7d
2022-01-17,FR,24,23,0,23,2022-05-03_11-02-08,fp7d
2022-01-17,GE,38,56,18,38,2022-05-03_11-02-08,fp7d
2022-01-17,GL,6,6,0,6,2022-05-03_11-02-08,fp7d
2022-01-17,GR,16,18,2,16,2022-05-03_11-02-08,fp7d
2022-01-17,JU,6,8,2,6,2022-05-03_11-02-08,fp7d
2022-01-17,LU,59,43,0,43,2022-05-03_11-02-08,fp7d
2022-01-17,NE,10,10,0,10,2022-05-03_11-02-08,fp7d
2022-01-17,NW,6,6,0,6,2022-05-03_11-02-08,fp7d
2022-01-17,OW,0,0,0,0,2022-05-03_11-02-08,fp7d
2022-01-17,SG,54,40,1,39,2022-05-03_11-02-08,fp7d
2022-01-17,SH,8,6,0,6,2022-05-03_11-02-08,fp7d
2022-01-17,SO,17,16,0,16,2022-05-03_11-02-08,fp7d
2022-01-17,SZ,12,11,0,11,2022-05-03_11-02-08,fp7d
2022-01-17,TG,21,28,7,21,2022-05-03_11-02-08,fp7d
2022-01-17,TI,57,69,12,57,2022-05-03_11-02-08,fp7d
2022-01-17,UR,6,6,0,6,2022-05-03_11-02-08,fp7d
2022-01-17,VD,86,93,7,86,2022-05-03_11-02-08,fp7d
2022-01-17,VS,21,24,3,21,2022-05-03_11-02-08,fp7d
2022-01-17,ZG,8,8,0,8,2022-05-03_11-02-08,fp7d
2022-01-17,ZH,190,189,10,179,2022-05-03_11-02-08,fp7d
2022-01-18,AG,50,50,4,46,2022-05-03_11-02-08,fp7d
2022-01-18,AI,0,0,0,0,2022-05-03_11-02-08,fp7d
2022-01-18,AR,6,6,0,6,2022-05-03_11-02-08,fp7d
2022-01-18,BE,106,99,9,90,2022-05-03_11-02-08,fp7d
2022-01-18,BL,20,16,0,16,2022-05-03_11-02-08,fp7d
2022-01-18,BS,54,52,2,50,2022-05-03_11-02-08,fp7d
2022-01-18,FR,24,23,0,23,2022-05-03_11-02-08,fp7d
2022-01-18,GE,38,50,12,38,2022-05-03_11-02-08,fp7d
2022-01-18,GL,6,6,0,6,2022-05-03_11-02-08,fp7d
2022-01-18,GR,16,18,2,16,2022-05-03_11-02-08,fp7d
2022-01-18,JU,6,8,2,6,2022-05-03_11-02-08,fp7d
2022-01-18,LU,59,43,0,43,2022-05-03_11-02-08,fp7d
2022-01-18,NE,10,10,0,10,2022-05-03_11-02-08,fp7d
2022-01-18,NW,6,6,0,6,2022-05-03_11-02-08,fp7d
2022-01-18,OW,0,0,0,0,2022-05-03_11-02-08,fp7d
2022-01-18,SG,54,40,1,39,2022-05-03_11-02-08,fp7d
2022-01-18,SH,8,6,0,6,2022-05-03_11-02-08,fp7d
2022-01-18,SO,17,17,0,17,2022-05-03_11-02-08,fp7d
2022-01-18,SZ,12,11,0,11,2022-05-03_11-02-08,fp7d
2022-01-18,TG,21,24,3,21,2022-05-03_11-02-08,fp7d
2022-01-18,TI,57,69,12,57,2022-05-03_11-02-08,fp7d
2022-01-18,UR,6,6,0,6,2022-05-03_11-02-08,fp7d
2022-01-18,VD,86,93,7,86,2022-05-03_11-02-08,fp7d
2022-01-18,VS,21,24,3,21,2022-05-03_11-02-08,fp7d
2022-01-18,ZG,8,8,0,8,2022-05-03_11-02-08,fp7d
2022-01-18,ZH,190,189,9,180,2022-05-03_11-02-08,fp7d
2022-01-19,AG,50,50,4,46,2022-05-03_11-02-08,fp7d
2022-01-19,AI,0,0,0,0,2022-05-03_11-02-08,fp7d
2022-01-19,AR,6,6,0,6,2022-05-03_11-02-08,fp7d
2022-01-19,BE,106,99,9,90,2022-05-03_11-02-08,fp7d
2022-01-19,BL,20,16,0,16,2022-05-03_11-02-08,fp7d
2022-01-19,BS,54,52,2,50,2022-05-03_11-02-08,fp7d
2022-01-19,FR,24,23,0,23,2022-05-03_11-02-08,fp7d
2022-01-19,GE,38,50,12,38,2022-05-03_11-02-08,fp7d
2022-01-19,GL,6,5,0,5,2022-05-03_11-02-08,fp7d
2022-01-19,GR,16,18,2,16,2022-05-03_11-02-08,fp7d
2022-01-19,JU,6,8,2,6,2022-05-03_11-02-08,fp7d
2022-01-19,LU,59,43,0,43,2022-05-03_11-02-08,fp7d
2022-01-19,NE,10,10,0,10,2022-05-03_11-02-08,fp7d
2022-01-19,NW,6,6,0,6,2022-05-03_11-02-08,fp7d
2022-01-19,OW,0,0,0,0,2022-05-03_11-02-08,fp7d
2022-01-19,SG,54,40,1,39,2022-05-03_11-02-08,fp7d
2022-01-19,SH,8,6,0,6,2022-05-03_11-02-08,fp7d
2022-01-19,SO,17,16,0,16,2022-05-03_11-02-08,fp7d
2022-01-19,SZ,12,11,0,11,2022-05-03_11-02-08,fp7d
2022-01-19,TG,21,24,3,21,2022-05-03_11-02-08,fp7d
2022-01-19,TI,57,69,12,57,2022-05-03_11-02-08,fp7d
2022-01-19,UR,6,6,0,6,2022-05-03_11-02-08,fp7d
2022-01-19,VD,86,93,7,86,2022-05-03_11-02-08,fp7d
2022-01-19,VS,21,24,3,21,2022-05-03_11-02-08,fp7d
2022-01-19,ZG,8,8,0,8,2022-05-03_11-02-08,fp7d
2022-01-19,ZH,190,187,8,179,2022-05-03_11-02-08,fp7d
2022-01-20,AG,50,50,4,46,2022-05-03_11-02-08,fp7d
2022-01-20,AI,0,0,0,0,2022-05-03_11-02-08,fp7d
2022-01-20,AR,6,6,0,6,2022-05-03_11-02-08,fp7d
2022-01-20,BE,106,99,9,90,2022-05-03_11-02-08,fp7d
2022-01-20,BL,20,16,0,16,2022-05-03_11-02-08,fp7d
2022-01-20,BS,54,52,2,50,2022-05-03_11-02-08,fp7d
2022-01-20,FR,24,23,0,23,2022-05-03_11-02-08,fp7d
2022-01-20,GE,38,50,12,38,2022-05-03_11-02-08,fp7d
2022-01-20,GL,6,6,0,6,2022-05-03_11-02-08,fp7d
2022-01-20,GR,16,18,2,16,2022-05-03_11-02-08,fp7d
2022-01-20,JU,6,8,2,6,2022-05-03_11-02-08,fp7d
2022-01-20,LU,59,45,0,45,2022-05-03_11-02-08,fp7d
2022-01-20,NE,10,10,0,10,2022-05-03_11-02-08,fp7d
2022-01-20,NW,6,4,0,4,2022-05-03_11-02-08,fp7d
2022-01-20,OW,0,0,0,0,2022-05-03_11-02-08,fp7d
2022-01-20,SG,54,40,1,39,2022-05-03_11-02-08,fp7d
2022-01-20,SH,8,6,0,6,2022-05-03_11-02-08,fp7d
2022-01-20,SO,17,16,0,16,2022-05-03_11-02-08,fp7d
2022-01-20,SZ,12,11,0,11,2022-05-03_11-02-08,fp7d
2022-01-20,TG,21,24,3,21,2022-05-03_11-02-08,fp7d
2022-01-20,TI,57,69,12,57,2022-05-03_11-02-08,fp7d
2022-01-20,UR,6,6,0,6,2022-05-03_11-02-08,fp7d
2022-01-20,VD,86,93,7,86,2022-05-03_11-02-08,fp7d
2022-01-20,VS,21,24,3,21,2022-05-03_11-02-08,fp7d
2022-01-20,ZG,8,8,0,8,2022-05-03_11-02-08,fp7d
2022-01-20,ZH,190,188,8,180,2022-05-03_11-02-08,fp7d
2022-01-21,AG,50,51,4,47,2022-05-03_11-02-08,fp7d
2022-01-21,AI,0,0,0,0,2022-05-03_11-02-08,fp7d
2022-01-21,AR,6,6,0,6,2022-05-03_11-02-08,fp7d
2022-01-21,BE,106,99,9,90,2022-05-03_11-02-08,fp7d
2022-01-21,BL,20,16,0,16,2022-05-03_11-02-08,fp7d
2022-01-21,BS,54,52,2,50,2022-05-03_11-02-08,fp7d
2022-01-21,FR,24,23,0,23,2022-05-03_11-02-08,fp7d
2022-01-21,GE,38,50,12,38,2022-05-03_11-02-08,fp7d
2022-01-21,GL,6,6,0,6,2022-05-03_11-02-08,fp7d
2022-01-21,GR,16,18,2,16,2022-05-03_11-02-08,fp7d
2022-01-21,JU,6,8,2,6,2022-05-03_11-02-08,fp7d
2022-01-21,LU,59,45,0,45,2022-05-03_11-02-08,fp7d
2022-01-21,NE,10,10,0,10,2022-05-03_11-02-08,fp7d
2022-01-21,NW,6,6,0,6,2022-05-03_11-02-08,fp7d
2022-01-21,OW,0,0,0,0,2022-05-03_11-02-08,fp7d
2022-01-21,SG,54,40,1,39,2022-05-03_11-02-08,fp7d
2022-01-21,SH,8,6,0,6,2022-05-03_11-02-08,fp7d
2022-01-21,SO,17,16,0,16,2022-05-03_11-02-08,fp7d
2022-01-21,SZ,12,11,0,11,2022-05-03_11-02-08,fp7d
2022-01-21,TG,21,24,3,21,2022-05-03_11-02-08,fp7d
2022-01-21,TI,57,69,12,57,2022-05-03_11-02-08,fp7d
2022-01-21,UR,6,6,0,6,2022-05-03_11-02-08,fp7d
2022-01-21,VD,86,93,7,86,2022-05-03_11-02-08,fp7d
2022-01-21,VS,21,24,3,21,2022-05-03_11-02-08,fp7d
2022-01-21,ZG,8,8,0,8,2022-05-03_11-02-08,fp7d
2022-01-21,ZH,190,186,7,179,2022-05-03_11-02-08,fp7d
2022-01-22,AG,50,49,3,46,2022-05-03_11-02-08,fp7d
2022-01-22,AI,0,0,0,0,2022-05-03_11-02-08,fp7d
2022-01-22,AR,6,6,0,6,2022-05-03_11-02-08,fp7d
2022-01-22,BE,106,96,7,89,2022-05-03_11-02-08,fp7d
2022-01-22,BL,20,16,0,16,2022-05-03_11-02-08,fp7d
2022-01-22,BS,54,48,2,46,2022-05-03_11-02-08,fp7d
2022-01-22,FR,24,23,0,23,2022-05-03_11-02-08,fp7d
2022-01-22,GE,38,50,12,38,2022-05-03_11-02-08,fp7d
2022-01-22,GL,6,6,0,6,2022-05-03_11-02-08,fp7d
2022-01-22,GR,16,16,0,16,2022-05-03_11-02-08,fp7d
2022-01-22,JU,6,8,2,6,2022-05-03_11-02-08,fp7d
2022-01-22,LU,59,45,0,45,2022-05-03_11-02-08,fp7d
2022-01-22,NE,10,10,0,10,2022-05-03_11-02-08,fp7d
2022-01-22,NW,6,6,0,6,2022-05-03_11-02-08,fp7d
2022-01-22,OW,0,0,0,0,2022-05-03_11-02-08,fp7d
2022-01-22,SG,54,40,1,39,2022-05-03_11-02-08,fp7d
2022-01-22,SH,8,6,0,6,2022-05-03_11-02-08,fp7d
2022-01-22,SO,17,16,0,16,2022-05-03_11-02-08,fp7d
2022-01-22,SZ,12,11,0,11,2022-05-03_11-02-08,fp7d
2022-01-22,TG,21,25,4,21,2022-05-03_11-02-08,fp7d
2022-01-22,TI,57,69,12,57,2022-05-03_11-02-08,fp7d
2022-01-22,UR,6,6,0,6,2022-05-03_11-02-08,fp7d
2022-01-22,VD,86,93,7,86,2022-05-03_11-02-08,fp7d
2022-01-22,VS,21,24,3,21,2022-05-03_11-02-08,fp7d
2022-01-22,ZG,8,8,0,8,2022-05-03_11-02-08,fp7d
2022-01-22,ZH,190,183,6,177,2022-05-03_11-02-08,fp7d
2022-01-23,AG,50,49,3,46,2022-05-03_11-02-08,fp7d
2022-01-23,AI,0,0,0,0,2022-05-03_11-02-08,fp7d
2022-01-23,AR,6,6,0,6,2022-05-03_11-02-08,fp7d
2022-01-23,BE,106,97,7,90,2022-05-03_11-02-08,fp7d
2022-01-23,BL,20,16,0,16,2022-05-03_11-02-08,fp7d
2022-01-23,BS,54,48,2,46,2022-05-03_11-02-08,fp7d
2022-01-23,FR,24,23,0,23,2022-05-03_11-02-08,fp7d
2022-01-23,GE,38,50,12,38,2022-05-03_11-02-08,fp7d
2022-01-23,GL,6,6,0,6,2022-05-03_11-02-08,fp7d
2022-01-23,GR,16,16,0,16,2022-05-03_11-02-08,fp7d
2022-01-23,JU,6,8,2,6,2022-05-03_11-02-08,fp7d
2022-01-23,LU,59,45,0,45,2022-05-03_11-02-08,fp7d
2022-01-23,NE,10,10,0,10,2022-05-03_11-02-08,fp7d
2022-01-23,NW,6,6,0,6,2022-05-03_11-02-08,fp7d
2022-01-23,OW,0,0,0,0,2022-05-03_11-02-08,fp7d
2022-01-23,SG,54,40,1,39,2022-05-03_11-02-08,fp7d
2022-01-23,SH,8,6,0,6,2022-05-03_11-02-08,fp7d
2022-01-23,SO,17,16,0,16,2022-05-03_11-02-08,fp7d
2022-01-23,SZ,12,11,0,11,2022-05-03_11-02-08,fp7d
2022-01-23,TG,21,25,4,21,2022-05-03_11-02-08,fp7d
2022-01-23,TI,57,69,12,57,2022-05-03_11-02-08,fp7d
2022-01-23,UR,6,6,0,6,2022-05-03_11-02-08,fp7d
2022-01-23,VD,86,93,7,86,2022-05-03_11-02-08,fp7d
2022-01-23,VS,21,24,3,21,2022-05-03_11-02-08,fp7d
2022-01-23,ZG,8,8,0,8,2022-05-03_11-02-08,fp7d
2022-01-23,ZH,190,184,6,178,2022-05-03_11-02-08,fp7d
2022-01-24,AG,50,49,3,46,2022-05-03_11-02-08,fp7d
2022-01-24,AI,0,0,0,0,2022-05-03_11-02-08,fp7d
2022-01-24,AR,6,6,0,6,2022-05-03_11-02-08,fp7d
2022-01-24,BE,106,97,7,90,2022-05-03_11-02-08,fp7d
2022-01-24,BL,20,16,0,16,2022-05-03_11-02-08,fp7d
2022-01-24,BS,54,52,2,50,2022-05-03_11-02-08,fp7d
2022-01-24,FR,24,23,0,23,2022-05-03_11-02-08,fp7d
2022-01-24,GE,38,50,12,38,2022-05-03_11-02-08,fp7d
2022-01-24,GL,6,6,0,6,2022-05-03_11-02-08,fp7d
2022-01-24,GR,16,18,2,16,2022-05-03_11-02-08,fp7d
2022-01-24,JU,6,8,2,6,2022-05-03_11-02-08,fp7d
2022-01-24,LU,59,45,0,45,2022-05-03_11-02-08,fp7d
2022-01-24,NE,10,10,0,10,2022-05-03_11-02-08,fp7d
2022-01-24,NW,6,6,0,6,2022-05-03_11-02-08,fp7d
2022-01-24,OW,0,0,0,0,2022-05-03_11-02-08,fp7d
2022-01-24,SG,54,40,1,39,2022-05-03_11-02-08,fp7d
2022-01-24,SH,8,6,0,6,2022-05-03_11-02-08,fp7d
2022-01-24,SO,17,16,0,16,2022-05-03_11-02-08,fp7d
2022-01-24,SZ,12,11,0,11,2022-05-03_11-02-08,fp7d
2022-01-24,TG,22,25,4,21,2022-05-03_11-02-08,fp7d
2022-01-24,TI,57,69,12,57,2022-05-03_11-02-08,fp7d
2022-01-24,UR,6,6,0,6,2022-05-03_11-02-08,fp7d
2022-01-24,VD,86,93,7,86,2022-05-03_11-02-08,fp7d
2022-01-24,VS,21,24,3,21,2022-05-03_11-02-08,fp7d
2022-01-24,ZG,8,8,0,8,2022-05-03_11-02-08,fp7d
2022-01-24,ZH,190,182,6,176,2022-05-03_11-02-08,fp7d
2022-01-25,AG,50,49,3,46,2022-05-03_11-02-08,fp7d
2022-01-25,AI,0,0,0,0,2022-05-03_11-02-08,fp7d
2022-01-25,AR,6,6,0,6,2022-05-03_11-02-08,fp7d
2022-01-25,BE,106,93,3,90,2022-05-03_11-02-08,fp7d
2022-01-25,BL,20,16,0,16,2022-05-03_11-02-08,fp7d
2022-01-25,BS,54,52,2,50,2022-05-03_11-02-08,fp7d
2022-01-25,FR,24,23,0,23,2022-05-03_11-02-08,fp7d
2022-01-25,GE,38,50,12,38,2022-05-03_11-02-08,fp7d
2022-01-25,GL,6,6,0,6,2022-05-03_11-02-08,fp7d
2022-01-25,GR,16,18,2,16,2022-05-03_11-02-08,fp7d
2022-01-25,JU,6,8,2,6,2022-05-03_11-02-08,fp7d
2022-01-25,LU,59,45,0,45,2022-05-03_11-02-08,fp7d
2022-01-25,NE,10,10,0,10,2022-05-03_11-02-08,fp7d
2022-01-25,NW,5,5,0,5,2022-05-03_11-02-08,fp7d
2022-01-25,OW,0,0,0,0,2022-05-03_11-02-08,fp7d
2022-01-25,SG,54,40,1,39,2022-05-03_11-02-08,fp7d
2022-01-25,SH,8,6,0,6,2022-05-03_11-02-08,fp7d
2022-01-25,SO,17,16,0,16,2022-05-03_11-02-08,fp7d
2022-01-25,SZ,12,11,0,11,2022-05-03_11-02-08,fp7d
2022-01-25,TG,22,25,4,21,2022-05-03_11-02-08,fp7d
2022-01-25,TI,55,69,14,55,2022-05-03_11-02-08,fp7d
2022-01-25,UR,6,6,0,6,2022-05-03_11-02-08,fp7d
2022-01-25,VD,86,93,7,86,2022-05-03_11-02-08,fp7d
2022-01-25,VS,21,24,3,21,2022-05-03_11-02-08,fp7d
2022-01-25,ZG,8,8,0,8,2022-05-03_11-02-08,fp7d
2022-01-25,ZH,190,185,7,178,2022-05-03_11-02-08,fp7d
2022-01-26,AG,50,49,3,46,2022-05-03_11-02-08,fp7d
2022-01-26,AI,0,0,0,0,2022-05-03_11-02-08,fp7d
2022-01-26,AR,6,6,0,6,2022-05-03_11-02-08,fp7d
2022-01-26,BE,106,91,3,88,2022-05-03_11-02-08,fp7d
2022-01-26,BL,20,16,0,16,2022-05-03_11-02-08,fp7d
2022-01-26,BS,54,52,2,50,2022-05-03_11-02-08,fp7d
2022-01-26,FR,24,23,0,23,2022-05-03_11-02-08,fp7d
2022-01-26,GE,38,50,12,38,2022-05-03_11-02-08,fp7d
2022-01-26,GL,6,6,0,6,2022-05-03_11-02-08,fp7d
2022-01-26,GR,16,18,2,16,2022-05-03_11-02-08,fp7d
2022-01-26,JU,6,8,2,6,2022-05-03_11-02-08,fp7d
2022-01-26,LU,59,45,0,45,2022-05-03_11-02-08,fp7d
2022-01-26,NE,10,10,0,10,2022-05-03_11-02-08,fp7d
2022-01-26,NW,5,5,0,5,2022-05-03_11-02-08,fp7d
2022-01-26,OW,0,0,0,0,2022-05-03_11-02-08,fp7d
2022-01-26,SG,54,40,1,39,2022-05-03_11-02-08,fp7d
2022-01-26,SH,8,6,0,6,2022-05-03_11-02-08,fp7d
2022-01-26,SO,17,16,0,16,2022-05-03_11-02-08,fp7d
2022-01-26,SZ,12,11,0,11,2022-05-03_11-02-08,fp7d
2022-01-26,TG,22,27,6,21,2022-05-03_11-02-08,fp7d
2022-01-26,TI,55,69,14,55,2022-05-03_11-02-08,fp7d
2022-01-26,UR,6,6,0,6,2022-05-03_11-02-08,fp7d
2022-01-26,VD,86,93,7,86,2022-05-03_11-02-08,fp7d
2022-01-26,VS,22,24,2,22,2022-05-03_11-02-08,fp7d
2022-01-26,ZG,8,8,0,8,2022-05-03_11-02-08,fp7d
2022-01-26,ZH,190,185,7,178,2022-05-03_11-02-08,fp7d
2022-01-27,AG,50,49,3,46,2022-05-03_11-02-08,fp7d
2022-01-27,AI,0,0,0,0,2022-05-03_11-02-08,fp7d
2022-01-27,AR,6,6,0,6,2022-05-03_11-02-08,fp7d
2022-01-27,BE,106,91,3,88,2022-05-03_11-02-08,fp7d
2022-01-27,BL,20,16,0,16,2022-05-03_11-02-08,fp7d
2022-01-27,BS,54,52,2,50,2022-05-03_11-02-08,fp7d
2022-01-27,FR,24,23,0,23,2022-05-03_11-02-08,fp7d
2022-01-27,GE,38,50,12,38,2022-05-03_11-02-08,fp7d
2022-01-27,GL,6,6,0,6,2022-05-03_11-02-08,fp7d
2022-01-27,GR,16,18,2,16,2022-05-03_11-02-08,fp7d
2022-01-27,JU,6,8,2,6,2022-05-03_11-02-08,fp7d
2022-01-27,LU,59,44,0,44,2022-05-03_11-02-08,fp7d
2022-01-27,NE,10,10,0,10,2022-05-03_11-02-08,fp7d
2022-01-27,NW,5,5,0,5,2022-05-03_11-02-08,fp7d
2022-01-27,OW,0,0,0,0,2022-05-03_11-02-08,fp7d
2022-01-27,SG,54,40,1,39,2022-05-03_11-02-08,fp7d
2022-01-27,SH,8,7,0,7,2022-05-03_11-02-08,fp7d
2022-01-27,SO,17,16,0,16,2022-05-03_11-02-08,fp7d
2022-01-27,SZ,12,11,0,11,2022-05-03_11-02-08,fp7d
2022-01-27,TG,22,27,6,21,2022-05-03_11-02-08,fp7d
2022-01-27,TI,55,69,14,55,2022-05-03_11-02-08,fp7d
2022-01-27,UR,6,6,0,6,2022-05-03_11-02-08,fp7d
2022-01-27,VD,86,93,7,86,2022-05-03_11-02-08,fp7d
2022-01-27,VS,22,24,2,22,2022-05-03_11-02-08,fp7d
2022-01-27,ZG,8,8,0,8,2022-05-03_11-02-08,fp7d
2022-01-27,ZH,190,185,8,177,2022-05-03_11-02-08,fp7d
2022-01-28,AG,50,49,3,46,2022-05-03_11-02-08,fp7d
2022-01-28,AI,0,0,0,0,2022-05-03_11-02-08,fp7d
2022-01-28,AR,6,6,0,6,2022-05-03_11-02-08,fp7d
2022-01-28,BE,105,90,3,87,2022-05-03_11-02-08,fp7d
2022-01-28,BL,20,16,0,16,2022-05-03_11-02-08,fp7d
2022-01-28,BS,54,52,2,50,2022-05-03_11-02-08,fp7d
2022-01-28,FR,24,23,0,23,2022-05-03_11-02-08,fp7d
2022-01-28,GE,38,50,12,38,2022-05-03_11-02-08,fp7d
2022-01-28,GL,5,6,1,5,2022-05-03_11-02-08,fp7d
2022-01-28,GR,16,18,2,16,2022-05-03_11-02-08,fp7d
2022-01-28,JU,6,8,2,6,2022-05-03_11-02-08,fp7d
2022-01-28,LU,59,45,0,45,2022-05-03_11-02-08,fp7d
2022-01-28,NE,10,10,0,10,2022-05-03_11-02-08,fp7d
2022-01-28,NW,5,5,0,5,2022-05-03_11-02-08,fp7d
2022-01-28,OW,0,0,0,0,2022-05-03_11-02-08,fp7d
2022-01-28,SG,54,40,1,39,2022-05-03_11-02-08,fp7d
2022-01-28,SH,8,6,0,6,2022-05-03_11-02-08,fp7d
2022-01-28,SO,17,17,0,17,2022-05-03_11-02-08,fp7d
2022-01-28,SZ,12,11,0,11,2022-05-03_11-02-08,fp7d
2022-01-28,TG,22,27,6,21,2022-05-03_11-02-08,fp7d
2022-01-28,TI,55,69,14,55,2022-05-03_11-02-08,fp7d
2022-01-28,UR,6,6,0,6,2022-05-03_11-02-08,fp7d
2022-01-28,VD,86,93,7,86,2022-05-03_11-02-08,fp7d
2022-01-28,VS,22,24,2,22,2022-05-03_11-02-08,fp7d
2022-01-28,ZG,8,8,0,8,2022-05-03_11-02-08,fp7d
2022-01-28,ZH,190,184,7,177,2022-05-03_11-02-08,fp7d
2022-01-29,AG,50,49,3,46,2022-05-03_11-02-08,fp7d
2022-01-29,AI,0,0,0,0,2022-05-03_11-02-08,fp7d
2022-01-29,AR,6,6,0,6,2022-05-03_11-02-08,fp7d
2022-01-29,BE,105,88,3,85,2022-05-03_11-02-08,fp7d
2022-01-29,BL,20,16,0,16,2022-05-03_11-02-08,fp7d
2022-01-29,BS,54,48,2,46,2022-05-03_11-02-08,fp7d
2022-01-29,FR,24,23,0,23,2022-05-03_11-02-08,fp7d
2022-01-29,GE,38,50,12,38,2022-05-03_11-02-08,fp7d
2022-01-29,GL,5,6,1,5,2022-05-03_11-02-08,fp7d
2022-01-29,GR,16,18,2,16,2022-05-03_11-02-08,fp7d
2022-01-29,JU,6,8,2,6,2022-05-03_11-02-08,fp7d
2022-01-29,LU,59,45,0,45,2022-05-03_11-02-08,fp7d
2022-01-29,NE,10,10,0,10,2022-05-03_11-02-08,fp7d
2022-01-29,NW,6,6,0,6,2022-05-03_11-02-08,fp7d
2022-01-29,OW,0,0,0,0,2022-05-03_11-02-08,fp7d
2022-01-29,SG,54,40,1,39,2022-05-03_11-02-08,fp7d
2022-01-29,SH,8,6,0,6,2022-05-03_11-02-08,fp7d
2022-01-29,SO,17,16,0,16,2022-05-03_11-02-08,fp7d
2022-01-29,SZ,12,11,0,11,2022-05-03_11-02-08,fp7d
2022-01-29,TG,22,27,6,21,2022-05-03_11-02-08,fp7d
2022-01-29,TI,55,67,12,55,2022-05-03_11-02-08,fp7d
2022-01-29,UR,6,6,0,6,2022-05-03_11-02-08,fp7d
2022-01-29,VD,86,93,7,86,2022-05-03_11-02-08,fp7d
2022-01-29,VS,22,24,2,22,2022-05-03_11-02-08,fp7d
2022-01-29,ZG,8,8,0,8,2022-05-03_11-02-08,fp7d
2022-01-29,ZH,190,185,8,177,2022-05-03_11-02-08,fp7d
2022-01-30,AG,50,49,3,46,2022-05-03_11-02-08,fp7d
2022-01-30,AI,0,0,0,0,2022-05-03_11-02-08,fp7d
2022-01-30,AR,6,6,0,6,2022-05-03_11-02-08,fp7d
2022-01-30,BE,105,88,3,85,2022-05-03_11-02-08,fp7d
2022-01-30,BL,20,16,0,16,2022-05-03_11-02-08,fp7d
2022-01-30,BS,54,48,2,46,2022-05-03_11-02-08,fp7d
2022-01-30,FR,24,23,0,23,2022-05-03_11-02-08,fp7d
2022-01-30,GE,38,50,12,38,2022-05-03_11-02-08,fp7d
2022-01-30,GL,5,6,1,5,2022-05-03_11-02-08,fp7d
2022-01-30,GR,16,18,2,16,2022-05-03_11-02-08,fp7d
2022-01-30,JU,6,6,0,6,2022-05-03_11-02-08,fp7d
2022-01-30,LU,59,45,0,45,2022-05-03_11-02-08,fp7d
2022-01-30,NE,10,10,0,10,2022-05-03_11-02-08,fp7d
2022-01-30,NW,6,6,0,6,2022-05-03_11-02-08,fp7d
2022-01-30,OW,0,0,0,0,2022-05-03_11-02-08,fp7d
2022-01-30,SG,54,40,1,39,2022-05-03_11-02-08,fp7d
2022-01-30,SH,8,6,0,6,2022-05-03_11-02-08,fp7d
2022-01-30,SO,17,16,0,16,2022-05-03_11-02-08,fp7d
2022-01-30,SZ,12,11,0,11,2022-05-03_11-02-08,fp7d
2022-01-30,TG,22,27,6,21,2022-05-03_11-02-08,fp7d
2022-01-30,TI,55,67,12,55,2022-05-03_11-02-08,fp7d
2022-01-30,UR,6,6,0,6,2022-05-03_11-02-08,fp7d
2022-01-30,VD,86,93,7,86,2022-05-03_11-02-08,fp7d
2022-01-30,VS,22,24,2,22,2022-05-03_11-02-08,fp7d
2022-01-30,ZG,8,8,0,8,2022-05-03_11-02-08,fp7d
2022-01-30,ZH,190,185,8,177,2022-05-03_11-02-08,fp7d
2022-01-31,AG,50,48,2,46,2022-05-03_11-02-08,fp7d
2022-01-31,AI,0,0,0,0,2022-05-03_11-02-08,fp7d
2022-01-31,AR,6,6,0,6,2022-05-03_11-02-08,fp7d
2022-01-31,BE,105,88,3,85,2022-05-03_11-02-08,fp7d
2022-01-31,BL,20,16,0,16,2022-05-03_11-02-08,fp7d
2022-01-31,BS,54,52,2,50,2022-05-03_11-02-08,fp7d
2022-01-31,FR,24,23,0,23,2022-05-03_11-02-08,fp7d
2022-01-31,GE,38,50,12,38,2022-05-03_11-02-08,fp7d
2022-01-31,GL,6,5,0,5,2022-05-03_11-02-08,fp7d
2022-01-31,GR,16,16,0,16,2022-05-03_11-02-08,fp7d
2022-01-31,JU,6,6,0,6,2022-05-03_11-02-08,fp7d
2022-01-31,LU,59,45,0,45,2022-05-03_11-02-08,fp7d
2022-01-31,NE,10,10,0,10,2022-05-03_11-02-08,fp7d
2022-01-31,NW,6,5,0,5,2022-05-03_11-02-08,fp7d
2022-01-31,OW,0,0,0,0,2022-05-03_11-02-08,fp7d
2022-01-31,SG,54,40,1,39,2022-05-03_11-02-08,fp7d
2022-01-31,SH,8,6,0,6,2022-05-03_11-02-08,fp7d
2022-01-31,SO,17,18,1,17,2022-05-03_11-02-08,fp7d
2022-01-31,SZ,12,11,0,11,2022-05-03_11-02-08,fp7d
2022-01-31,TG,21,27,6,21,2022-05-03_11-02-08,fp7d
2022-01-31,TI,55,67,12,55,2022-05-03_11-02-08,fp7d
2022-01-31,UR,6,6,0,6,2022-05-03_11-02-08,fp7d
2022-01-31,VD,94,101,7,94,2022-05-03_11-02-08,fp7d
2022-01-31,VS,22,24,2,22,2022-05-03_11-02-08,fp7d
2022-01-31,ZG,8,8,0,8,2022-05-03_11-02-08,fp7d
2022-01-31,ZH,190,186,7,179,2022-05-03_11-02-08,fp7d
2022-02-01,AG,50,48,2,46,2022-05-03_11-02-08,fp7d
2022-02-01,AI,0,0,0,0,2022-05-03_11-02-08,fp7d
2022-02-01,AR,6,6,0,6,2022-05-03_11-02-08,fp7d
2022-02-01,BE,105,88,3,85,2022-05-03_11-02-08,fp7d
2022-02-01,BL,20,15,0,15,2022-05-03_11-02-08,fp7d
2022-02-01,BS,54,52,2,50,2022-05-03_11-02-08,fp7d
2022-02-01,FR,24,23,0,23,2022-05-03_11-02-08,fp7d
2022-02-01,GE,38,50,12,38,2022-05-03_11-02-08,fp7d
2022-02-01,GL,6,5,0,5,2022-05-03_11-02-08,fp7d
2022-02-01,GR,16,18,2,16,2022-05-03_11-02-08,fp7d
2022-02-01,JU,6,6,0,6,2022-05-03_11-02-08,fp7d
2022-02-01,LU,59,45,0,45,2022-05-03_11-02-08,fp7d
2022-02-01,NE,10,10,0,10,2022-05-03_11-02-08,fp7d
2022-02-01,NW,6,5,0,5,2022-05-03_11-02-08,fp7d
2022-02-01,OW,0,0,0,0,2022-05-03_11-02-08,fp7d
2022-02-01,SG,54,40,1,39,2022-05-03_11-02-08,fp7d
2022-02-01,SH,8,6,0,6,2022-05-03_11-02-08,fp7d
2022-02-01,SO,17,18,1,17,2022-05-03_11-02-08,fp7d
2022-02-01,SZ,12,11,0,11,2022-05-03_11-02-08,fp7d
2022-02-01,TG,21,27,6,21,2022-05-03_11-02-08,fp7d
2022-02-01,TI,55,67,12,55,2022-05-03_11-02-08,fp7d
2022-02-01,UR,6,6,0,6,2022-05-03_11-02-08,fp7d
2022-02-01,VD,86,93,7,86,2022-05-03_11-02-08,fp7d
2022-02-01,VS,22,24,2,22,2022-05-03_11-02-08,fp7d
2022-02-01,ZG,8,8,0,8,2022-05-03_11-02-08,fp7d
2022-02-01,ZH,190,185,6,179,2022-05-03_11-02-08,fp7d
2022-02-02,AG,50,48,2,46,2022-05-03_11-02-08,fp7d
2022-02-02,AI,0,0,0,0,2022-05-03_11-02-08,fp7d
2022-02-02,AR,6,6,0,6,2022-05-03_11-02-08,fp7d
2022-02-02,BE,105,89,3,86,2022-05-03_11-02-08,fp7d
2022-02-02,BL,20,15,0,15,2022-05-03_11-02-08,fp7d
2022-02-02,BS,54,52,2,50,2022-05-03_11-02-08,fp7d
2022-02-02,FR,24,23,0,23,2022-05-03_11-02-08,fp7d
2022-02-02,GE,38,50,12,38,2022-05-03_11-02-08,fp7d
2022-02-02,GL,6,5,0,5,2022-05-03_11-02-08,fp7d
2022-02-02,GR,16,18,2,16,2022-05-03_11-02-08,fp7d
2022-02-02,JU,6,6,0,6,2022-05-03_11-02-08,fp7d
2022-02-02,LU,59,47,0,47,2022-05-03_11-02-08,fp7d
2022-02-02,NE,10,10,0,10,2022-05-03_11-02-08,fp7d
2022-02-02,NW,6,5,0,5,2022-05-03_11-02-08,fp7d
2022-02-02,OW,0,0,0,0,2022-05-03_11-02-08,fp7d
2022-02-02,SG,54,43,1,42,2022-05-03_11-02-08,fp7d
2022-02-02,SH,8,6,0,6,2022-05-03_11-02-08,fp7d
2022-02-02,SO,17,18,1,17,2022-05-03_11-02-08,fp7d
2022-02-02,SZ,12,11,0,11,2022-05-03_11-02-08,fp7d
2022-02-02,TG,21,27,6,21,2022-05-03_11-02-08,fp7d
2022-02-02,TI,55,67,12,55,2022-05-03_11-02-08,fp7d
2022-02-02,UR,6,6,0,6,2022-05-03_11-02-08,fp7d
2022-02-02,VD,86,93,7,86,2022-05-03_11-02-08,fp7d
2022-02-02,VS,22,24,2,22,2022-05-03_11-02-08,fp7d
2022-02-02,ZG,8,8,0,8,2022-05-03_11-02-08,fp7d
2022-02-02,ZH,190,186,7,179,2022-05-03_11-02-08,fp7d
2022-02-03,AG,50,48,2,46,2022-05-03_11-02-08,fp7d
2022-02-03,AI,0,0,0,0,2022-05-03_11-02-08,fp7d
2022-02-03,AR,6,6,0,6,2022-05-03_11-02-08,fp7d
2022-02-03,BE,105,88,3,85,2022-05-03_11-02-08,fp7d
2022-02-03,BL,20,15,0,15,2022-05-03_11-02-08,fp7d
2022-02-03,BS,54,52,2,50,2022-05-03_11-02-08,fp7d
2022-02-03,FR,24,23,0,23,2022-05-03_11-02-08,fp7d
2022-02-03,GE,38,50,12,38,2022-05-03_11-02-08,fp7d
2022-02-03,GL,6,5,0,5,2022-05-03_11-02-08,fp7d
2022-02-03,GR,16,18,2,16,2022-05-03_11-02-08,fp7d
2022-02-03,JU,6,6,0,6,2022-05-03_11-02-08,fp7d
2022-02-03,LU,59,47,0,47,2022-05-03_11-02-08,fp7d
2022-02-03,NE,10,10,0,10,2022-05-03_11-02-08,fp7d
2022-02-03,NW,6,6,0,6,2022-05-03_11-02-08,fp7d
2022-02-03,OW,0,0,0,0,2022-05-03_11-02-08,fp7d
2022-02-03,SG,54,47,1,46,2022-05-03_11-02-08,fp7d
2022-02-03,SH,8,6,0,6,2022-05-03_11-02-08,fp7d
2022-02-03,SO,17,18,1,17,2022-05-03_11-02-08,fp7d
2022-02-03,SZ,12,10,0,10,2022-05-03_11-02-08,fp7d
2022-02-03,TG,21,27,6,21,2022-05-03_11-02-08,fp7d
2022-02-03,TI,55,67,12,55,2022-05-03_11-02-08,fp7d
2022-02-03,UR,6,6,0,6,2022-05-03_11-02-08,fp7d
2022-02-03,VD,86,93,7,86,2022-05-03_11-02-08,fp7d
2022-02-03,VS,22,24,2,22,2022-05-03_11-02-08,fp7d
2022-02-03,ZG,8,8,0,8,2022-05-03_11-02-08,fp7d
2022-02-03,ZH,190,187,9,178,2022-05-03_11-02-08,fp7d
2022-02-04,AG,50,48,2,46,2022-05-03_11-02-08,fp7d
2022-02-04,AI,0,0,0,0,2022-05-03_11-02-08,fp7d
2022-02-04,AR,6,6,0,6,2022-05-03_11-02-08,fp7d
2022-02-04,BE,105,87,3,84,2022-05-03_11-02-08,fp7d
2022-02-04,BL,20,15,0,15,2022-05-03_11-02-08,fp7d
2022-02-04,BS,54,52,2,50,2022-05-03_11-02-08,fp7d
2022-02-04,FR,24,23,0,23,2022-05-03_11-02-08,fp7d
2022-02-04,GE,38,50,12,38,2022-05-03_11-02-08,fp7d
2022-02-04,GL,6,6,0,6,2022-05-03_11-02-08,fp7d
2022-02-04,GR,16,18,2,16,2022-05-03_11-02-08,fp7d
2022-02-04,JU,6,6,0,6,2022-05-03_11-02-08,fp7d
2022-02-04,LU,59,47,0,47,2022-05-03_11-02-08,fp7d
2022-02-04,NE,8,8,0,8,2022-05-03_11-02-08,fp7d
2022-02-04,NW,6,6,0,6,2022-05-03_11-02-08,fp7d
2022-02-04,OW,0,0,0,0,2022-05-03_11-02-08,fp7d
2022-02-04,SG,54,47,1,46,2022-05-03_11-02-08,fp7d
2022-02-04,SH,8,6,0,6,2022-05-03_11-02-08,fp7d
2022-02-04,SO,17,18,1,17,2022-05-03_11-02-08,fp7d
2022-02-04,SZ,12,10,0,10,2022-05-03_11-02-08,fp7d
2022-02-04,TG,21,27,6,21,2022-05-03_11-02-08,fp7d
2022-02-04,TI,55,67,12,55,2022-05-03_11-02-08,fp7d
2022-02-04,UR,6,6,0,6,2022-05-03_11-02-08,fp7d
2022-02-04,VD,86,93,7,86,2022-05-03_11-02-08,fp7d
2022-02-04,VS,22,24,2,22,2022-05-03_11-02-08,fp7d
2022-02-04,ZG,8,8,0,8,2022-05-03_11-02-08,fp7d
2022-02-04,ZH,190,188,8,180,2022-05-03_11-02-08,fp7d
2022-02-05,AG,50,48,2,46,2022-05-03_11-02-08,fp7d
2022-02-05,AI,0,0,0,0,2022-05-03_11-02-08,fp7d
2022-02-05,AR,6,6,0,6,2022-05-03_11-02-08,fp7d
2022-02-05,BE,105,85,3,82,2022-05-03_11-02-08,fp7d
2022-02-05,BL,20,15,0,15,2022-05-03_11-02-08,fp7d
2022-02-05,BS,54,48,2,46,2022-05-03_11-02-08,fp7d
2022-02-05,FR,24,23,0,23,2022-05-03_11-02-08,fp7d
2022-02-05,GE,38,50,12,38,2022-05-03_11-02-08,fp7d
2022-02-05,GL,6,6,0,6,2022-05-03_11-02-08,fp7d
2022-02-05,GR,16,18,2,16,2022-05-03_11-02-08,fp7d
2022-02-05,JU,6,6,0,6,2022-05-03_11-02-08,fp7d
2022-02-05,LU,59,45,0,45,2022-05-03_11-02-08,fp7d
2022-02-05,NE,8,8,0,8,2022-05-03_11-02-08,fp7d
2022-02-05,NW,6,6,0,6,2022-05-03_11-02-08,fp7d
2022-02-05,OW,0,0,0,0,2022-05-03_11-02-08,fp7d
2022-02-05,SG,54,40,1,39,2022-05-03_11-02-08,fp7d
2022-02-05,SH,8,6,0,6,2022-05-03_11-02-08,fp7d
2022-02-05,SO,17,18,1,17,2022-05-03_11-02-08,fp7d
2022-02-05,SZ,12,10,0,10,2022-05-03_11-02-08,fp7d
2022-02-05,TG,21,27,6,21,2022-05-03_11-02-08,fp7d
2022-02-05,TI,55,67,12,55,2022-05-03_11-02-08,fp7d
2022-02-05,UR,6,6,0,6,2022-05-03_11-02-08,fp7d
2022-02-05,VD,86,93,7,86,2022-05-03_11-02-08,fp7d
2022-02-05,VS,21,23,2,21,2022-05-03_11-02-08,fp7d
2022-02-05,ZG,8,8,0,8,2022-05-03_11-02-08,fp7d
2022-02-05,ZH,190,190,10,180,2022-05-03_11-02-08,fp7d
2022-02-06,AG,50,48,2,46,2022-05-03_11-02-08,fp7d
2022-02-06,AI,0,0,0,0,2022-05-03_11-02-08,fp7d
2022-02-06,AR,6,6,0,6,2022-05-03_11-02-08,fp7d
2022-02-06,BE,105,84,3,81,2022-05-03_11-02-08,fp7d
2022-02-06,BL,20,15,0,15,2022-05-03_11-02-08,fp7d
2022-02-06,BS,54,48,2,46,2022-05-03_11-02-08,fp7d
2022-02-06,FR,24,23,0,23,2022-05-03_11-02-08,fp7d
2022-02-06,GE,38,50,12,38,2022-05-03_11-02-08,fp7d
2022-02-06,GL,6,6,0,6,2022-05-03_11-02-08,fp7d
2022-02-06,GR,16,18,2,16,2022-05-03_11-02-08,fp7d
2022-02-06,JU,6,6,0,6,2022-05-03_11-02-08,fp7d
2022-02-06,LU,59,45,0,45,2022-05-03_11-02-08,fp7d
2022-02-06,NE,8,8,0,8,2022-05-03_11-02-08,fp7d
2022-02-06,NW,6,6,0,6,2022-05-03_11-02-08,fp7d
2022-02-06,OW,0,0,0,0,2022-05-03_11-02-08,fp7d
2022-02-06,SG,54,40,1,39,2022-05-03_11-02-08,fp7d
2022-02-06,SH,8,6,0,6,2022-05-03_11-02-08,fp7d
2022-02-06,SO,17,18,1,17,2022-05-03_11-02-08,fp7d
2022-02-06,SZ,12,10,0,10,2022-05-03_11-02-08,fp7d
2022-02-06,TG,21,27,6,21,2022-05-03_11-02-08,fp7d
2022-02-06,TI,55,67,12,55,2022-05-03_11-02-08,fp7d
2022-02-06,UR,6,6,0,6,2022-05-03_11-02-08,fp7d
2022-02-06,VD,86,93,7,86,2022-05-03_11-02-08,fp7d
2022-02-06,VS,21,23,2,21,2022-05-03_11-02-08,fp7d
2022-02-06,ZG,8,8,0,8,2022-05-03_11-02-08,fp7d
2022-02-06,ZH,190,189,9,180,2022-05-03_11-02-08,fp7d
2022-02-07,AG,50,48,2,46,2022-05-03_11-02-08,fp7d
2022-02-07,AI,0,0,0,0,2022-05-03_11-02-08,fp7d
2022-02-07,AR,6,6,0,6,2022-05-03_11-02-08,fp7d
2022-02-07,BE,105,88,3,85,2022-05-03_11-02-08,fp7d
2022-02-07,BL,20,15,0,15,2022-05-03_11-02-08,fp7d
2022-02-07,BS,54,52,2,50,2022-05-03_11-02-08,fp7d
2022-02-07,FR,24,23,0,23,2022-05-03_11-02-08,fp7d
2022-02-07,GE,38,50,12,38,2022-05-03_11-02-08,fp7d
2022-02-07,GL,6,6,0,6,2022-05-03_11-02-08,fp7d
2022-02-07,GR,16,18,2,16,2022-05-03_11-02-08,fp7d
2022-02-07,JU,6,6,0,6,2022-05-03_11-02-08,fp7d
2022-02-07,LU,59,47,0,47,2022-05-03_11-02-08,fp7d
2022-02-07,NE,10,10,0,10,2022-05-03_11-02-08,fp7d
2022-02-07,NW,6,6,0,6,2022-05-03_11-02-08,fp7d
2022-02-07,OW,0,0,0,0,2022-05-03_11-02-08,fp7d
2022-02-07,SG,54,40,1,39,2022-05-03_11-02-08,fp7d
2022-02-07,SH,8,6,0,6,2022-05-03_11-02-08,fp7d
2022-02-07,SO,17,18,1,17,2022-05-03_11-02-08,fp7d
2022-02-07,SZ,12,10,0,10,2022-05-03_11-02-08,fp7d
2022-02-07,TG,21,27,6,21,2022-05-03_11-02-08,fp7d
2022-02-07,TI,55,67,12,55,2022-05-03_11-02-08,fp7d
2022-02-07,UR,6,6,0,6,2022-05-03_11-02-08,fp7d
2022-02-07,VD,86,93,7,86,2022-05-03_11-02-08,fp7d
2022-02-07,VS,21,23,2,21,2022-05-03_11-02-08,fp7d
2022-02-07,ZG,8,8,0,8,2022-05-03_11-02-08,fp7d
2022-02-07,ZH,190,191,10,181,2022-05-03_11-02-08,fp7d
2022-02-08,AG,50,48,2,46,2022-05-03_11-02-08,fp7d
2022-02-08,AI,0,0,0,0,2022-05-03_11-02-08,fp7d
2022-02-08,AR,6,6,0,6,2022-05-03_11-02-08,fp7d
2022-02-08,BE,105,88,3,85,2022-05-03_11-02-08,fp7d
2022-02-08,BL,20,16,0,16,2022-05-03_11-02-08,fp7d
2022-02-08,BS,54,52,2,50,2022-05-03_11-02-08,fp7d
2022-02-08,FR,24,23,0,23,2022-05-03_11-02-08,fp7d
2022-02-08,GE,38,50,12,38,2022-05-03_11-02-08,fp7d
2022-02-08,GL,6,6,0,6,2022-05-03_11-02-08,fp7d
2022-02-08,GR,16,17,1,16,2022-05-03_11-02-08,fp7d
2022-02-08,JU,6,6,0,6,2022-05-03_11-02-08,fp7d
2022-02-08,LU,59,47,0,47,2022-05-03_11-02-08,fp7d
2022-02-08,NE,10,10,0,10,2022-05-03_11-02-08,fp7d
2022-02-08,NW,6,6,0,6,2022-05-03_11-02-08,fp7d
2022-02-08,OW,0,0,0,0,2022-05-03_11-02-08,fp7d
2022-02-08,SG,54,44,1,43,2022-05-03_11-02-08,fp7d
2022-02-08,SH,8,7,0,7,2022-05-03_11-02-08,fp7d
2022-02-08,SO,17,18,1,17,2022-05-03_11-02-08,fp7d
2022-02-08,SZ,12,10,0,10,2022-05-03_11-02-08,fp7d
2022-02-08,TG,21,27,6,21,2022-05-03_11-02-08,fp7d
2022-02-08,TI,55,67,12,55,2022-05-03_11-02-08,fp7d
2022-02-08,UR,6,6,0,6,2022-05-03_11-02-08,fp7d
2022-02-08,VD,86,93,7,86,2022-05-03_11-02-08,fp7d
2022-02-08,VS,21,23,2,21,2022-05-03_11-02-08,fp7d
2022-02-08,ZG,8,8,0,8,2022-05-03_11-02-08,fp7d
2022-02-08,ZH,190,191,10,181,2022-05-03_11-02-08,fp7d
2022-02-09,AG,50,48,2,46,2022-05-03_11-02-08,fp7d
2022-02-09,AI,0,0,0,0,2022-05-03_11-02-08,fp7d
2022-02-09,AR,6,6,0,6,2022-05-03_11-02-08,fp7d
2022-02-09,BE,105,87,3,84,2022-05-03_11-02-08,fp7d
2022-02-09,BL,20,15,0,15,2022-05-03_11-02-08,fp7d
2022-02-09,BS,54,52,2,50,2022-05-03_11-02-08,fp7d
2022-02-09,FR,24,23,0,23,2022-05-03_11-02-08,fp7d
2022-02-09,GE,38,50,12,38,2022-05-03_11-02-08,fp7d
2022-02-09,GL,6,6,0,6,2022-05-03_11-02-08,fp7d
2022-02-09,GR,16,18,2,16,2022-05-03_11-02-08,fp7d
2022-02-09,JU,6,6,0,6,2022-05-03_11-02-08,fp7d
2022-02-09,LU,59,47,0,47,2022-05-03_11-02-08,fp7d
2022-02-09,NE,10,10,0,10,2022-05-03_11-02-08,fp7d
2022-02-09,NW,6,6,0,6,2022-05-03_11-02-08,fp7d
2022-02-09,OW,0,0,0,0,2022-05-03_11-02-08,fp7d
2022-02-09,SG,54,40,1,39,2022-05-03_11-02-08,fp7d
2022-02-09,SH,8,7,0,7,2022-05-03_11-02-08,fp7d
2022-02-09,SO,17,17,0,17,2022-05-03_11-02-08,fp7d
2022-02-09,SZ,12,10,0,10,2022-05-03_11-02-08,fp7d
2022-02-09,TG,21,27,6,21,2022-05-03_11-02-08,fp7d
2022-02-09,TI,55,67,12,55,2022-05-03_11-02-08,fp7d
2022-02-09,UR,6,6,0,6,2022-05-03_11-02-08,fp7d
2022-02-09,VD,86,93,7,86,2022-05-03_11-02-08,fp7d
2022-02-09,VS,21,23,2,21,2022-05-03_11-02-08,fp7d
2022-02-09,ZG,8,8,0,8,2022-05-03_11-02-08,fp7d
2022-02-09,ZH,190,193,11,182,2022-05-03_11-02-08,fp7d
2022-02-10,AG,50,48,2,46,2022-05-03_11-02-08,fp7d
2022-02-10,AI,0,0,0,0,2022-05-03_11-02-08,fp7d
2022-02-10,AR,6,6,0,6,2022-05-03_11-02-08,fp7d
2022-02-10,BE,105,86,3,83,2022-05-03_11-02-08,fp7d
2022-02-10,BL,20,15,0,15,2022-05-03_11-02-08,fp7d
2022-02-10,BS,54,52,2,50,2022-05-03_11-02-08,fp7d
2022-02-10,FR,24,23,0,23,2022-05-03_11-02-08,fp7d
2022-02-10,GE,38,50,12,38,2022-05-03_11-02-08,fp7d
2022-02-10,GL,6,6,0,6,2022-05-03_11-02-08,fp7d
2022-02-10,GR,16,18,2,16,2022-05-03_11-02-08,fp7d
2022-02-10,JU,6,6,0,6,2022-05-03_11-02-08,fp7d
2022-02-10,LU,59,47,0,47,2022-05-03_11-02-08,fp7d
2022-02-10,NE,10,10,0,10,2022-05-03_11-02-08,fp7d
2022-02-10,NW,6,6,0,6,2022-05-03_11-02-08,fp7d
2022-02-10,OW,0,0,0,0,2022-05-03_11-02-08,fp7d
2022-02-10,SG,54,40,1,39,2022-05-03_11-02-08,fp7d
2022-02-10,SH,8,7,0,7,2022-05-03_11-02-08,fp7d
2022-02-10,SO,17,18,1,17,2022-05-03_11-02-08,fp7d
2022-02-10,SZ,12,10,0,10,2022-05-03_11-02-08,fp7d
2022-02-10,TG,21,27,6,21,2022-05-03_11-02-08,fp7d
2022-02-10,TI,55,67,12,55,2022-05-03_11-02-08,fp7d
2022-02-10,UR,6,6,0,6,2022-05-03_11-02-08,fp7d
2022-02-10,VD,86,93,7,86,2022-05-03_11-02-08,fp7d
2022-02-10,VS,21,23,2,21,2022-05-03_11-02-08,fp7d
2022-02-10,ZG,8,8,0,8,2022-05-03_11-02-08,fp7d
2022-02-10,ZH,190,192,10,182,2022-05-03_11-02-08,fp7d
2022-02-11,AG,50,48,2,46,2022-05-03_11-02-08,fp7d
2022-02-11,AI,0,0,0,0,2022-05-03_11-02-08,fp7d
2022-02-11,AR,6,6,0,6,2022-05-03_11-02-08,fp7d
2022-02-11,BE,105,87,3,84,2022-05-03_11-02-08,fp7d
2022-02-11,BL,20,15,0,15,2022-05-03_11-02-08,fp7d
2022-02-11,BS,54,52,2,50,2022-05-03_11-02-08,fp7d
2022-02-11,FR,24,23,0,23,2022-05-03_11-02-08,fp7d
2022-02-11,GE,38,50,12,38,2022-05-03_11-02-08,fp7d
2022-02-11,GL,6,6,0,6,2022-05-03_11-02-08,fp7d
2022-02-11,GR,16,16,0,16,2022-05-03_11-02-08,fp7d
2022-02-11,JU,6,6,0,6,2022-05-03_11-02-08,fp7d
2022-02-11,LU,59,47,0,47,2022-05-03_11-02-08,fp7d
2022-02-11,NE,10,10,0,10,2022-05-03_11-02-08,fp7d
2022-02-11,NW,6,6,0,6,2022-05-03_11-02-08,fp7d
2022-02-11,OW,0,0,0,0,2022-05-03_11-02-08,fp7d
2022-02-11,SG,54,40,1,39,2022-05-03_11-02-08,fp7d
2022-02-11,SH,8,7,0,7,2022-05-03_11-02-08,fp7d
2022-02-11,SO,17,18,1,17,2022-05-03_11-02-08,fp7d
2022-02-11,SZ,12,10,0,10,2022-05-03_11-02-08,fp7d
2022-02-11,TG,21,27,6,21,2022-05-03_11-02-08,fp7d
2022-02-11,TI,55,67,12,55,2022-05-03_11-02-08,fp7d
2022-02-11,UR,6,6,0,6,2022-05-03_11-02-08,fp7d
2022-02-11,VD,86,93,7,86,2022-05-03_11-02-08,fp7d
2022-02-11,VS,21,23,2,21,2022-05-03_11-02-08,fp7d
2022-02-11,ZG,8,8,0,8,2022-05-03_11-02-08,fp7d
2022-02-11,ZH,190,191,9,182,2022-05-03_11-02-08,fp7d
2022-02-12,AG,50,48,2,46,2022-05-03_11-02-08,fp7d
2022-02-12,AI,0,0,0,0,2022-05-03_11-02-08,fp7d
2022-02-12,AR,6,6,0,6,2022-05-03_11-02-08,fp7d
2022-02-12,BE,105,87,3,84,2022-05-03_11-02-08,fp7d
2022-02-12,BL,20,15,0,15,2022-05-03_11-02-08,fp7d
2022-02-12,BS,54,48,2,46,2022-05-03_11-02-08,fp7d
2022-02-12,FR,24,23,0,23,2022-05-03_11-02-08,fp7d
2022-02-12,GE,38,50,12,38,2022-05-03_11-02-08,fp7d
2022-02-12,GL,6,6,0,6,2022-05-03_11-02-08,fp7d
2022-02-12,GR,16,16,0,16,2022-05-03_11-02-08,fp7d
2022-02-12,JU,6,6,0,6,2022-05-03_11-02-08,fp7d
2022-02-12,LU,59,44,0,44,2022-05-03_11-02-08,fp7d
2022-02-12,NE,10,10,0,10,2022-05-03_11-02-08,fp7d
2022-02-12,NW,6,6,0,6,2022-05-03_11-02-08,fp7d
2022-02-12,OW,0,0,0,0,2022-05-03_11-02-08,fp7d
2022-02-12,SG,54,40,1,39,2022-05-03_11-02-08,fp7d
2022-02-12,SH,8,7,0,7,2022-05-03_11-02-08,fp7d
2022-02-12,SO,17,18,1,17,2022-05-03_11-02-08,fp7d
2022-02-12,SZ,12,10,0,10,2022-05-03_11-02-08,fp7d
2022-02-12,TG,21,27,6,21,2022-05-03_11-02-08,fp7d
2022-02-12,TI,55,67,12,55,2022-05-03_11-02-08,fp7d
2022-02-12,UR,6,6,0,6,2022-05-03_11-02-08,fp7d
2022-02-12,VD,86,93,7,86,2022-05-03_11-02-08,fp7d
2022-02-12,VS,21,23,2,21,2022-05-03_11-02-08,fp7d
2022-02-12,ZG,8,8,0,8,2022-05-03_11-02-08,fp7d
2022-02-12,ZH,190,192,10,182,2022-05-03_11-02-08,fp7d
2022-02-13,AG,50,48,2,46,2022-05-03_11-02-08,fp7d
2022-02-13,AI,0,0,0,0,2022-05-03_11-02-08,fp7d
2022-02-13,AR,6,6,0,6,2022-05-03_11-02-08,fp7d
2022-02-13,BE,105,86,3,83,2022-05-03_11-02-08,fp7d
2022-02-13,BL,20,15,0,15,2022-05-03_11-02-08,fp7d
2022-02-13,BS,54,48,2,46,2022-05-03_11-02-08,fp7d
2022-02-13,FR,24,23,0,23,2022-05-03_11-02-08,fp7d
2022-02-13,GE,38,50,12,38,2022-05-03_11-02-08,fp7d
2022-02-13,GL,6,6,0,6,2022-05-03_11-02-08,fp7d
2022-02-13,GR,16,16,0,16,2022-05-03_11-02-08,fp7d
2022-02-13,JU,6,6,0,6,2022-05-03_11-02-08,fp7d
2022-02-13,LU,59,44,0,44,2022-05-03_11-02-08,fp7d
2022-02-13,NE,10,10,0,10,2022-05-03_11-02-08,fp7d
2022-02-13,NW,6,6,0,6,2022-05-03_11-02-08,fp7d
2022-02-13,OW,0,0,0,0,2022-05-03_11-02-08,fp7d
2022-02-13,SG,54,40,1,39,2022-05-03_11-02-08,fp7d
2022-02-13,SH,8,7,0,7,2022-05-03_11-02-08,fp7d
2022-02-13,SO,17,18,1,17,2022-05-03_11-02-08,fp7d
2022-02-13,SZ,12,10,0,10,2022-05-03_11-02-08,fp7d
2022-02-13,TG,21,27,6,21,2022-05-03_11-02-08,fp7d
2022-02-13,TI,55,67,12,55,2022-05-03_11-02-08,fp7d
2022-02-13,UR,6,6,0,6,2022-05-03_11-02-08,fp7d
2022-02-13,VD,86,93,7,86,2022-05-03_11-02-08,fp7d
2022-02-13,VS,21,23,2,21,2022-05-03_11-02-08,fp7d
2022-02-13,ZG,8,8,0,8,2022-05-03_11-02-08,fp7d
2022-02-13,ZH,190,193,10,183,2022-05-03_11-02-08,fp7d
2022-02-14,AG,50,48,2,46,2022-05-03_11-02-08,fp7d
2022-02-14,AI,0,0,0,0,2022-05-03_11-02-08,fp7d
2022-02-14,AR,6,6,0,6,2022-05-03_11-02-08,fp7d
2022-02-14,BE,106,87,3,84,2022-05-03_11-02-08,fp7d
2022-02-14,BL,20,15,0,15,2022-05-03_11-02-08,fp7d
2022-02-14,BS,54,52,2,50,2022-05-03_11-02-08,fp7d
2022-02-14,FR,24,23,0,23,2022-05-03_11-02-08,fp7d
2022-02-14,GE,38,50,12,38,2022-05-03_11-02-08,fp7d
2022-02-14,GL,6,6,0,6,2022-05-03_11-02-08,fp7d
2022-02-14,GR,16,18,2,16,2022-05-03_11-02-08,fp7d
2022-02-14,JU,6,6,0,6,2022-05-03_11-02-08,fp7d
2022-02-14,LU,59,44,0,44,2022-05-03_11-02-08,fp7d
2022-02-14,NE,10,10,0,10,2022-05-03_11-02-08,fp7d
2022-02-14,NW,6,6,0,6,2022-05-03_11-02-08,fp7d
2022-02-14,OW,0,0,0,0,2022-05-03_11-02-08,fp7d
2022-02-14,SG,54,40,1,39,2022-05-03_11-02-08,fp7d
2022-02-14,SH,8,7,0,7,2022-05-03_11-02-08,fp7d
2022-02-14,SO,17,18,1,17,2022-05-03_11-02-08,fp7d
2022-02-14,SZ,12,10,0,10,2022-05-03_11-02-08,fp7d
2022-02-14,TG,21,27,6,21,2022-05-03_11-02-08,fp7d
2022-02-14,TI,55,67,12,55,2022-05-03_11-02-08,fp7d
2022-02-14,UR,6,6,0,6,2022-05-03_11-02-08,fp7d
2022-02-14,VD,86,93,7,86,2022-05-03_11-02-08,fp7d
2022-02-14,VS,21,21,0,21,2022-05-03_11-02-08,fp7d
2022-02-14,ZG,8,8,0,8,2022-05-03_11-02-08,fp7d
2022-02-14,ZH,190,188,7,181,2022-05-03_11-02-08,fp7d
2022-02-15,AG,50,48,2,46,2022-05-03_11-02-08,fp7d
2022-02-15,AI,0,0,0,0,2022-05-03_11-02-08,fp7d
2022-02-15,AR,6,6,0,6,2022-05-03_11-02-08,fp7d
2022-02-15,BE,106,88,3,85,2022-05-03_11-02-08,fp7d
2022-02-15,BL,20,15,0,15,2022-05-03_11-02-08,fp7d
2022-02-15,BS,54,52,2,50,2022-05-03_11-02-08,fp7d
2022-02-15,FR,24,23,0,23,2022-05-03_11-02-08,fp7d
2022-02-15,GE,38,50,12,38,2022-05-03_11-02-08,fp7d
2022-02-15,GL,6,6,0,6,2022-05-03_11-02-08,fp7d
2022-02-15,GR,16,18,2,16,2022-05-03_11-02-08,fp7d
2022-02-15,JU,6,6,0,6,2022-05-03_11-02-08,fp7d
2022-02-15,LU,59,45,0,45,2022-05-03_11-02-08,fp7d
2022-02-15,NE,10,10,0,10,2022-05-03_11-02-08,fp7d
2022-02-15,NW,6,6,0,6,2022-05-03_11-02-08,fp7d
2022-02-15,OW,0,0,0,0,2022-05-03_11-02-08,fp7d
2022-02-15,SG,54,40,1,39,2022-05-03_11-02-08,fp7d
2022-02-15,SH,8,7,0,7,2022-05-03_11-02-08,fp7d
2022-02-15,SO,17,18,1,17,2022-05-03_11-02-08,fp7d
2022-02-15,SZ,12,10,0,10,2022-05-03_11-02-08,fp7d
2022-02-15,TG,21,27,6,21,2022-05-03_11-02-08,fp7d
2022-02-15,TI,55,67,12,55,2022-05-03_11-02-08,fp7d
2022-02-15,UR,6,6,0,6,2022-05-03_11-02-08,fp7d
2022-02-15,VD,86,93,7,86,2022-05-03_11-02-08,fp7d
2022-02-15,VS,21,21,0,21,2022-05-03_11-02-08,fp7d
2022-02-15,ZG,8,8,0,8,2022-05-03_11-02-08,fp7d
2022-02-15,ZH,190,187,7,180,2022-05-03_11-02-08,fp7d
2022-02-16,AG,50,48,2,46,2022-05-03_11-02-08,fp7d
2022-02-16,AI,0,0,0,0,2022-05-03_11-02-08,fp7d
2022-02-16,AR,6,6,0,6,2022-05-03_11-02-08,fp7d
2022-02-16,BE,105,88,3,85,2022-05-03_11-02-08,fp7d
2022-02-16,BL,20,15,0,15,2022-05-03_11-02-08,fp7d
2022-02-16,BS,54,52,2,50,2022-05-03_11-02-08,fp7d
2022-02-16,FR,24,23,0,23,2022-05-03_11-02-08,fp7d
2022-02-16,GE,38,50,12,38,2022-05-03_11-02-08,fp7d
2022-02-16,GL,6,6,0,6,2022-05-03_11-02-08,fp7d
2022-02-16,GR,16,18,2,16,2022-05-03_11-02-08,fp7d
2022-02-16,JU,6,6,0,6,2022-05-03_11-02-08,fp7d
2022-02-16,LU,59,44,0,44,2022-05-03_11-02-08,fp7d
2022-02-16,NE,10,10,0,10,2022-05-03_11-02-08,fp7d
2022-02-16,NW,6,6,0,6,2022-05-03_11-02-08,fp7d
2022-02-16,OW,0,0,0,0,2022-05-03_11-02-08,fp7d
2022-02-16,SG,54,40,1,39,2022-05-03_11-02-08,fp7d
2022-02-16,SH,8,7,0,7,2022-05-03_11-02-08,fp7d
2022-02-16,SO,17,18,1,17,2022-05-03_11-02-08,fp7d
2022-02-16,SZ,12,10,0,10,2022-05-03_11-02-08,fp7d
2022-02-16,TG,21,26,5,21,2022-05-03_11-02-08,fp7d
2022-02-16,TI,55,67,12,55,2022-05-03_11-02-08,fp7d
2022-02-16,UR,6,6,0,6,2022-05-03_11-02-08,fp7d
2022-02-16,VD,86,93,7,86,2022-05-03_11-02-08,fp7d
2022-02-16,VS,21,21,0,21,2022-05-03_11-02-08,fp7d
2022-02-16,ZG,8,8,0,8,2022-05-03_11-02-08,fp7d
2022-02-16,ZH,190,190,8,182,2022-05-03_11-02-08,fp7d
2022-02-17,AG,50,48,2,46,2022-05-03_11-02-08,fp7d
2022-02-17,AI,0,0,0,0,2022-05-03_11-02-08,fp7d
2022-02-17,AR,6,6,0,6,2022-05-03_11-02-08,fp7d
2022-02-17,BE,105,88,3,85,2022-05-03_11-02-08,fp7d
2022-02-17,BL,20,15,0,15,2022-05-03_11-02-08,fp7d
2022-02-17,BS,54,52,2,50,2022-05-03_11-02-08,fp7d
2022-02-17,FR,24,23,0,23,2022-05-03_11-02-08,fp7d
2022-02-17,GE,38,50,12,38,2022-05-03_11-02-08,fp7d
2022-02-17,GL,6,6,0,6,2022-05-03_11-02-08,fp7d
2022-02-17,GR,16,18,2,16,2022-05-03_11-02-08,fp7d
2022-02-17,JU,6,6,0,6,2022-05-03_11-02-08,fp7d
2022-02-17,LU,59,44,0,44,2022-05-03_11-02-08,fp7d
2022-02-17,NE,10,10,0,10,2022-05-03_11-02-08,fp7d
2022-02-17,NW,6,6,0,6,2022-05-03_11-02-08,fp7d
2022-02-17,OW,0,0,0,0,2022-05-03_11-02-08,fp7d
2022-02-17,SG,54,40,1,39,2022-05-03_11-02-08,fp7d
2022-02-17,SH,8,7,0,7,2022-05-03_11-02-08,fp7d
2022-02-17,SO,17,18,1,17,2022-05-03_11-02-08,fp7d
2022-02-17,SZ,12,10,0,10,2022-05-03_11-02-08,fp7d
2022-02-17,TG,21,26,5,21,2022-05-03_11-02-08,fp7d
2022-02-17,TI,55,67,12,55,2022-05-03_11-02-08,fp7d
2022-02-17,UR,6,6,0,6,2022-05-03_11-02-08,fp7d
2022-02-17,VD,86,93,7,86,2022-05-03_11-02-08,fp7d
2022-02-17,VS,21,21,0,21,2022-05-03_11-02-08,fp7d
2022-02-17,ZG,8,8,0,8,2022-05-03_11-02-08,fp7d
2022-02-17,ZH,190,188,8,180,2022-05-03_11-02-08,fp7d
2022-02-18,AG,50,48,2,46,2022-05-03_11-02-08,fp7d
2022-02-18,AI,0,0,0,0,2022-05-03_11-02-08,fp7d
2022-02-18,AR,6,6,0,6,2022-05-03_11-02-08,fp7d
2022-02-18,BE,105,88,3,85,2022-05-03_11-02-08,fp7d
2022-02-18,BL,20,15,0,15,2022-05-03_11-02-08,fp7d
2022-02-18,BS,54,52,2,50,2022-05-03_11-02-08,fp7d
2022-02-18,FR,24,23,0,23,2022-05-03_11-02-08,fp7d
2022-02-18,GE,38,50,12,38,2022-05-03_11-02-08,fp7d
2022-02-18,GL,6,6,0,6,2022-05-03_11-02-08,fp7d
2022-02-18,GR,16,18,2,16,2022-05-03_11-02-08,fp7d
2022-02-18,JU,6,6,0,6,2022-05-03_11-02-08,fp7d
2022-02-18,LU,59,44,0,44,2022-05-03_11-02-08,fp7d
2022-02-18,NE,10,10,0,10,2022-05-03_11-02-08,fp7d
2022-02-18,NW,6,6,0,6,2022-05-03_11-02-08,fp7d
2022-02-18,OW,0,0,0,0,2022-05-03_11-02-08,fp7d
2022-02-18,SG,54,40,1,39,2022-05-03_11-02-08,fp7d
2022-02-18,SH,8,7,0,7,2022-05-03_11-02-08,fp7d
2022-02-18,SO,17,18,1,17,2022-05-03_11-02-08,fp7d
2022-02-18,SZ,12,10,0,10,2022-05-03_11-02-08,fp7d
2022-02-18,TG,21,26,5,21,2022-05-03_11-02-08,fp7d
2022-02-18,TI,55,63,8,55,2022-05-03_11-02-08,fp7d
2022-02-18,UR,6,6,0,6,2022-05-03_11-02-08,fp7d
2022-02-18,VD,86,93,7,86,2022-05-03_11-02-08,fp7d
2022-02-18,VS,21,21,0,21,2022-05-03_11-02-08,fp7d
2022-02-18,ZG,8,8,0,8,2022-05-03_11-02-08,fp7d
2022-02-18,ZH,190,188,7,181,2022-05-03_11-02-08,fp7d
2022-02-19,AG,50,48,2,46,2022-05-03_11-02-08,fp7d
2022-02-19,AI,0,0,0,0,2022-05-03_11-02-08,fp7d
2022-02-19,AR,6,6,0,6,2022-05-03_11-02-08,fp7d
2022-02-19,BE,105,86,3,83,2022-05-03_11-02-08,fp7d
2022-02-19,BL,20,15,0,15,2022-05-03_11-02-08,fp7d
2022-02-19,BS,54,48,2,46,2022-05-03_11-02-08,fp7d
2022-02-19,FR,24,23,0,23,2022-05-03_11-02-08,fp7d
2022-02-19,GE,38,50,12,38,2022-05-03_11-02-08,fp7d
2022-02-19,GL,6,6,0,6,2022-05-03_11-02-08,fp7d
2022-02-19,GR,16,18,2,16,2022-05-03_11-02-08,fp7d
2022-02-19,JU,6,6,0,6,2022-05-03_11-02-08,fp7d
2022-02-19,LU,59,44,0,44,2022-05-03_11-02-08,fp7d
2022-02-19,NE,10,10,0,10,2022-05-03_11-02-08,fp7d
2022-02-19,NW,6,6,0,6,2022-05-03_11-02-08,fp7d
2022-02-19,OW,0,0,0,0,2022-05-03_11-02-08,fp7d
2022-02-19,SG,54,40,1,39,2022-05-03_11-02-08,fp7d
2022-02-19,SH,8,7,0,7,2022-05-03_11-02-08,fp7d
2022-02-19,SO,17,18,1,17,2022-05-03_11-02-08,fp7d
2022-02-19,SZ,12,10,0,10,2022-05-03_11-02-08,fp7d
2022-02-19,TG,21,27,6,21,2022-05-03_11-02-08,fp7d
2022-02-19,TI,55,63,8,55,2022-05-03_11-02-08,fp7d
2022-02-19,UR,6,6,0,6,2022-05-03_11-02-08,fp7d
2022-02-19,VD,86,93,7,86,2022-05-03_11-02-08,fp7d
2022-02-19,VS,21,21,0,21,2022-05-03_11-02-08,fp7d
2022-02-19,ZG,8,8,0,8,2022-05-03_11-02-08,fp7d
2022-02-19,ZH,190,188,9,179,2022-05-03_11-02-08,fp7d
2022-02-20,AG,50,48,2,46,2022-05-03_11-02-08,fp7d
2022-02-20,AI,0,0,0,0,2022-05-03_11-02-08,fp7d
2022-02-20,AR,6,6,0,6,2022-05-03_11-02-08,fp7d
2022-02-20,BE,105,86,3,83,2022-05-03_11-02-08,fp7d
2022-02-20,BL,20,15,0,15,2022-05-03_11-02-08,fp7d
2022-02-20,BS,54,48,2,46,2022-05-03_11-02-08,fp7d
2022-02-20,FR,24,23,0,23,2022-05-03_11-02-08,fp7d
2022-02-20,GE,38,50,12,38,2022-05-03_11-02-08,fp7d
2022-02-20,GL,6,6,0,6,2022-05-03_11-02-08,fp7d
2022-02-20,GR,16,18,2,16,2022-05-03_11-02-08,fp7d
2022-02-20,JU,6,6,0,6,2022-05-03_11-02-08,fp7d
2022-02-20,LU,59,44,0,44,2022-05-03_11-02-08,fp7d
2022-02-20,NE,10,10,0,10,2022-05-03_11-02-08,fp7d
2022-02-20,NW,6,6,0,6,2022-05-03_11-02-08,fp7d
2022-02-20,OW,0,0,0,0,2022-05-03_11-02-08,fp7d
2022-02-20,SG,54,40,1,39,2022-05-03_11-02-08,fp7d
2022-02-20,SH,8,7,0,7,2022-05-03_11-02-08,fp7d
2022-02-20,SO,17,18,1,17,2022-05-03_11-02-08,fp7d
2022-02-20,SZ,12,10,0,10,2022-05-03_11-02-08,fp7d
2022-02-20,TG,21,27,6,21,2022-05-03_11-02-08,fp7d
2022-02-20,TI,55,63,8,55,2022-05-03_11-02-08,fp7d
2022-02-20,UR,6,6,0,6,2022-05-03_11-02-08,fp7d
2022-02-20,VD,86,93,7,86,2022-05-03_11-02-08,fp7d
2022-02-20,VS,21,21,0,21,2022-05-03_11-02-08,fp7d
2022-02-20,ZG,8,8,0,8,2022-05-03_11-02-08,fp7d
2022-02-20,ZH,190,184,7,177,2022-05-03_11-02-08,fp7d
2022-02-21,AG,50,48,2,46,2022-05-03_11-02-08,fp7d
2022-02-21,AI,0,0,0,0,2022-05-03_11-02-08,fp7d
2022-02-21,AR,6,6,0,6,2022-05-03_11-02-08,fp7d
2022-02-21,BE,105,86,3,83,2022-05-03_11-02-08,fp7d
2022-02-21,BL,20,15,0,15,2022-05-03_11-02-08,fp7d
2022-02-21,BS,54,52,2,50,2022-05-03_11-02-08,fp7d
2022-02-21,FR,24,23,0,23,2022-05-03_11-02-08,fp7d
2022-02-21,GE,38,50,12,38,2022-05-03_11-02-08,fp7d
2022-02-21,GL,6,6,0,6,2022-05-03_11-02-08,fp7d
2022-02-21,GR,16,18,2,16,2022-05-03_11-02-08,fp7d
2022-02-21,JU,6,6,0,6,2022-05-03_11-02-08,fp7d
2022-02-21,LU,59,46,0,46,2022-05-03_11-02-08,fp7d
2022-02-21,NE,10,10,0,10,2022-05-03_11-02-08,fp7d
2022-02-21,NW,6,6,0,6,2022-05-03_11-02-08,fp7d
2022-02-21,OW,0,0,0,0,2022-05-03_11-02-08,fp7d
2022-02-21,SG,54,40,1,39,2022-05-03_11-02-08,fp7d
2022-02-21,SH,8,7,0,7,2022-05-03_11-02-08,fp7d
2022-02-21,SO,17,18,1,17,2022-05-03_11-02-08,fp7d
2022-02-21,SZ,12,10,0,10,2022-05-03_11-02-08,fp7d
2022-02-21,TG,21,27,6,21,2022-05-03_11-02-08,fp7d
2022-02-21,TI,55,61,6,55,2022-05-03_11-02-08,fp7d
2022-02-21,UR,6,6,0,6,2022-05-03_11-02-08,fp7d
2022-02-21,VD,86,93,7,86,2022-05-03_11-02-08,fp7d
2022-02-21,VS,14,14,0,14,2022-05-03_11-02-08,fp7d
2022-02-21,ZG,8,8,0,8,2022-05-03_11-02-08,fp7d
2022-02-21,ZH,190,186,7,179,2022-05-03_11-02-08,fp7d
2022-02-22,AG,50,48,2,46,2022-05-03_11-02-08,fp7d
2022-02-22,AI,0,0,0,0,2022-05-03_11-02-08,fp7d
2022-02-22,AR,6,6,0,6,2022-05-03_11-02-08,fp7d
2022-02-22,BE,105,86,3,83,2022-05-03_11-02-08,fp7d
2022-02-22,BL,20,15,0,15,2022-05-03_11-02-08,fp7d
2022-02-22,BS,54,52,2,50,2022-05-03_11-02-08,fp7d
2022-02-22,FR,24,23,0,23,2022-05-03_11-02-08,fp7d
2022-02-22,GE,38,50,12,38,2022-05-03_11-02-08,fp7d
2022-02-22,GL,6,6,0,6,2022-05-03_11-02-08,fp7d
2022-02-22,GR,16,18,2,16,2022-05-03_11-02-08,fp7d
2022-02-22,JU,6,6,0,6,2022-05-03_11-02-08,fp7d
2022-02-22,LU,59,47,0,47,2022-05-03_11-02-08,fp7d
2022-02-22,NE,10,10,0,10,2022-05-03_11-02-08,fp7d
2022-02-22,NW,6,6,0,6,2022-05-03_11-02-08,fp7d
2022-02-22,OW,0,0,0,0,2022-05-03_11-02-08,fp7d
2022-02-22,SG,54,40,1,39,2022-05-03_11-02-08,fp7d
2022-02-22,SH,8,7,0,7,2022-05-03_11-02-08,fp7d
2022-02-22,SO,17,16,0,16,2022-05-03_11-02-08,fp7d
2022-02-22,SZ,12,11,0,11,2022-05-03_11-02-08,fp7d
2022-02-22,TG,21,27,6,21,2022-05-03_11-02-08,fp7d
2022-02-22,TI,55,61,6,55,2022-05-03_11-02-08,fp7d
2022-02-22,UR,6,6,0,6,2022-05-03_11-02-08,fp7d
2022-02-22,VD,86,93,7,86,2022-05-03_11-02-08,fp7d
2022-02-22,VS,14,14,0,14,2022-05-03_11-02-08,fp7d
2022-02-22,ZG,8,8,0,8,2022-05-03_11-02-08,fp7d
2022-02-22,ZH,190,188,7,181,2022-05-03_11-02-08,fp7d
2022-02-23,AG,50,48,2,46,2022-05-03_11-02-08,fp7d
2022-02-23,AI,0,0,0,0,2022-05-03_11-02-08,fp7d
2022-02-23,AR,6,6,0,6,2022-05-03_11-02-08,fp7d
2022-02-23,BE,105,85,3,82,2022-05-03_11-02-08,fp7d
2022-02-23,BL,20,15,0,15,2022-05-03_11-02-08,fp7d
2022-02-23,BS,54,52,2,50,2022-05-03_11-02-08,fp7d
2022-02-23,FR,24,23,0,23,2022-05-03_11-02-08,fp7d
2022-02-23,GE,38,56,18,38,2022-05-03_11-02-08,fp7d
2022-02-23,GL,6,6,0,6,2022-05-03_11-02-08,fp7d
2022-02-23,GR,16,18,2,16,2022-05-03_11-02-08,fp7d
2022-02-23,JU,6,6,0,6,2022-05-03_11-02-08,fp7d
2022-02-23,LU,59,47,0,47,2022-05-03_11-02-08,fp7d
2022-02-23,NE,10,10,0,10,2022-05-03_11-02-08,fp7d
2022-02-23,NW,6,6,0,6,2022-05-03_11-02-08,fp7d
2022-02-23,OW,0,0,0,0,2022-05-03_11-02-08,fp7d
2022-02-23,SG,54,40,1,39,2022-05-03_11-02-08,fp7d
2022-02-23,SH,8,7,0,7,2022-05-03_11-02-08,fp7d
2022-02-23,SO,17,16,0,16,2022-05-03_11-02-08,fp7d
2022-02-23,SZ,12,11,0,11,2022-05-03_11-02-08,fp7d
2022-02-23,TG,21,27,6,21,2022-05-03_11-02-08,fp7d
2022-02-23,TI,55,61,6,55,2022-05-03_11-02-08,fp7d
2022-02-23,UR,6,6,0,6,2022-05-03_11-02-08,fp7d
2022-02-23,VD,86,93,7,86,2022-05-03_11-02-08,fp7d
2022-02-23,VS,14,14,0,14,2022-05-03_11-02-08,fp7d
2022-02-23,ZG,8,8,0,8,2022-05-03_11-02-08,fp7d
2022-02-23,ZH,190,190,8,182,2022-05-03_11-02-08,fp7d
2022-02-24,AG,50,48,2,46,2022-05-03_11-02-08,fp7d
2022-02-24,AI,0,0,0,0,2022-05-03_11-02-08,fp7d
2022-02-24,AR,6,6,0,6,2022-05-03_11-02-08,fp7d
2022-02-24,BE,105,87,3,84,2022-05-03_11-02-08,fp7d
2022-02-24,BL,20,15,0,15,2022-05-03_11-02-08,fp7d
2022-02-24,BS,54,52,2,50,2022-05-03_11-02-08,fp7d
2022-02-24,FR,24,23,0,23,2022-05-03_11-02-08,fp7d
2022-02-24,GE,38,56,18,38,2022-05-03_11-02-08,fp7d
2022-02-24,GL,6,6,0,6,2022-05-03_11-02-08,fp7d
2022-02-24,GR,16,18,2,16,2022-05-03_11-02-08,fp7d
2022-02-24,JU,6,6,0,6,2022-05-03_11-02-08,fp7d
2022-02-24,LU,59,47,0,47,2022-05-03_11-02-08,fp7d
2022-02-24,NE,10,10,0,10,2022-05-03_11-02-08,fp7d
2022-02-24,NW,6,6,0,6,2022-05-03_11-02-08,fp7d
2022-02-24,OW,0,0,0,0,2022-05-03_11-02-08,fp7d
2022-02-24,SG,54,40,1,39,2022-05-03_11-02-08,fp7d
2022-02-24,SH,8,7,0,7,2022-05-03_11-02-08,fp7d
2022-02-24,SO,17,16,0,16,2022-05-03_11-02-08,fp7d
2022-02-24,SZ,12,11,0,11,2022-05-03_11-02-08,fp7d
2022-02-24,TG,21,27,6,21,2022-05-03_11-02-08,fp7d
2022-02-24,TI,55,61,6,55,2022-05-03_11-02-08,fp7d
2022-02-24,UR,6,6,0,6,2022-05-03_11-02-08,fp7d
2022-02-24,VD,86,93,7,86,2022-05-03_11-02-08,fp7d
2022-02-24,VS,20,20,0,20,2022-05-03_11-02-08,fp7d
2022-02-24,ZG,8,8,0,8,2022-05-03_11-02-08,fp7d
2022-02-24,ZH,190,191,8,183,2022-05-03_11-02-08,fp7d
2022-02-25,AG,50,48,2,46,2022-05-03_11-02-08,fp7d
2022-02-25,AI,0,0,0,0,2022-05-03_11-02-08,fp7d
2022-02-25,AR,6,6,0,6,2022-05-03_11-02-08,fp7d
2022-02-25,BE,105,86,3,83,2022-05-03_11-02-08,fp7d
2022-02-25,BL,20,15,0,15,2022-05-03_11-02-08,fp7d
2022-02-25,BS,54,52,2,50,2022-05-03_11-02-08,fp7d
2022-02-25,FR,24,23,0,23,2022-05-03_11-02-08,fp7d
2022-02-25,GE,38,56,18,38,2022-05-03_11-02-08,fp7d
2022-02-25,GL,6,6,0,6,2022-05-03_11-02-08,fp7d
2022-02-25,GR,16,18,2,16,2022-05-03_11-02-08,fp7d
2022-02-25,JU,6,6,0,6,2022-05-03_11-02-08,fp7d
2022-02-25,LU,59,47,0,47,2022-05-03_11-02-08,fp7d
2022-02-25,NE,10,10,0,10,2022-05-03_11-02-08,fp7d
2022-02-25,NW,6,6,0,6,2022-05-03_11-02-08,fp7d
2022-02-25,OW,0,0,0,0,2022-05-03_11-02-08,fp7d
2022-02-25,SG,54,40,1,39,2022-05-03_11-02-08,fp7d
2022-02-25,SH,8,7,0,7,2022-05-03_11-02-08,fp7d
2022-02-25,SO,17,16,0,16,2022-05-03_11-02-08,fp7d
2022-02-25,SZ,12,11,0,11,2022-05-03_11-02-08,fp7d
2022-02-25,TG,21,27,6,21,2022-05-03_11-02-08,fp7d
2022-02-25,TI,55,61,6,55,2022-05-03_11-02-08,fp7d
2022-02-25,UR,6,6,0,6,2022-05-03_11-02-08,fp7d
2022-02-25,VD,86,93,7,86,2022-05-03_11-02-08,fp7d
2022-02-25,VS,20,20,0,20,2022-05-03_11-02-08,fp7d
2022-02-25,ZG,8,8,0,8,2022-05-03_11-02-08,fp7d
2022-02-25,ZH,190,188,7,181,2022-05-03_11-02-08,fp7d
2022-02-26,AG,50,50,2,48,2022-05-03_11-02-08,fp7d
2022-02-26,AI,0,0,0,0,2022-05-03_11-02-08,fp7d
2022-02-26,AR,6,6,0,6,2022-05-03_11-02-08,fp7d
2022-02-26,BE,105,83,3,80,2022-05-03_11-02-08,fp7d
2022-02-26,BL,20,15,0,15,2022-05-03_11-02-08,fp7d
2022-02-26,BS,54,48,2,46,2022-05-03_11-02-08,fp7d
2022-02-26,FR,24,23,0,23,2022-05-03_11-02-08,fp7d
2022-02-26,GE,38,52,16,36,2022-05-03_11-02-08,fp7d
2022-02-26,GL,6,6,0,6,2022-05-03_11-02-08,fp7d
2022-02-26,GR,16,18,2,16,2022-05-03_11-02-08,fp7d
2022-02-26,JU,6,6,0,6,2022-05-03_11-02-08,fp7d
2022-02-26,LU,59,47,0,47,2022-05-03_11-02-08,fp7d
2022-02-26,NE,10,10,0,10,2022-05-03_11-02-08,fp7d
2022-02-26,NW,6,6,0,6,2022-05-03_11-02-08,fp7d
2022-02-26,OW,0,0,0,0,2022-05-03_11-02-08,fp7d
2022-02-26,SG,54,40,1,39,2022-05-03_11-02-08,fp7d
2022-02-26,SH,8,7,0,7,2022-05-03_11-02-08,fp7d
2022-02-26,SO,17,16,0,16,2022-05-03_11-02-08,fp7d
2022-02-26,SZ,12,11,0,11,2022-05-03_11-02-08,fp7d
2022-02-26,TG,21,27,6,21,2022-05-03_11-02-08,fp7d
2022-02-26,TI,55,61,6,55,2022-05-03_11-02-08,fp7d
2022-02-26,UR,6,6,0,6,2022-05-03_11-02-08,fp7d
2022-02-26,VD,86,93,7,86,2022-05-03_11-02-08,fp7d
2022-02-26,VS,20,20,0,20,2022-05-03_11-02-08,fp7d
2022-02-26,ZG,8,8,0,8,2022-05-03_11-02-08,fp7d
2022-02-26,ZH,190,190,9,181,2022-05-03_11-02-08,fp7d
2022-02-27,AG,50,48,2,46,2022-05-03_11-02-08,fp7d
2022-02-27,AI,0,0,0,0,2022-05-03_11-02-08,fp7d
2022-02-27,AR,6,6,0,6,2022-05-03_11-02-08,fp7d
2022-02-27,BE,105,83,3,80,2022-05-03_11-02-08,fp7d
2022-02-27,BL,20,15,0,15,2022-05-03_11-02-08,fp7d
2022-02-27,BS,54,48,2,46,2022-05-03_11-02-08,fp7d
2022-02-27,FR,24,23,0,23,2022-05-03_11-02-08,fp7d
2022-02-27,GE,38,51,16,35,2022-05-03_11-02-08,fp7d
2022-02-27,GL,6,6,0,6,2022-05-03_11-02-08,fp7d
2022-02-27,GR,16,18,2,16,2022-05-03_11-02-08,fp7d
2022-02-27,JU,6,6,0,6,2022-05-03_11-02-08,fp7d
2022-02-27,LU,59,45,0,45,2022-05-03_11-02-08,fp7d
2022-02-27,NE,10,10,0,10,2022-05-03_11-02-08,fp7d
2022-02-27,NW,6,6,0,6,2022-05-03_11-02-08,fp7d
2022-02-27,OW,0,0,0,0,2022-05-03_11-02-08,fp7d
2022-02-27,SG,54,40,1,39,2022-05-03_11-02-08,fp7d
2022-02-27,SH,8,7,0,7,2022-05-03_11-02-08,fp7d
2022-02-27,SO,17,16,0,16,2022-05-03_11-02-08,fp7d
2022-02-27,SZ,12,11,0,11,2022-05-03_11-02-08,fp7d
2022-02-27,TG,21,27,6,21,2022-05-03_11-02-08,fp7d
2022-02-27,TI,55,61,6,55,2022-05-03_11-02-08,fp7d
2022-02-27,UR,6,6,0,6,2022-05-03_11-02-08,fp7d
2022-02-27,VD,86,93,7,86,2022-05-03_11-02-08,fp7d
2022-02-27,VS,20,20,0,20,2022-05-03_11-02-08,fp7d
2022-02-27,ZG,8,8,0,8,2022-05-03_11-02-08,fp7d
2022-02-27,ZH,190,186,6,180,2022-05-03_11-02-08,fp7d
2022-02-28,AG,50,50,2,48,2022-05-03_11-02-08,fp7d
2022-02-28,AI,0,0,0,0,2022-05-03_11-02-08,fp7d
2022-02-28,AR,6,6,0,6,2022-05-03_11-02-08,fp7d
2022-02-28,BE,105,86,3,83,2022-05-03_11-02-08,fp7d
2022-02-28,BL,20,15,0,15,2022-05-03_11-02-08,fp7d
2022-02-28,BS,54,52,2,50,2022-05-03_11-02-08,fp7d
2022-02-28,FR,24,23,0,23,2022-05-03_11-02-08,fp7d
2022-02-28,GE,38,51,13,38,2022-05-03_11-02-08,fp7d
2022-02-28,GL,6,6,0,6,2022-05-03_11-02-08,fp7d
2022-02-28,GR,16,18,2,16,2022-05-03_11-02-08,fp7d
2022-02-28,JU,6,6,0,6,2022-05-03_11-02-08,fp7d
2022-02-28,LU,59,45,0,45,2022-05-03_11-02-08,fp7d
2022-02-28,NE,10,10,0,10,2022-05-03_11-02-08,fp7d
2022-02-28,NW,6,6,0,6,2022-05-03_11-02-08,fp7d
2022-02-28,OW,0,0,0,0,2022-05-03_11-02-08,fp7d
2022-02-28,SG,54,40,1,39,2022-05-03_11-02-08,fp7d
2022-02-28,SH,8,6,0,6,2022-05-03_11-02-08,fp7d
2022-02-28,SO,17,16,0,16,2022-05-03_11-02-08,fp7d
2022-02-28,SZ,12,11,0,11,2022-05-03_11-02-08,fp7d
2022-02-28,TG,21,27,6,21,2022-05-03_11-02-08,fp7d
2022-02-28,TI,55,61,6,55,2022-05-03_11-02-08,fp7d
2022-02-28,UR,6,6,0,6,2022-05-03_11-02-08,fp7d
2022-02-28,VD,83,92,9,83,2022-05-03_11-02-08,fp7d
2022-02-28,VS,20,20,0,20,2022-05-03_11-02-08,fp7d
2022-02-28,ZG,8,8,0,8,2022-05-03_11-02-08,fp7d
2022-02-28,ZH,190,191,9,182,2022-05-03_11-02-08,fp7d
2022-03-01,AG,50,50,2,48,2022-05-03_11-02-08,fp7d
2022-03-01,AI,0,0,0,0,2022-05-03_11-02-08,fp7d
2022-03-01,AR,6,6,0,6,2022-05-03_11-02-08,fp7d
2022-03-01,BE,105,86,3,83,2022-05-03_11-02-08,fp7d
2022-03-01,BL,20,15,0,15,2022-05-03_11-02-08,fp7d
2022-03-01,BS,54,52,2,50,2022-05-03_11-02-08,fp7d
2022-03-01,FR,24,23,0,23,2022-05-03_11-02-08,fp7d
2022-03-01,GE,38,51,13,38,2022-05-03_11-02-08,fp7d
2022-03-01,GL,6,6,0,6,2022-05-03_11-02-08,fp7d
2022-03-01,GR,16,18,2,16,2022-05-03_11-02-08,fp7d
2022-03-01,JU,6,6,0,6,2022-05-03_11-02-08,fp7d
2022-03-01,LU,59,44,0,44,2022-05-03_11-02-08,fp7d
2022-03-01,NE,10,10,0,10,2022-05-03_11-02-08,fp7d
2022-03-01,NW,6,6,0,6,2022-05-03_11-02-08,fp7d
2022-03-01,OW,0,0,0,0,2022-05-03_11-02-08,fp7d
2022-03-01,SG,54,40,1,39,2022-05-03_11-02-08,fp7d
2022-03-01,SH,8,6,0,6,2022-05-03_11-02-08,fp7d
2022-03-01,SO,17,16,0,16,2022-05-03_11-02-08,fp7d
2022-03-01,SZ,12,11,0,11,2022-05-03_11-02-08,fp7d
2022-03-01,TG,21,27,6,21,2022-05-03_11-02-08,fp7d
2022-03-01,TI,55,61,6,55,2022-05-03_11-02-08,fp7d
2022-03-01,UR,6,6,0,6,2022-05-03_11-02-08,fp7d
2022-03-01,VD,83,92,9,83,2022-05-03_11-02-08,fp7d
2022-03-01,VS,20,20,0,20,2022-05-03_11-02-08,fp7d
2022-03-01,ZG,8,8,0,8,2022-05-03_11-02-08,fp7d
2022-03-01,ZH,190,190,10,180,2022-05-03_11-02-08,fp7d
2022-03-02,AG,50,50,2,48,2022-05-03_11-02-08,fp7d
2022-03-02,AI,0,0,0,0,2022-05-03_11-02-08,fp7d
2022-03-02,AR,6,6,0,6,2022-05-03_11-02-08,fp7d
2022-03-02,BE,105,88,3,85,2022-05-03_11-02-08,fp7d
2022-03-02,BL,20,15,0,15,2022-05-03_11-02-08,fp7d
2022-03-02,BS,54,52,2,50,2022-05-03_11-02-08,fp7d
2022-03-02,FR,24,23,0,23,2022-05-03_11-02-08,fp7d
2022-03-02,GE,43,51,8,43,2022-05-03_11-02-08,fp7d
2022-03-02,GL,6,6,0,6,2022-05-03_11-02-08,fp7d
2022-03-02,GR,16,18,2,16,2022-05-03_11-02-08,fp7d
2022-03-02,JU,6,6,0,6,2022-05-03_11-02-08,fp7d
2022-03-02,LU,59,44,0,44,2022-05-03_11-02-08,fp7d
2022-03-02,NE,10,10,0,10,2022-05-03_11-02-08,fp7d
2022-03-02,NW,6,6,0,6,2022-05-03_11-02-08,fp7d
2022-03-02,OW,0,0,0,0,2022-05-03_11-02-08,fp7d
2022-03-02,SG,54,40,1,39,2022-05-03_11-02-08,fp7d
2022-03-02,SH,8,6,0,6,2022-05-03_11-02-08,fp7d
2022-03-02,SO,17,16,0,16,2022-05-03_11-02-08,fp7d
2022-03-02,SZ,12,11,0,11,2022-05-03_11-02-08,fp7d
2022-03-02,TG,21,27,6,21,2022-05-03_11-02-08,fp7d
2022-03-02,TI,55,61,6,55,2022-05-03_11-02-08,fp7d
2022-03-02,UR,6,6,0,6,2022-05-03_11-02-08,fp7d
2022-03-02,VD,83,92,9,83,2022-05-03_11-02-08,fp7d
2022-03-02,VS,20,20,0,20,2022-05-03_11-02-08,fp7d
2022-03-02,ZG,8,8,0,8,2022-05-03_11-02-08,fp7d
2022-03-02,ZH,190,191,11,180,2022-05-03_11-02-08,fp7d
2022-03-03,AG,50,50,2,48,2022-05-03_11-02-08,fp7d
2022-03-03,AI,0,0,0,0,2022-05-03_11-02-08,fp7d
2022-03-03,AR,6,6,0,6,2022-05-03_11-02-08,fp7d
2022-03-03,BE,105,89,3,86,2022-05-03_11-02-08,fp7d
2022-03-03,BL,20,15,0,15,2022-05-03_11-02-08,fp7d
2022-03-03,BS,54,52,2,50,2022-05-03_11-02-08,fp7d
2022-03-03,FR,24,23,0,23,2022-05-03_11-02-08,fp7d
2022-03-03,GE,38,51,13,38,2022-05-03_11-02-08,fp7d
2022-03-03,GL,6,6,0,6,2022-05-03_11-02-08,fp7d
2022-03-03,GR,16,18,2,16,2022-05-03_11-02-08,fp7d
2022-03-03,JU,6,6,0,6,2022-05-03_11-02-08,fp7d
2022-03-03,LU,59,46,0,46,2022-05-03_11-02-08,fp7d
2022-03-03,NE,10,10,0,10,2022-05-03_11-02-08,fp7d
2022-03-03,NW,6,6,0,6,2022-05-03_11-02-08,fp7d
2022-03-03,OW,0,0,0,0,2022-05-03_11-02-08,fp7d
2022-03-03,SG,54,40,1,39,2022-05-03_11-02-08,fp7d
2022-03-03,SH,8,6,0,6,2022-05-03_11-02-08,fp7d
2022-03-03,SO,17,16,0,16,2022-05-03_11-02-08,fp7d
2022-03-03,SZ,13,12,0,12,2022-05-03_11-02-08,fp7d
2022-03-03,TG,21,27,6,21,2022-05-03_11-02-08,fp7d
2022-03-03,TI,55,61,6,55,2022-05-03_11-02-08,fp7d
2022-03-03,UR,6,6,0,6,2022-05-03_11-02-08,fp7d
2022-03-03,VD,83,93,10,83,2022-05-03_11-02-08,fp7d
2022-03-03,VS,20,20,0,20,2022-05-03_11-02-08,fp7d
2022-03-03,ZG,8,8,0,8,2022-05-03_11-02-08,fp7d
2022-03-03,ZH,190,188,8,180,2022-05-03_11-02-08,fp7d
2022-03-04,AG,50,50,2,48,2022-05-03_11-02-08,fp7d
2022-03-04,AI,0,0,0,0,2022-05-03_11-02-08,fp7d
2022-03-04,AR,6,6,0,6,2022-05-03_11-02-08,fp7d
2022-03-04,BE,105,87,1,86,2022-05-03_11-02-08,fp7d
2022-03-04,BL,20,15,0,15,2022-05-03_11-02-08,fp7d
2022-03-04,BS,54,52,2,50,2022-05-03_11-02-08,fp7d
2022-03-04,FR,24,23,0,23,2022-05-03_11-02-08,fp7d
2022-03-04,GE,38,51,13,38,2022-05-03_11-02-08,fp7d
2022-03-04,GL,6,6,0,6,2022-05-03_11-02-08,fp7d
2022-03-04,GR,16,18,2,16,2022-05-03_11-02-08,fp7d
2022-03-04,JU,6,6,0,6,2022-05-03_11-02-08,fp7d
2022-03-04,LU,59,46,0,46,2022-05-03_11-02-08,fp7d
2022-03-04,NE,10,10,0,10,2022-05-03_11-02-08,fp7d
2022-03-04,NW,6,6,0,6,2022-05-03_11-02-08,fp7d
2022-03-04,OW,0,0,0,0,2022-05-03_11-02-08,fp7d
2022-03-04,SG,54,40,1,39,2022-05-03_11-02-08,fp7d
2022-03-04,SH,8,6,0,6,2022-05-03_11-02-08,fp7d
2022-03-04,SO,17,15,0,15,2022-05-03_11-02-08,fp7d
2022-03-04,SZ,13,12,0,12,2022-05-03_11-02-08,fp7d
2022-03-04,TG,21,27,6,21,2022-05-03_11-02-08,fp7d
2022-03-04,TI,55,61,6,55,2022-05-03_11-02-08,fp7d
2022-03-04,UR,6,6,0,6,2022-05-03_11-02-08,fp7d
2022-03-04,VD,83,88,5,83,2022-05-03_11-02-08,fp7d
2022-03-04,VS,20,20,0,20,2022-05-03_11-02-08,fp7d
2022-03-04,ZG,8,8,0,8,2022-05-03_11-02-08,fp7d
2022-03-04,ZH,190,188,8,180,2022-05-03_11-02-08,fp7d
2022-03-05,AG,50,50,2,48,2022-05-03_11-02-08,fp7d
2022-03-05,AI,0,0,0,0,2022-05-03_11-02-08,fp7d
2022-03-05,AR,6,6,0,6,2022-05-03_11-02-08,fp7d
2022-03-05,BE,105,85,1,84,2022-05-03_11-02-08,fp7d
2022-03-05,BL,20,15,0,15,2022-05-03_11-02-08,fp7d
2022-03-05,BS,54,48,2,46,2022-05-03_11-02-08,fp7d
2022-03-05,FR,24,23,0,23,2022-05-03_11-02-08,fp7d
2022-03-05,GE,38,51,13,38,2022-05-03_11-02-08,fp7d
2022-03-05,GL,6,6,0,6,2022-05-03_11-02-08,fp7d
2022-03-05,GR,16,18,2,16,2022-05-03_11-02-08,fp7d
2022-03-05,JU,6,6,0,6,2022-05-03_11-02-08,fp7d
2022-03-05,LU,59,46,0,46,2022-05-03_11-02-08,fp7d
2022-03-05,NE,10,10,0,10,2022-05-03_11-02-08,fp7d
2022-03-05,NW,6,6,0,6,2022-05-03_11-02-08,fp7d
2022-03-05,OW,0,0,0,0,2022-05-03_11-02-08,fp7d
2022-03-05,SG,54,40,1,39,2022-05-03_11-02-08,fp7d
2022-03-05,SH,8,6,0,6,2022-05-03_11-02-08,fp7d
2022-03-05,SO,17,15,0,15,2022-05-03_11-02-08,fp7d
2022-03-05,SZ,13,12,0,12,2022-05-03_11-02-08,fp7d
2022-03-05,TG,21,27,6,21,2022-05-03_11-02-08,fp7d
2022-03-05,TI,55,61,6,55,2022-05-03_11-02-08,fp7d
2022-03-05,UR,6,6,0,6,2022-05-03_11-02-08,fp7d
2022-03-05,VD,83,88,5,83,2022-05-03_11-02-08,fp7d
2022-03-05,VS,20,20,0,20,2022-05-03_11-02-08,fp7d
2022-03-05,ZG,8,8,0,8,2022-05-03_11-02-08,fp7d
2022-03-05,ZH,190,188,8,180,2022-05-03_11-02-08,fp7d
2022-03-06,AG,50,50,2,48,2022-05-03_11-02-08,fp7d
2022-03-06,AI,0,0,0,0,2022-05-03_11-02-08,fp7d
2022-03-06,AR,6,6,0,6,2022-05-03_11-02-08,fp7d
2022-03-06,BE,105,84,1,83,2022-05-03_11-02-08,fp7d
2022-03-06,BL,20,15,0,15,2022-05-03_11-02-08,fp7d
2022-03-06,BS,54,48,2,46,2022-05-03_11-02-08,fp7d
2022-03-06,FR,24,23,0,23,2022-05-03_11-02-08,fp7d
2022-03-06,GE,38,51,13,38,2022-05-03_11-02-08,fp7d
2022-03-06,GL,6,6,0,6,2022-05-03_11-02-08,fp7d
2022-03-06,GR,16,18,2,16,2022-05-03_11-02-08,fp7d
2022-03-06,JU,6,6,0,6,2022-05-03_11-02-08,fp7d
2022-03-06,LU,59,46,0,46,2022-05-03_11-02-08,fp7d
2022-03-06,NE,10,10,0,10,2022-05-03_11-02-08,fp7d
2022-03-06,NW,6,6,0,6,2022-05-03_11-02-08,fp7d
2022-03-06,OW,0,0,0,0,2022-05-03_11-02-08,fp7d
2022-03-06,SG,54,40,1,39,2022-05-03_11-02-08,fp7d
2022-03-06,SH,8,6,0,6,2022-05-03_11-02-08,fp7d
2022-03-06,SO,17,15,0,15,2022-05-03_11-02-08,fp7d
2022-03-06,SZ,13,12,0,12,2022-05-03_11-02-08,fp7d
2022-03-06,TG,21,27,6,21,2022-05-03_11-02-08,fp7d
2022-03-06,TI,55,61,6,55,2022-05-03_11-02-08,fp7d
2022-03-06,UR,6,6,0,6,2022-05-03_11-02-08,fp7d
2022-03-06,VD,83,88,5,83,2022-05-03_11-02-08,fp7d
2022-03-06,VS,20,20,0,20,2022-05-03_11-02-08,fp7d
2022-03-06,ZG,8,8,0,8,2022-05-03_11-02-08,fp7d
2022-03-06,ZH,190,188,8,180,2022-05-03_11-02-08,fp7d
2022-03-07,AG,50,48,2,46,2022-05-03_11-02-08,fp7d
2022-03-07,AI,0,0,0,0,2022-05-03_11-02-08,fp7d
2022-03-07,AR,6,6,0,6,2022-05-03_11-02-08,fp7d
2022-03-07,BE,105,89,3,86,2022-05-03_11-02-08,fp7d
2022-03-07,BL,20,15,0,15,2022-05-03_11-02-08,fp7d
2022-03-07,BS,54,52,2,50,2022-05-03_11-02-08,fp7d
2022-03-07,FR,24,23,0,23,2022-05-03_11-02-08,fp7d
2022-03-07,GE,38,51,13,38,2022-05-03_11-02-08,fp7d
2022-03-07,GL,6,6,0,6,2022-05-03_11-02-08,fp7d
2022-03-07,GR,16,18,2,16,2022-05-03_11-02-08,fp7d
2022-03-07,JU,6,6,0,6,2022-05-03_11-02-08,fp7d
2022-03-07,LU,59,46,0,46,2022-05-03_11-02-08,fp7d
2022-03-07,NE,10,10,0,10,2022-05-03_11-02-08,fp7d
2022-03-07,NW,6,6,0,6,2022-05-03_11-02-08,fp7d
2022-03-07,OW,0,0,0,0,2022-05-03_11-02-08,fp7d
2022-03-07,SG,54,40,1,39,2022-05-03_11-02-08,fp7d
2022-03-07,SH,8,6,0,6,2022-05-03_11-02-08,fp7d
2022-03-07,SO,17,14,0,14,2022-05-03_11-02-08,fp7d
2022-03-07,SZ,13,12,0,12,2022-05-03_11-02-08,fp7d
2022-03-07,TG,21,27,6,21,2022-05-03_11-02-08,fp7d
2022-03-07,TI,55,61,6,55,2022-05-03_11-02-08,fp7d
2022-03-07,UR,6,6,0,6,2022-05-03_11-02-08,fp7d
2022-03-07,VD,83,88,5,83,2022-05-03_11-02-08,fp7d
2022-03-07,VS,20,20,0,20,2022-05-03_11-02-08,fp7d
2022-03-07,ZG,8,8,0,8,2022-05-03_11-02-08,fp7d
2022-03-07,ZH,190,188,8,180,2022-05-03_11-02-08,fp7d
2022-03-08,AG,50,48,2,46,2022-05-03_11-02-08,fp7d
2022-03-08,AI,0,0,0,0,2022-05-03_11-02-08,fp7d
2022-03-08,AR,6,6,0,6,2022-05-03_11-02-08,fp7d
2022-03-08,BE,105,89,3,86,2022-05-03_11-02-08,fp7d
2022-03-08,BL,20,15,0,15,2022-05-03_11-02-08,fp7d
2022-03-08,BS,54,52,2,50,2022-05-03_11-02-08,fp7d
2022-03-08,FR,24,23,0,23,2022-05-03_11-02-08,fp7d
2022-03-08,GE,38,51,13,38,2022-05-03_11-02-08,fp7d
2022-03-08,GL,6,6,0,6,2022-05-03_11-02-08,fp7d
2022-03-08,GR,16,18,2,16,2022-05-03_11-02-08,fp7d
2022-03-08,JU,6,6,0,6,2022-05-03_11-02-08,fp7d
2022-03-08,LU,53,41,0,41,2022-05-03_11-02-08,fp7d
2022-03-08,NE,10,10,0,10,2022-05-03_11-02-08,fp7d
2022-03-08,NW,6,6,0,6,2022-05-03_11-02-08,fp7d
2022-03-08,OW,0,0,0,0,2022-05-03_11-02-08,fp7d
2022-03-08,SG,54,40,1,39,2022-05-03_11-02-08,fp7d
2022-03-08,SH,8,6,0,6,2022-05-03_11-02-08,fp7d
2022-03-08,SO,17,15,0,15,2022-05-03_11-02-08,fp7d
2022-03-08,SZ,13,12,0,12,2022-05-03_11-02-08,fp7d
2022-03-08,TG,21,27,6,21,2022-05-03_11-02-08,fp7d
2022-03-08,TI,55,61,6,55,2022-05-03_11-02-08,fp7d
2022-03-08,UR,6,6,0,6,2022-05-03_11-02-08,fp7d
2022-03-08,VD,83,88,5,83,2022-05-03_11-02-08,fp7d
2022-03-08,VS,20,20,0,20,2022-05-03_11-02-08,fp7d
2022-03-08,ZG,8,8,0,8,2022-05-03_11-02-08,fp7d
2022-03-08,ZH,190,189,9,180,2022-05-03_11-02-08,fp7d
2022-03-09,AG,50,48,2,46,2022-05-03_11-02-08,fp7d
2022-03-09,AI,0,0,0,0,2022-05-03_11-02-08,fp7d
2022-03-09,AR,6,6,0,6,2022-05-03_11-02-08,fp7d
2022-03-09,BE,105,89,3,86,2022-05-03_11-02-08,fp7d
2022-03-09,BL,20,15,0,15,2022-05-03_11-02-08,fp7d
2022-03-09,BS,54,52,2,50,2022-05-03_11-02-08,fp7d
2022-03-09,FR,24,23,0,23,2022-05-03_11-02-08,fp7d
2022-03-09,GE,38,51,13,38,2022-05-03_11-02-08,fp7d
2022-03-09,GL,6,6,0,6,2022-05-03_11-02-08,fp7d
2022-03-09,GR,16,18,2,16,2022-05-03_11-02-08,fp7d
2022-03-09,JU,6,6,0,6,2022-05-03_11-02-08,fp7d
2022-03-09,LU,59,44,0,44,2022-05-03_11-02-08,fp7d
2022-03-09,NE,10,10,0,10,2022-05-03_11-02-08,fp7d
2022-03-09,NW,6,6,0,6,2022-05-03_11-02-08,fp7d
2022-03-09,OW,0,0,0,0,2022-05-03_11-02-08,fp7d
2022-03-09,SG,54,40,1,39,2022-05-03_11-02-08,fp7d
2022-03-09,SH,8,6,0,6,2022-05-03_11-02-08,fp7d
2022-03-09,SO,17,16,0,16,2022-05-03_11-02-08,fp7d
2022-03-09,SZ,13,12,0,12,2022-05-03_11-02-08,fp7d
2022-03-09,TG,21,27,6,21,2022-05-03_11-02-08,fp7d
2022-03-09,TI,55,61,6,55,2022-05-03_11-02-08,fp7d
2022-03-09,UR,6,6,0,6,2022-05-03_11-02-08,fp7d
2022-03-09,VD,83,88,5,83,2022-05-03_11-02-08,fp7d
2022-03-09,VS,14,14,0,14,2022-05-03_11-02-08,fp7d
2022-03-09,ZG,8,8,0,8,2022-05-03_11-02-08,fp7d
2022-03-09,ZH,190,187,7,180,2022-05-03_11-02-08,fp7d
2022-03-10,AG,50,46,2,44,2022-05-03_11-02-08,fp7d
2022-03-10,AI,0,0,0,0,2022-05-03_11-02-08,fp7d
2022-03-10,AR,6,6,0,6,2022-05-03_11-02-08,fp7d
2022-03-10,BE,106,90,3,87,2022-05-03_11-02-08,fp7d
2022-03-10,BL,20,15,0,15,2022-05-03_11-02-08,fp7d
2022-03-10,BS,54,52,2,50,2022-05-03_11-02-08,fp7d
2022-03-10,FR,24,23,0,23,2022-05-03_11-02-08,fp7d
2022-03-10,GE,38,51,13,38,2022-05-03_11-02-08,fp7d
2022-03-10,GL,6,6,0,6,2022-05-03_11-02-08,fp7d
2022-03-10,GR,16,18,2,16,2022-05-03_11-02-08,fp7d
2022-03-10,JU,6,6,0,6,2022-05-03_11-02-08,fp7d
2022-03-10,LU,59,44,0,44,2022-05-03_11-02-08,fp7d
2022-03-10,NE,10,10,0,10,2022-05-03_11-02-08,fp7d
2022-03-10,NW,6,6,0,6,2022-05-03_11-02-08,fp7d
2022-03-10,OW,0,0,0,0,2022-05-03_11-02-08,fp7d
2022-03-10,SG,54,40,1,39,2022-05-03_11-02-08,fp7d
2022-03-10,SH,8,6,0,6,2022-05-03_11-02-08,fp7d
2022-03-10,SO,17,16,0,16,2022-05-03_11-02-08,fp7d
2022-03-10,SZ,13,12,0,12,2022-05-03_11-02-08,fp7d
2022-03-10,TG,21,27,6,21,2022-05-03_11-02-08,fp7d
2022-03-10,TI,55,61,6,55,2022-05-03_11-02-08,fp7d
2022-03-10,UR,6,6,0,6,2022-05-03_11-02-08,fp7d
2022-03-10,VD,83,88,5,83,2022-05-03_11-02-08,fp7d
2022-03-10,VS,14,14,0,14,2022-05-03_11-02-08,fp7d
2022-03-10,ZG,8,8,0,8,2022-05-03_11-02-08,fp7d
2022-03-10,ZH,190,190,8,182,2022-05-03_11-02-08,fp7d
2022-03-11,AG,50,46,2,44,2022-05-03_11-02-08,fp7d
2022-03-11,AI,0,0,0,0,2022-05-03_11-02-08,fp7d
2022-03-11,AR,6,6,0,6,2022-05-03_11-02-08,fp7d
2022-03-11,BE,106,87,2,85,2022-05-03_11-02-08,fp7d
2022-03-11,BL,20,15,0,15,2022-05-03_11-02-08,fp7d
2022-03-11,BS,54,52,2,50,2022-05-03_11-02-08,fp7d
2022-03-11,FR,24,23,0,23,2022-05-03_11-02-08,fp7d
2022-03-11,GE,38,51,13,38,2022-05-03_11-02-08,fp7d
2022-03-11,GL,6,6,0,6,2022-05-03_11-02-08,fp7d
2022-03-11,GR,16,18,2,16,2022-05-03_11-02-08,fp7d
2022-03-11,JU,6,6,0,6,2022-05-03_11-02-08,fp7d
2022-03-11,LU,59,46,0,46,2022-05-03_11-02-08,fp7d
2022-03-11,NE,10,10,0,10,2022-05-03_11-02-08,fp7d
2022-03-11,NW,6,5,0,5,2022-05-03_11-02-08,fp7d
2022-03-11,OW,0,0,0,0,2022-05-03_11-02-08,fp7d
2022-03-11,SG,54,40,1,39,2022-05-03_11-02-08,fp7d
2022-03-11,SH,8,6,0,6,2022-05-03_11-02-08,fp7d
2022-03-11,SO,17,16,0,16,2022-05-03_11-02-08,fp7d
2022-03-11,SZ,13,12,0,12,2022-05-03_11-02-08,fp7d
2022-03-11,TG,21,27,6,21,2022-05-03_11-02-08,fp7d
2022-03-11,TI,55,61,6,55,2022-05-03_11-02-08,fp7d
2022-03-11,UR,6,6,0,6,2022-05-03_11-02-08,fp7d
2022-03-11,VD,86,88,2,86,2022-05-03_11-02-08,fp7d
2022-03-11,VS,14,14,0,14,2022-05-03_11-02-08,fp7d
2022-03-11,ZG,8,8,0,8,2022-05-03_11-02-08,fp7d
2022-03-11,ZH,190,187,7,180,2022-05-03_11-02-08,fp7d
2022-03-12,AG,50,46,2,44,2022-05-03_11-02-08,fp7d
2022-03-12,AI,0,0,0,0,2022-05-03_11-02-08,fp7d
2022-03-12,AR,6,6,0,6,2022-05-03_11-02-08,fp7d
2022-03-12,BE,106,86,2,84,2022-05-03_11-02-08,fp7d
2022-03-12,BL,20,15,0,15,2022-05-03_11-02-08,fp7d
2022-03-12,BS,54,48,2,46,2022-05-03_11-02-08,fp7d
2022-03-12,FR,24,23,0,23,2022-05-03_11-02-08,fp7d
2022-03-12,GE,38,51,13,38,2022-05-03_11-02-08,fp7d
2022-03-12,GL,6,6,0,6,2022-05-03_11-02-08,fp7d
2022-03-12,GR,16,18,2,16,2022-05-03_11-02-08,fp7d
2022-03-12,JU,6,6,0,6,2022-05-03_11-02-08,fp7d
2022-03-12,LU,59,45,0,45,2022-05-03_11-02-08,fp7d
2022-03-12,NE,10,10,0,10,2022-05-03_11-02-08,fp7d
2022-03-12,NW,6,6,0,6,2022-05-03_11-02-08,fp7d
2022-03-12,OW,0,0,0,0,2022-05-03_11-02-08,fp7d
2022-03-12,SG,54,40,1,39,2022-05-03_11-02-08,fp7d
2022-03-12,SH,8,6,0,6,2022-05-03_11-02-08,fp7d
2022-03-12,SO,17,16,0,16,2022-05-03_11-02-08,fp7d
2022-03-12,SZ,13,12,0,12,2022-05-03_11-02-08,fp7d
2022-03-12,TG,21,27,6,21,2022-05-03_11-02-08,fp7d
2022-03-12,TI,55,61,6,55,2022-05-03_11-02-08,fp7d
2022-03-12,UR,6,6,0,6,2022-05-03_11-02-08,fp7d
2022-03-12,VD,86,88,2,86,2022-05-03_11-02-08,fp7d
2022-03-12,VS,14,14,0,14,2022-05-03_11-02-08,fp7d
2022-03-12,ZG,8,8,0,8,2022-05-03_11-02-08,fp7d
2022-03-12,ZH,190,186,7,179,2022-05-03_11-02-08,fp7d
2022-03-13,AG,50,46,2,44,2022-05-03_11-02-08,fp7d
2022-03-13,AI,0,0,0,0,2022-05-03_11-02-08,fp7d
2022-03-13,AR,6,6,0,6,2022-05-03_11-02-08,fp7d
2022-03-13,BE,106,85,2,83,2022-05-03_11-02-08,fp7d
2022-03-13,BL,20,15,0,15,2022-05-03_11-02-08,fp7d
2022-03-13,BS,54,48,2,46,2022-05-03_11-02-08,fp7d
2022-03-13,FR,24,23,0,23,2022-05-03_11-02-08,fp7d
2022-03-13,GE,38,51,13,38,2022-05-03_11-02-08,fp7d
2022-03-13,GL,6,6,0,6,2022-05-03_11-02-08,fp7d
2022-03-13,GR,16,18,2,16,2022-05-03_11-02-08,fp7d
2022-03-13,JU,6,6,0,6,2022-05-03_11-02-08,fp7d
2022-03-13,LU,59,45,0,45,2022-05-03_11-02-08,fp7d
2022-03-13,NE,10,10,0,10,2022-05-03_11-02-08,fp7d
2022-03-13,NW,6,6,0,6,2022-05-03_11-02-08,fp7d
2022-03-13,OW,0,0,0,0,2022-05-03_11-02-08,fp7d
2022-03-13,SG,54,40,1,39,2022-05-03_11-02-08,fp7d
2022-03-13,SH,8,6,0,6,2022-05-03_11-02-08,fp7d
2022-03-13,SO,17,16,0,16,2022-05-03_11-02-08,fp7d
2022-03-13,SZ,13,12,0,12,2022-05-03_11-02-08,fp7d
2022-03-13,TG,21,27,6,21,2022-05-03_11-02-08,fp7d
2022-03-13,TI,55,61,6,55,2022-05-03_11-02-08,fp7d
2022-03-13,UR,6,6,0,6,2022-05-03_11-02-08,fp7d
2022-03-13,VD,86,88,2,86,2022-05-03_11-02-08,fp7d
2022-03-13,VS,14,14,0,14,2022-05-03_11-02-08,fp7d
2022-03-13,ZG,8,8,0,8,2022-05-03_11-02-08,fp7d
2022-03-13,ZH,190,187,8,179,2022-05-03_11-02-08,fp7d
2022-03-14,AG,50,46,2,44,2022-05-03_11-02-08,fp7d
2022-03-14,AI,0,0,0,0,2022-05-03_11-02-08,fp7d
2022-03-14,AR,6,6,0,6,2022-05-03_11-02-08,fp7d
2022-03-14,BE,106,86,2,84,2022-05-03_11-02-08,fp7d
2022-03-14,BL,20,15,0,15,2022-05-03_11-02-08,fp7d
2022-03-14,BS,54,52,2,50,2022-05-03_11-02-08,fp7d
2022-03-14,FR,24,23,0,23,2022-05-03_11-02-08,fp7d
2022-03-14,GE,38,51,13,38,2022-05-03_11-02-08,fp7d
2022-03-14,GL,6,6,0,6,2022-05-03_11-02-08,fp7d
2022-03-14,GR,16,18,2,16,2022-05-03_11-02-08,fp7d
2022-03-14,JU,6,6,0,6,2022-05-03_11-02-08,fp7d
2022-03-14,LU,59,45,0,45,2022-05-03_11-02-08,fp7d
2022-03-14,NE,10,10,0,10,2022-05-03_11-02-08,fp7d
2022-03-14,NW,6,6,0,6,2022-05-03_11-02-08,fp7d
2022-03-14,OW,0,0,0,0,2022-05-03_11-02-08,fp7d
2022-03-14,SG,54,40,1,39,2022-05-03_11-02-08,fp7d
2022-03-14,SH,8,7,0,7,2022-05-03_11-02-08,fp7d
2022-03-14,SO,17,16,0,16,2022-05-03_11-02-08,fp7d
2022-03-14,SZ,13,12,0,12,2022-05-03_11-02-08,fp7d
2022-03-14,TG,21,27,6,21,2022-05-03_11-02-08,fp7d
2022-03-14,TI,55,61,6,55,2022-05-03_11-02-08,fp7d
2022-03-14,UR,6,6,0,6,2022-05-03_11-02-08,fp7d
2022-03-14,VD,86,88,2,86,2022-05-03_11-02-08,fp7d
2022-03-14,VS,14,14,0,14,2022-05-03_11-02-08,fp7d
2022-03-14,ZG,8,8,0,8,2022-05-03_11-02-08,fp7d
2022-03-14,ZH,190,189,10,179,2022-05-03_11-02-08,fp7d
2022-03-15,AG,52,49,1,48,2022-05-03_11-02-08,fp7d
2022-03-15,AI,0,0,0,0,2022-05-03_11-02-08,fp7d
2022-03-15,AR,6,6,0,6,2022-05-03_11-02-08,fp7d
2022-03-15,BE,106,85,2,83,2022-05-03_11-02-08,fp7d
2022-03-15,BL,20,15,0,15,2022-05-03_11-02-08,fp7d
2022-03-15,BS,54,52,2,50,2022-05-03_11-02-08,fp7d
2022-03-15,FR,24,23,0,23,2022-05-03_11-02-08,fp7d
2022-03-15,GE,38,51,13,38,2022-05-03_11-02-08,fp7d
2022-03-15,GL,6,6,0,6,2022-05-03_11-02-08,fp7d
2022-03-15,GR,16,18,2,16,2022-05-03_11-02-08,fp7d
2022-03-15,JU,6,6,0,6,2022-05-03_11-02-08,fp7d
2022-03-15,LU,59,47,0,47,2022-05-03_11-02-08,fp7d
2022-03-15,NE,10,10,0,10,2022-05-03_11-02-08,fp7d
2022-03-15,NW,6,6,0,6,2022-05-03_11-02-08,fp7d
2022-03-15,OW,0,0,0,0,2022-05-03_11-02-08,fp7d
2022-03-15,SG,54,40,1,39,2022-05-03_11-02-08,fp7d
2022-03-15,SH,8,7,0,7,2022-05-03_11-02-08,fp7d
2022-03-15,SO,17,16,0,16,2022-05-03_11-02-08,fp7d
2022-03-15,SZ,13,11,0,11,2022-05-03_11-02-08,fp7d
2022-03-15,TG,21,27,6,21,2022-05-03_11-02-08,fp7d
2022-03-15,TI,55,61,6,55,2022-05-03_11-02-08,fp7d
2022-03-15,UR,6,6,0,6,2022-05-03_11-02-08,fp7d
2022-03-15,VD,86,88,2,86,2022-05-03_11-02-08,fp7d
2022-03-15,VS,14,14,0,14,2022-05-03_11-02-08,fp7d
2022-03-15,ZG,8,8,0,8,2022-05-03_11-02-08,fp7d
2022-03-15,ZH,190,190,11,179,2022-05-03_11-02-08,fp7d
2022-03-16,AG,52,49,1,48,2022-05-03_11-02-08,fp7d
2022-03-16,AI,0,0,0,0,2022-05-03_11-02-08,fp7d
2022-03-16,AR,6,6,0,6,2022-05-03_11-02-08,fp7d
2022-03-16,BE,105,83,1,82,2022-05-03_11-02-08,fp7d
2022-03-16,BL,20,15,0,15,2022-05-03_11-02-08,fp7d
2022-03-16,BS,54,52,2,50,2022-05-03_11-02-08,fp7d
2022-03-16,FR,24,23,0,23,2022-05-03_11-02-08,fp7d
2022-03-16,GE,38,51,13,38,2022-05-03_11-02-08,fp7d
2022-03-16,GL,6,6,0,6,2022-05-03_11-02-08,fp7d
2022-03-16,GR,16,18,2,16,2022-05-03_11-02-08,fp7d
2022-03-16,JU,6,6,0,6,2022-05-03_11-02-08,fp7d
2022-03-16,LU,59,47,0,47,2022-05-03_11-02-08,fp7d
2022-03-16,NE,10,10,0,10,2022-05-03_11-02-08,fp7d
2022-03-16,NW,6,5,0,5,2022-05-03_11-02-08,fp7d
2022-03-16,OW,0,0,0,0,2022-05-03_11-02-08,fp7d
2022-03-16,SG,54,40,1,39,2022-05-03_11-02-08,fp7d
2022-03-16,SH,8,7,0,7,2022-05-03_11-02-08,fp7d
2022-03-16,SO,17,16,0,16,2022-05-03_11-02-08,fp7d
2022-03-16,SZ,13,11,0,11,2022-05-03_11-02-08,fp7d
2022-03-16,TG,21,27,6,21,2022-05-03_11-02-08,fp7d
2022-03-16,TI,55,61,6,55,2022-05-03_11-02-08,fp7d
2022-03-16,UR,6,6,0,6,2022-05-03_11-02-08,fp7d
2022-03-16,VD,86,88,2,86,2022-05-03_11-02-08,fp7d
2022-03-16,VS,14,14,0,14,2022-05-03_11-02-08,fp7d
2022-03-16,ZG,8,8,0,8,2022-05-03_11-02-08,fp7d
2022-03-16,ZH,190,186,7,179,2022-05-03_11-02-08,fp7d
2022-03-17,AG,52,51,1,50,2022-05-03_11-02-08,fp7d
2022-03-17,AI,0,0,0,0,2022-05-03_11-02-08,fp7d
2022-03-17,AR,6,6,0,6,2022-05-03_11-02-08,fp7d
2022-03-17,BE,105,86,1,85,2022-05-03_11-02-08,fp7d
2022-03-17,BL,20,15,0,15,2022-05-03_11-02-08,fp7d
2022-03-17,BS,54,52,2,50,2022-05-03_11-02-08,fp7d
2022-03-17,FR,24,23,0,23,2022-05-03_11-02-08,fp7d
2022-03-17,GE,38,51,13,38,2022-05-03_11-02-08,fp7d
2022-03-17,GL,6,6,0,6,2022-05-03_11-02-08,fp7d
2022-03-17,GR,16,18,2,16,2022-05-03_11-02-08,fp7d
2022-03-17,JU,6,6,0,6,2022-05-03_11-02-08,fp7d
2022-03-17,LU,59,47,0,47,2022-05-03_11-02-08,fp7d
2022-03-17,NE,10,10,0,10,2022-05-03_11-02-08,fp7d
2022-03-17,NW,6,5,0,5,2022-05-03_11-02-08,fp7d
2022-03-17,OW,0,0,0,0,2022-05-03_11-02-08,fp7d
2022-03-17,SG,54,40,1,39,2022-05-03_11-02-08,fp7d
2022-03-17,SH,8,7,0,7,2022-05-03_11-02-08,fp7d
2022-03-17,SO,16,16,0,16,2022-05-03_11-02-08,fp7d
2022-03-17,SZ,13,11,0,11,2022-05-03_11-02-08,fp7d
2022-03-17,TG,21,27,6,21,2022-05-03_11-02-08,fp7d
2022-03-17,TI,55,61,6,55,2022-05-03_11-02-08,fp7d
2022-03-17,UR,6,6,0,6,2022-05-03_11-02-08,fp7d
2022-03-17,VD,86,88,2,86,2022-05-03_11-02-08,fp7d
2022-03-17,VS,14,14,0,14,2022-05-03_11-02-08,fp7d
2022-03-17,ZG,8,8,0,8,2022-05-03_11-02-08,fp7d
2022-03-17,ZH,190,187,7,180,2022-05-03_11-02-08,fp7d
2022-03-18,AG,54,51,0,51,2022-05-03_11-02-08,fp7d
2022-03-18,AI,0,0,0,0,2022-05-03_11-02-08,fp7d
2022-03-18,AR,6,6,0,6,2022-05-03_11-02-08,fp7d
2022-03-18,BE,105,85,1,84,2022-05-03_11-02-08,fp7d
2022-03-18,BL,20,14,0,14,2022-05-03_11-02-08,fp7d
2022-03-18,BS,54,52,2,50,2022-05-03_11-02-08,fp7d
2022-03-18,FR,24,23,0,23,2022-05-03_11-02-08,fp7d
2022-03-18,GE,38,51,13,38,2022-05-03_11-02-08,fp7d
2022-03-18,GL,6,6,0,6,2022-05-03_11-02-08,fp7d
2022-03-18,GR,16,18,2,16,2022-05-03_11-02-08,fp7d
2022-03-18,JU,6,6,0,6,2022-05-03_11-02-08,fp7d
2022-03-18,LU,59,47,0,47,2022-05-03_11-02-08,fp7d
2022-03-18,NE,10,10,0,10,2022-05-03_11-02-08,fp7d
2022-03-18,NW,6,5,0,5,2022-05-03_11-02-08,fp7d
2022-03-18,OW,0,0,0,0,2022-05-03_11-02-08,fp7d
2022-03-18,SG,54,40,1,39,2022-05-03_11-02-08,fp7d
2022-03-18,SH,8,7,0,7,2022-05-03_11-02-08,fp7d
2022-03-18,SO,17,16,0,16,2022-05-03_11-02-08,fp7d
2022-03-18,SZ,13,11,0,11,2022-05-03_11-02-08,fp7d
2022-03-18,TG,21,27,6,21,2022-05-03_11-02-08,fp7d
2022-03-18,TI,55,61,6,55,2022-05-03_11-02-08,fp7d
2022-03-18,UR,6,6,0,6,2022-05-03_11-02-08,fp7d
2022-03-18,VD,86,88,2,86,2022-05-03_11-02-08,fp7d
2022-03-18,VS,14,14,0,14,2022-05-03_11-02-08,fp7d
2022-03-18,ZG,8,8,0,8,2022-05-03_11-02-08,fp7d
2022-03-18,ZH,190,187,7,180,2022-05-03_11-02-08,fp7d
2022-03-19,AG,54,51,0,51,2022-05-03_11-02-08,fp7d
2022-03-19,AI,0,0,0,0,2022-05-03_11-02-08,fp7d
2022-03-19,AR,6,6,0,6,2022-05-03_11-02-08,fp7d
2022-03-19,BE,105,85,1,84,2022-05-03_11-02-08,fp7d
2022-03-19,BL,20,14,0,14,2022-05-03_11-02-08,fp7d
2022-03-19,BS,54,48,2,46,2022-05-03_11-02-08,fp7d
2022-03-19,FR,24,23,0,23,2022-05-03_11-02-08,fp7d
2022-03-19,GE,38,51,13,38,2022-05-03_11-02-08,fp7d
2022-03-19,GL,6,6,0,6,2022-05-03_11-02-08,fp7d
2022-03-19,GR,16,18,2,16,2022-05-03_11-02-08,fp7d
2022-03-19,JU,6,6,0,6,2022-05-03_11-02-08,fp7d
2022-03-19,LU,59,47,0,47,2022-05-03_11-02-08,fp7d
2022-03-19,NE,10,10,0,10,2022-05-03_11-02-08,fp7d
2022-03-19,NW,6,5,0,5,2022-05-03_11-02-08,fp7d
2022-03-19,OW,0,0,0,0,2022-05-03_11-02-08,fp7d
2022-03-19,SG,54,40,1,39,2022-05-03_11-02-08,fp7d
2022-03-19,SH,8,7,0,7,2022-05-03_11-02-08,fp7d
2022-03-19,SO,17,16,0,16,2022-05-03_11-02-08,fp7d
2022-03-19,SZ,13,11,0,11,2022-05-03_11-02-08,fp7d
2022-03-19,TG,21,27,6,21,2022-05-03_11-02-08,fp7d
2022-03-19,TI,55,61,6,55,2022-05-03_11-02-08,fp7d
2022-03-19,UR,6,6,0,6,2022-05-03_11-02-08,fp7d
2022-03-19,VD,86,88,2,86,2022-05-03_11-02-08,fp7d
2022-03-19,VS,14,14,0,14,2022-05-03_11-02-08,fp7d
2022-03-19,ZG,8,8,0,8,2022-05-03_11-02-08,fp7d
2022-03-19,ZH,190,188,7,181,2022-05-03_11-02-08,fp7d
2022-03-20,AG,54,51,0,51,2022-05-03_11-02-08,fp7d
2022-03-20,AI,0,0,0,0,2022-05-03_11-02-08,fp7d
2022-03-20,AR,6,6,0,6,2022-05-03_11-02-08,fp7d
2022-03-20,BE,105,85,1,84,2022-05-03_11-02-08,fp7d
2022-03-20,BL,20,14,0,14,2022-05-03_11-02-08,fp7d
2022-03-20,BS,54,48,2,46,2022-05-03_11-02-08,fp7d
2022-03-20,FR,24,23,0,23,2022-05-03_11-02-08,fp7d
2022-03-20,GE,38,51,13,38,2022-05-03_11-02-08,fp7d
2022-03-20,GL,6,6,0,6,2022-05-03_11-02-08,fp7d
2022-03-20,GR,16,18,2,16,2022-05-03_11-02-08,fp7d
2022-03-20,JU,6,6,0,6,2022-05-03_11-02-08,fp7d
2022-03-20,LU,59,47,0,47,2022-05-03_11-02-08,fp7d
2022-03-20,NE,10,10,0,10,2022-05-03_11-02-08,fp7d
2022-03-20,NW,4,4,0,4,2022-05-03_11-02-08,fp7d
2022-03-20,OW,0,0,0,0,2022-05-03_11-02-08,fp7d
2022-03-20,SG,54,40,1,39,2022-05-03_11-02-08,fp7d
2022-03-20,SH,8,7,0,7,2022-05-03_11-02-08,fp7d
2022-03-20,SO,17,16,0,16,2022-05-03_11-02-08,fp7d
2022-03-20,SZ,13,11,0,11,2022-05-03_11-02-08,fp7d
2022-03-20,TG,21,27,6,21,2022-05-03_11-02-08,fp7d
2022-03-20,TI,55,61,6,55,2022-05-03_11-02-08,fp7d
2022-03-20,UR,6,6,0,6,2022-05-03_11-02-08,fp7d
2022-03-20,VD,86,88,2,86,2022-05-03_11-02-08,fp7d
2022-03-20,VS,14,14,0,14,2022-05-03_11-02-08,fp7d
2022-03-20,ZG,8,8,0,8,2022-05-03_11-02-08,fp7d
2022-03-20,ZH,190,185,6,179,2022-05-03_11-02-08,fp7d
2022-03-21,AG,54,51,0,51,2022-05-03_11-02-08,fp7d
2022-03-21,AI,0,0,0,0,2022-05-03_11-02-08,fp7d
2022-03-21,AR,6,6,0,6,2022-05-03_11-02-08,fp7d
2022-03-21,BE,105,87,1,86,2022-05-03_11-02-08,fp7d
2022-03-21,BL,20,14,0,14,2022-05-03_11-02-08,fp7d
2022-03-21,BS,54,52,2,50,2022-05-03_11-02-08,fp7d
2022-03-21,FR,24,23,0,23,2022-05-03_11-02-08,fp7d
2022-03-21,GE,38,51,13,38,2022-05-03_11-02-08,fp7d
2022-03-21,GL,6,6,0,6,2022-05-03_11-02-08,fp7d
2022-03-21,GR,16,18,2,16,2022-05-03_11-02-08,fp7d
2022-03-21,JU,6,6,0,6,2022-05-03_11-02-08,fp7d
2022-03-21,LU,59,47,0,47,2022-05-03_11-02-08,fp7d
2022-03-21,NE,10,10,0,10,2022-05-03_11-02-08,fp7d
2022-03-21,NW,6,6,0,6,2022-05-03_11-02-08,fp7d
2022-03-21,OW,0,0,0,0,2022-05-03_11-02-08,fp7d
2022-03-21,SG,54,40,1,39,2022-05-03_11-02-08,fp7d
2022-03-21,SH,8,7,0,7,2022-05-03_11-02-08,fp7d
2022-03-21,SO,17,16,0,16,2022-05-03_11-02-08,fp7d
2022-03-21,SZ,13,11,0,11,2022-05-03_11-02-08,fp7d
2022-03-21,TG,21,27,6,21,2022-05-03_11-02-08,fp7d
2022-03-21,TI,55,61,6,55,2022-05-03_11-02-08,fp7d
2022-03-21,UR,6,6,0,6,2022-05-03_11-02-08,fp7d
2022-03-21,VD,86,88,2,86,2022-05-03_11-02-08,fp7d
2022-03-21,VS,14,14,0,14,2022-05-03_11-02-08,fp7d
2022-03-21,ZG,8,8,0,8,2022-05-03_11-02-08,fp7d
2022-03-21,ZH,186,182,11,171,2022-05-03_11-02-08,fp7d
2022-03-22,AG,54,51,0,51,2022-05-03_11-02-08,fp7d
2022-03-22,AI,0,0,0,0,2022-05-03_11-02-08,fp7d
2022-03-22,AR,6,6,0,6,2022-05-03_11-02-08,fp7d
2022-03-22,BE,105,83,1,82,2022-05-03_11-02-08,fp7d
2022-03-22,BL,20,15,0,15,2022-05-03_11-02-08,fp7d
2022-03-22,BS,54,52,2,50,2022-05-03_11-02-08,fp7d
2022-03-22,FR,24,23,0,23,2022-05-03_11-02-08,fp7d
2022-03-22,GE,38,51,13,38,2022-05-03_11-02-08,fp7d
2022-03-22,GL,6,6,0,6,2022-05-03_11-02-08,fp7d
2022-03-22,GR,16,18,2,16,2022-05-03_11-02-08,fp7d
2022-03-22,JU,6,6,0,6,2022-05-03_11-02-08,fp7d
2022-03-22,LU,59,47,0,47,2022-05-03_11-02-08,fp7d
2022-03-22,NE,10,10,0,10,2022-05-03_11-02-08,fp7d
2022-03-22,NW,6,6,0,6,2022-05-03_11-02-08,fp7d
2022-03-22,OW,0,0,0,0,2022-05-03_11-02-08,fp7d
2022-03-22,SG,54,40,1,39,2022-05-03_11-02-08,fp7d
2022-03-22,SH,8,7,0,7,2022-05-03_11-02-08,fp7d
2022-03-22,SO,17,16,0,16,2022-05-03_11-02-08,fp7d
2022-03-22,SZ,13,11,0,11,2022-05-03_11-02-08,fp7d
2022-03-22,TG,21,27,6,21,2022-05-03_11-02-08,fp7d
2022-03-22,TI,55,61,6,55,2022-05-03_11-02-08,fp7d
2022-03-22,UR,6,6,0,6,2022-05-03_11-02-08,fp7d
2022-03-22,VD,86,88,2,86,2022-05-03_11-02-08,fp7d
2022-03-22,VS,14,14,0,14,2022-05-03_11-02-08,fp7d
2022-03-22,ZG,8,8,0,8,2022-05-03_11-02-08,fp7d
2022-03-22,ZH,190,183,7,176,2022-05-03_11-02-08,fp7d
2022-03-23,AG,54,51,0,51,2022-05-03_11-02-08,fp7d
2022-03-23,AI,0,0,0,0,2022-05-03_11-02-08,fp7d
2022-03-23,AR,6,6,0,6,2022-05-03_11-02-08,fp7d
2022-03-23,BE,105,83,1,82,2022-05-03_11-02-08,fp7d
2022-03-23,BL,20,15,0,15,2022-05-03_11-02-08,fp7d
2022-03-23,BS,54,52,2,50,2022-05-03_11-02-08,fp7d
2022-03-23,FR,24,23,0,23,2022-05-03_11-02-08,fp7d
2022-03-23,GE,38,51,13,38,2022-05-03_11-02-08,fp7d
2022-03-23,GL,6,6,0,6,2022-05-03_11-02-08,fp7d
2022-03-23,GR,16,18,2,16,2022-05-03_11-02-08,fp7d
2022-03-23,JU,6,6,0,6,2022-05-03_11-02-08,fp7d
2022-03-23,LU,59,47,0,47,2022-05-03_11-02-08,fp7d
2022-03-23,NE,10,10,0,10,2022-05-03_11-02-08,fp7d
2022-03-23,NW,6,6,0,6,2022-05-03_11-02-08,fp7d
2022-03-23,OW,0,0,0,0,2022-05-03_11-02-08,fp7d
2022-03-23,SG,54,40,1,39,2022-05-03_11-02-08,fp7d
2022-03-23,SH,8,7,0,7,2022-05-03_11-02-08,fp7d
2022-03-23,SO,17,16,0,16,2022-05-03_11-02-08,fp7d
2022-03-23,SZ,13,11,0,11,2022-05-03_11-02-08,fp7d
2022-03-23,TG,21,27,6,21,2022-05-03_11-02-08,fp7d
2022-03-23,TI,55,61,6,55,2022-05-03_11-02-08,fp7d
2022-03-23,UR,6,6,0,6,2022-05-03_11-02-08,fp7d
2022-03-23,VD,86,88,2,86,2022-05-03_11-02-08,fp7d
2022-03-23,VS,14,14,0,14,2022-05-03_11-02-08,fp7d
2022-03-23,ZG,8,8,0,8,2022-05-03_11-02-08,fp7d
2022-03-23,ZH,190,181,7,174,2022-05-03_11-02-08,fp7d
2022-03-24,AG,54,51,0,51,2022-05-03_11-02-08,fp7d
2022-03-24,AI,0,0,0,0,2022-05-03_11-02-08,fp7d
2022-03-24,AR,6,6,0,6,2022-05-03_11-02-08,fp7d
2022-03-24,BE,105,82,1,81,2022-05-03_11-02-08,fp7d
2022-03-24,BL,20,15,0,15,2022-05-03_11-02-08,fp7d
2022-03-24,BS,54,52,2,50,2022-05-03_11-02-08,fp7d
2022-03-24,FR,24,23,0,23,2022-05-03_11-02-08,fp7d
2022-03-24,GE,38,51,13,38,2022-05-03_11-02-08,fp7d
2022-03-24,GL,6,6,0,6,2022-05-03_11-02-08,fp7d
2022-03-24,GR,16,14,0,14,2022-05-03_11-02-08,fp7d
2022-03-24,JU,6,6,0,6,2022-05-03_11-02-08,fp7d
2022-03-24,LU,59,46,0,46,2022-05-03_11-02-08,fp7d
2022-03-24,NE,10,10,0,10,2022-05-03_11-02-08,fp7d
2022-03-24,NW,6,5,0,5,2022-05-03_11-02-08,fp7d
2022-03-24,OW,0,0,0,0,2022-05-03_11-02-08,fp7d
2022-03-24,SG,54,41,1,40,2022-05-03_11-02-08,fp7d
2022-03-24,SH,8,7,0,7,2022-05-03_11-02-08,fp7d
2022-03-24,SO,17,15,0,15,2022-05-03_11-02-08,fp7d
2022-03-24,SZ,13,11,0,11,2022-05-03_11-02-08,fp7d
2022-03-24,TG,21,27,6,21,2022-05-03_11-02-08,fp7d
2022-03-24,TI,53,59,6,53,2022-05-03_11-02-08,fp7d
2022-03-24,UR,6,6,0,6,2022-05-03_11-02-08,fp7d
2022-03-24,VD,86,88,2,86,2022-05-03_11-02-08,fp7d
2022-03-24,VS,14,14,0,14,2022-05-03_11-02-08,fp7d
2022-03-24,ZG,8,8,0,8,2022-05-03_11-02-08,fp7d
2022-03-24,ZH,190,178,6,172,2022-05-03_11-02-08,fp7d
2022-03-25,AG,54,51,0,51,2022-05-03_11-02-08,fp7d
2022-03-25,AI,0,0,0,0,2022-05-03_11-02-08,fp7d
2022-03-25,AR,6,6,0,6,2022-05-03_11-02-08,fp7d
2022-03-25,BE,105,85,3,82,2022-05-03_11-02-08,fp7d
2022-03-25,BL,20,15,0,15,2022-05-03_11-02-08,fp7d
2022-03-25,BS,54,52,2,50,2022-05-03_11-02-08,fp7d
2022-03-25,FR,24,20,0,20,2022-05-03_11-02-08,fp7d
2022-03-25,GE,38,51,13,38,2022-05-03_11-02-08,fp7d
2022-03-25,GL,6,6,0,6,2022-05-03_11-02-08,fp7d
2022-03-25,GR,16,18,2,16,2022-05-03_11-02-08,fp7d
2022-03-25,JU,6,6,0,6,2022-05-03_11-02-08,fp7d
2022-03-25,LU,59,46,0,46,2022-05-03_11-02-08,fp7d
2022-03-25,NE,10,10,0,10,2022-05-03_11-02-08,fp7d
2022-03-25,NW,6,5,0,5,2022-05-03_11-02-08,fp7d
2022-03-25,OW,0,0,0,0,2022-05-03_11-02-08,fp7d
2022-03-25,SG,54,40,1,39,2022-05-03_11-02-08,fp7d
2022-03-25,SH,8,7,0,7,2022-05-03_11-02-08,fp7d
2022-03-25,SO,17,15,0,15,2022-05-03_11-02-08,fp7d
2022-03-25,SZ,13,11,0,11,2022-05-03_11-02-08,fp7d
2022-03-25,TG,21,27,6,21,2022-05-03_11-02-08,fp7d
2022-03-25,TI,53,59,6,53,2022-05-03_11-02-08,fp7d
2022-03-25,UR,6,6,0,6,2022-05-03_11-02-08,fp7d
2022-03-25,VD,86,88,2,86,2022-05-03_11-02-08,fp7d
2022-03-25,VS,14,14,0,14,2022-05-03_11-02-08,fp7d
2022-03-25,ZG,8,8,0,8,2022-05-03_11-02-08,fp7d
2022-03-25,ZH,190,181,6,175,2022-05-03_11-02-08,fp7d
2022-03-26,AG,54,51,0,51,2022-05-03_11-02-08,fp7d
2022-03-26,AI,0,0,0,0,2022-05-03_11-02-08,fp7d
2022-03-26,AR,6,6,0,6,2022-05-03_11-02-08,fp7d
2022-03-26,BE,105,83,3,80,2022-05-03_11-02-08,fp7d
2022-03-26,BL,20,15,0,15,2022-05-03_11-02-08,fp7d
2022-03-26,BS,54,48,2,46,2022-05-03_11-02-08,fp7d
2022-03-26,FR,24,20,0,20,2022-05-03_11-02-08,fp7d
2022-03-26,GE,38,51,13,38,2022-05-03_11-02-08,fp7d
2022-03-26,GL,6,6,0,6,2022-05-03_11-02-08,fp7d
2022-03-26,GR,16,18,2,16,2022-05-03_11-02-08,fp7d
2022-03-26,JU,6,6,0,6,2022-05-03_11-02-08,fp7d
2022-03-26,LU,59,46,0,46,2022-05-03_11-02-08,fp7d
2022-03-26,NE,10,10,0,10,2022-05-03_11-02-08,fp7d
2022-03-26,NW,6,4,0,4,2022-05-03_11-02-08,fp7d
2022-03-26,OW,0,0,0,0,2022-05-03_11-02-08,fp7d
2022-03-26,SG,54,40,1,39,2022-05-03_11-02-08,fp7d
2022-03-26,SH,8,7,0,7,2022-05-03_11-02-08,fp7d
2022-03-26,SO,17,15,0,15,2022-05-03_11-02-08,fp7d
2022-03-26,SZ,13,11,0,11,2022-05-03_11-02-08,fp7d
2022-03-26,TG,21,26,6,20,2022-05-03_11-02-08,fp7d
2022-03-26,TI,53,59,6,53,2022-05-03_11-02-08,fp7d
2022-03-26,UR,6,6,0,6,2022-05-03_11-02-08,fp7d
2022-03-26,VD,86,88,2,86,2022-05-03_11-02-08,fp7d
2022-03-26,VS,14,14,0,14,2022-05-03_11-02-08,fp7d
2022-03-26,ZG,8,8,0,8,2022-05-03_11-02-08,fp7d
2022-03-26,ZH,190,183,6,177,2022-05-03_11-02-08,fp7d
2022-03-27,AG,54,51,0,51,2022-05-03_11-02-08,fp7d
2022-03-27,AI,0,0,0,0,2022-05-03_11-02-08,fp7d
2022-03-27,AR,6,6,0,6,2022-05-03_11-02-08,fp7d
2022-03-27,BE,105,83,3,80,2022-05-03_11-02-08,fp7d
2022-03-27,BL,20,15,0,15,2022-05-03_11-02-08,fp7d
2022-03-27,BS,54,48,2,46,2022-05-03_11-02-08,fp7d
2022-03-27,FR,24,20,0,20,2022-05-03_11-02-08,fp7d
2022-03-27,GE,38,51,13,38,2022-05-03_11-02-08,fp7d
2022-03-27,GL,6,6,0,6,2022-05-03_11-02-08,fp7d
2022-03-27,GR,16,18,2,16,2022-05-03_11-02-08,fp7d
2022-03-27,JU,6,6,0,6,2022-05-03_11-02-08,fp7d
2022-03-27,LU,59,46,0,46,2022-05-03_11-02-08,fp7d
2022-03-27,NE,10,10,0,10,2022-05-03_11-02-08,fp7d
2022-03-27,NW,6,4,0,4,2022-05-03_11-02-08,fp7d
2022-03-27,OW,0,0,0,0,2022-05-03_11-02-08,fp7d
2022-03-27,SG,54,40,1,39,2022-05-03_11-02-08,fp7d
2022-03-27,SH,8,7,0,7,2022-05-03_11-02-08,fp7d
2022-03-27,SO,17,15,0,15,2022-05-03_11-02-08,fp7d
2022-03-27,SZ,13,11,0,11,2022-05-03_11-02-08,fp7d
2022-03-27,TG,21,26,6,20,2022-05-03_11-02-08,fp7d
2022-03-27,TI,53,59,6,53,2022-05-03_11-02-08,fp7d
2022-03-27,UR,6,6,0,6,2022-05-03_11-02-08,fp7d
2022-03-27,VD,86,88,2,86,2022-05-03_11-02-08,fp7d
2022-03-27,VS,14,14,0,14,2022-05-03_11-02-08,fp7d
2022-03-27,ZG,8,8,0,8,2022-05-03_11-02-08,fp7d
2022-03-27,ZH,191,185,6,179,2022-05-03_11-02-08,fp7d
2022-03-28,AG,54,51,0,51,2022-05-03_11-02-08,fp7d
2022-03-28,AI,0,0,0,0,2022-05-03_11-02-08,fp7d
2022-03-28,AR,6,6,0,6,2022-05-03_11-02-08,fp7d
2022-03-28,BE,105,83,3,80,2022-05-03_11-02-08,fp7d
2022-03-28,BL,20,15,0,15,2022-05-03_11-02-08,fp7d
2022-03-28,BS,54,52,2,50,2022-05-03_11-02-08,fp7d
2022-03-28,FR,24,20,0,20,2022-05-03_11-02-08,fp7d
2022-03-28,GE,38,51,13,38,2022-05-03_11-02-08,fp7d
2022-03-28,GL,6,6,0,6,2022-05-03_11-02-08,fp7d
2022-03-28,GR,16,18,2,16,2022-05-03_11-02-08,fp7d
2022-03-28,JU,6,6,0,6,2022-05-03_11-02-08,fp7d
2022-03-28,LU,59,46,0,46,2022-05-03_11-02-08,fp7d
2022-03-28,NE,10,10,0,10,2022-05-03_11-02-08,fp7d
2022-03-28,NW,6,4,0,4,2022-05-03_11-02-08,fp7d
2022-03-28,OW,0,0,0,0,2022-05-03_11-02-08,fp7d
2022-03-28,SG,54,40,1,39,2022-05-03_11-02-08,fp7d
2022-03-28,SH,8,7,0,7,2022-05-03_11-02-08,fp7d
2022-03-28,SO,17,16,0,16,2022-05-03_11-02-08,fp7d
2022-03-28,SZ,13,11,0,11,2022-05-03_11-02-08,fp7d
2022-03-28,TG,21,27,6,21,2022-05-03_11-02-08,fp7d
2022-03-28,TI,53,59,6,53,2022-05-03_11-02-08,fp7d
2022-03-28,UR,6,6,0,6,2022-05-03_11-02-08,fp7d
2022-03-28,VD,86,88,2,86,2022-05-03_11-02-08,fp7d
2022-03-28,VS,14,14,0,14,2022-05-03_11-02-08,fp7d
2022-03-28,ZG,8,8,0,8,2022-05-03_11-02-08,fp7d
2022-03-28,ZH,190,186,6,180,2022-05-03_11-02-08,fp7d
2022-03-29,AG,54,51,0,51,2022-05-03_11-02-08,fp7d
2022-03-29,AI,0,0,0,0,2022-05-03_11-02-08,fp7d
2022-03-29,AR,6,6,0,6,2022-05-03_11-02-08,fp7d
2022-03-29,BE,105,85,3,82,2022-05-03_11-02-08,fp7d
2022-03-29,BL,20,15,0,15,2022-05-03_11-02-08,fp7d
2022-03-29,BS,54,52,2,50,2022-05-03_11-02-08,fp7d
2022-03-29,FR,24,20,0,20,2022-05-03_11-02-08,fp7d
2022-03-29,GE,38,51,13,38,2022-05-03_11-02-08,fp7d
2022-03-29,GL,6,6,0,6,2022-05-03_11-02-08,fp7d
2022-03-29,GR,16,18,2,16,2022-05-03_11-02-08,fp7d
2022-03-29,JU,6,6,0,6,2022-05-03_11-02-08,fp7d
2022-03-29,LU,59,46,0,46,2022-05-03_11-02-08,fp7d
2022-03-29,NE,10,10,0,10,2022-05-03_11-02-08,fp7d
2022-03-29,NW,6,4,0,4,2022-05-03_11-02-08,fp7d
2022-03-29,OW,0,0,0,0,2022-05-03_11-02-08,fp7d
2022-03-29,SG,54,40,1,39,2022-05-03_11-02-08,fp7d
2022-03-29,SH,8,7,0,7,2022-05-03_11-02-08,fp7d
2022-03-29,SO,17,15,0,15,2022-05-03_11-02-08,fp7d
2022-03-29,SZ,13,11,0,11,2022-05-03_11-02-08,fp7d
2022-03-29,TG,21,27,6,21,2022-05-03_11-02-08,fp7d
2022-03-29,TI,53,59,6,53,2022-05-03_11-02-08,fp7d
2022-03-29,UR,6,6,0,6,2022-05-03_11-02-08,fp7d
2022-03-29,VD,86,88,2,86,2022-05-03_11-02-08,fp7d
2022-03-29,VS,14,14,0,14,2022-05-03_11-02-08,fp7d
2022-03-29,ZG,8,8,0,8,2022-05-03_11-02-08,fp7d
2022-03-29,ZH,190,187,6,181,2022-05-03_11-02-08,fp7d
2022-03-30,AG,54,51,0,51,2022-05-03_11-02-08,fp7d
2022-03-30,AI,0,0,0,0,2022-05-03_11-02-08,fp7d
2022-03-30,AR,6,6,0,6,2022-05-03_11-02-08,fp7d
2022-03-30,BE,106,86,2,84,2022-05-03_11-02-08,fp7d
2022-03-30,BL,20,15,0,15,2022-05-03_11-02-08,fp7d
2022-03-30,BS,54,52,2,50,2022-05-03_11-02-08,fp7d
2022-03-30,FR,24,20,0,20,2022-05-03_11-02-08,fp7d
2022-03-30,GE,38,51,13,38,2022-05-03_11-02-08,fp7d
2022-03-30,GL,6,6,0,6,2022-05-03_11-02-08,fp7d
2022-03-30,GR,16,18,2,16,2022-05-03_11-02-08,fp7d
2022-03-30,JU,6,6,0,6,2022-05-03_11-02-08,fp7d
2022-03-30,LU,59,46,0,46,2022-05-03_11-02-08,fp7d
2022-03-30,NE,10,10,0,10,2022-05-03_11-02-08,fp7d
2022-03-30,NW,6,6,0,6,2022-05-03_11-02-08,fp7d
2022-03-30,OW,0,0,0,0,2022-05-03_11-02-08,fp7d
2022-03-30,SG,54,40,1,39,2022-05-03_11-02-08,fp7d
2022-03-30,SH,8,7,0,7,2022-05-03_11-02-08,fp7d
2022-03-30,SO,17,15,0,15,2022-05-03_11-02-08,fp7d
2022-03-30,SZ,13,11,0,11,2022-05-03_11-02-08,fp7d
2022-03-30,TG,21,27,6,21,2022-05-03_11-02-08,fp7d
2022-03-30,TI,53,59,6,53,2022-05-03_11-02-08,fp7d
2022-03-30,UR,6,6,0,6,2022-05-03_11-02-08,fp7d
2022-03-30,VD,86,88,2,86,2022-05-03_11-02-08,fp7d
2022-03-30,VS,14,14,0,14,2022-05-03_11-02-08,fp7d
2022-03-30,ZG,8,8,0,8,2022-05-03_11-02-08,fp7d
2022-03-30,ZH,190,187,7,180,2022-05-03_11-02-08,fp7d
2022-03-31,AG,54,51,0,51,2022-05-03_11-02-08,fp7d
2022-03-31,AI,0,0,0,0,2022-05-03_11-02-08,fp7d
2022-03-31,AR,6,6,0,6,2022-05-03_11-02-08,fp7d
2022-03-31,BE,106,87,3,84,2022-05-03_11-02-08,fp7d
2022-03-31,BL,20,14,0,14,2022-05-03_11-02-08,fp7d
2022-03-31,BS,54,52,2,50,2022-05-03_11-02-08,fp7d
2022-03-31,FR,24,20,0,20,2022-05-03_11-02-08,fp7d
2022-03-31,GE,38,51,13,38,2022-05-03_11-02-08,fp7d
2022-03-31,GL,6,6,0,6,2022-05-03_11-02-08,fp7d
2022-03-31,GR,16,18,2,16,2022-05-03_11-02-08,fp7d
2022-03-31,JU,6,6,0,6,2022-05-03_11-02-08,fp7d
2022-03-31,LU,59,46,0,46,2022-05-03_11-02-08,fp7d
2022-03-31,NE,10,10,0,10,2022-05-03_11-02-08,fp7d
2022-03-31,NW,6,6,0,6,2022-05-03_11-02-08,fp7d
2022-03-31,OW,0,0,0,0,2022-05-03_11-02-08,fp7d
2022-03-31,SG,54,40,1,39,2022-05-03_11-02-08,fp7d
2022-03-31,SH,8,7,0,7,2022-05-03_11-02-08,fp7d
2022-03-31,SO,17,15,0,15,2022-05-03_11-02-08,fp7d
2022-03-31,SZ,13,11,0,11,2022-05-03_11-02-08,fp7d
2022-03-31,TG,21,27,6,21,2022-05-03_11-02-08,fp7d
2022-03-31,TI,53,59,6,53,2022-05-03_11-02-08,fp7d
2022-03-31,UR,6,6,0,6,2022-05-03_11-02-08,fp7d
2022-03-31,VD,86,88,2,86,2022-05-03_11-02-08,fp7d
2022-03-31,VS,14,14,0,14,2022-05-03_11-02-08,fp7d
2022-03-31,ZG,8,8,0,8,2022-05-03_11-02-08,fp7d
2022-03-31,ZH,190,183,6,177,2022-05-03_11-02-08,fp7d
2022-04-01,AG,54,51,0,51,2022-05-03_11-02-08,fp7d
2022-04-01,AI,0,0,0,0,2022-05-03_11-02-08,fp7d
2022-04-01,AR,6,6,0,6,2022-05-03_11-02-08,fp7d
2022-04-01,BE,106,83,3,80,2022-05-03_11-02-08,fp7d
2022-04-01,BL,20,14,0,14,2022-05-03_11-02-08,fp7d
2022-04-01,BS,54,52,2,50,2022-05-03_11-02-08,fp7d
2022-04-01,FR,24,20,0,20,2022-05-03_11-02-08,fp7d
2022-04-01,GE,38,51,13,38,2022-05-03_11-02-08,fp7d
2022-04-01,GL,6,6,0,6,2022-05-03_11-02-08,fp7d
2022-04-01,GR,16,16,0,16,2022-05-03_11-02-08,fp7d
2022-04-01,JU,6,6,0,6,2022-05-03_11-02-08,fp7d
2022-04-01,LU,59,46,0,46,2022-05-03_11-02-08,fp7d
2022-04-01,NE,10,10,0,10,2022-05-03_11-02-08,fp7d
2022-04-01,NW,6,6,0,6,2022-05-03_11-02-08,fp7d
2022-04-01,OW,0,0,0,0,2022-05-03_11-02-08,fp7d
2022-04-01,SG,54,40,1,39,2022-05-03_11-02-08,fp7d
2022-04-01,SH,8,7,0,7,2022-05-03_11-02-08,fp7d
2022-04-01,SO,17,16,0,16,2022-05-03_11-02-08,fp7d
2022-04-01,SZ,13,11,0,11,2022-05-03_11-02-08,fp7d
2022-04-01,TG,21,27,6,21,2022-05-03_11-02-08,fp7d
2022-04-01,TI,53,59,6,53,2022-05-03_11-02-08,fp7d
2022-04-01,UR,6,6,0,6,2022-05-03_11-02-08,fp7d
2022-04-01,VD,86,88,2,86,2022-05-03_11-02-08,fp7d
2022-04-01,VS,14,14,0,14,2022-05-03_11-02-08,fp7d
2022-04-01,ZG,8,8,0,8,2022-05-03_11-02-08,fp7d
2022-04-01,ZH,190,182,6,176,2022-05-03_11-02-08,fp7d
2022-04-02,AG,54,51,0,51,2022-05-03_11-02-08,fp7d
2022-04-02,AI,0,0,0,0,2022-05-03_11-02-08,fp7d
2022-04-02,AR,6,6,0,6,2022-05-03_11-02-08,fp7d
2022-04-02,BE,106,83,3,80,2022-05-03_11-02-08,fp7d
2022-04-02,BL,20,14,0,14,2022-05-03_11-02-08,fp7d
2022-04-02,BS,54,48,2,46,2022-05-03_11-02-08,fp7d
2022-04-02,FR,24,20,0,20,2022-05-03_11-02-08,fp7d
2022-04-02,GE,38,51,13,38,2022-05-03_11-02-08,fp7d
2022-04-02,GL,6,6,0,6,2022-05-03_11-02-08,fp7d
2022-04-02,GR,16,16,0,16,2022-05-03_11-02-08,fp7d
2022-04-02,JU,6,6,0,6,2022-05-03_11-02-08,fp7d
2022-04-02,LU,59,46,0,46,2022-05-03_11-02-08,fp7d
2022-04-02,NE,10,10,0,10,2022-05-03_11-02-08,fp7d
2022-04-02,NW,6,4,0,4,2022-05-03_11-02-08,fp7d
2022-04-02,OW,0,0,0,0,2022-05-03_11-02-08,fp7d
2022-04-02,SG,54,40,1,39,2022-05-03_11-02-08,fp7d
2022-04-02,SH,8,7,0,7,2022-05-03_11-02-08,fp7d
2022-04-02,SO,17,16,0,16,2022-05-03_11-02-08,fp7d
2022-04-02,SZ,13,11,0,11,2022-05-03_11-02-08,fp7d
2022-04-02,TG,21,27,6,21,2022-05-03_11-02-08,fp7d
2022-04-02,TI,53,59,6,53,2022-05-03_11-02-08,fp7d
2022-04-02,UR,6,6,0,6,2022-05-03_11-02-08,fp7d
2022-04-02,VD,86,88,2,86,2022-05-03_11-02-08,fp7d
2022-04-02,VS,14,14,0,14,2022-05-03_11-02-08,fp7d
2022-04-02,ZG,8,8,0,8,2022-05-03_11-02-08,fp7d
2022-04-02,ZH,190,180,6,174,2022-05-03_11-02-08,fp7d
2022-04-03,AG,54,51,0,51,2022-05-03_11-02-08,fp7d
2022-04-03,AI,0,0,0,0,2022-05-03_11-02-08,fp7d
2022-04-03,AR,6,6,0,6,2022-05-03_11-02-08,fp7d
2022-04-03,BE,105,82,3,79,2022-05-03_11-02-08,fp7d
2022-04-03,BL,20,14,0,14,2022-05-03_11-02-08,fp7d
2022-04-03,BS,54,48,2,46,2022-05-03_11-02-08,fp7d
2022-04-03,FR,24,20,0,20,2022-05-03_11-02-08,fp7d
2022-04-03,GE,38,51,13,38,2022-05-03_11-02-08,fp7d
2022-04-03,GL,6,6,0,6,2022-05-03_11-02-08,fp7d
2022-04-03,GR,16,16,0,16,2022-05-03_11-02-08,fp7d
2022-04-03,JU,6,6,0,6,2022-05-03_11-02-08,fp7d
2022-04-03,LU,59,46,0,46,2022-05-03_11-02-08,fp7d
2022-04-03,NE,10,10,0,10,2022-05-03_11-02-08,fp7d
2022-04-03,NW,6,4,0,4,2022-05-03_11-02-08,fp7d
2022-04-03,OW,0,0,0,0,2022-05-03_11-02-08,fp7d
2022-04-03,SG,54,40,1,39,2022-05-03_11-02-08,fp7d
2022-04-03,SH,8,7,0,7,2022-05-03_11-02-08,fp7d
2022-04-03,SO,17,16,0,16,2022-05-03_11-02-08,fp7d
2022-04-03,SZ,13,11,0,11,2022-05-03_11-02-08,fp7d
2022-04-03,TG,21,27,6,21,2022-05-03_11-02-08,fp7d
2022-04-03,TI,53,59,6,53,2022-05-03_11-02-08,fp7d
2022-04-03,UR,6,6,0,6,2022-05-03_11-02-08,fp7d
2022-04-03,VD,86,88,2,86,2022-05-03_11-02-08,fp7d
2022-04-03,VS,14,14,0,14,2022-05-03_11-02-08,fp7d
2022-04-03,ZG,8,8,0,8,2022-05-03_11-02-08,fp7d
2022-04-03,ZH,190,179,6,173,2022-05-03_11-02-08,fp7d
2022-04-04,AG,54,51,0,51,2022-05-03_11-02-08,fp7d
2022-04-04,AI,0,0,0,0,2022-05-03_11-02-08,fp7d
2022-04-04,AR,6,6,0,6,2022-05-03_11-02-08,fp7d
2022-04-04,BE,105,82,3,79,2022-05-03_11-02-08,fp7d
2022-04-04,BL,20,14,0,14,2022-05-03_11-02-08,fp7d
2022-04-04,BS,54,52,2,50,2022-05-03_11-02-08,fp7d
2022-04-04,FR,24,20,0,20,2022-05-03_11-02-08,fp7d
2022-04-04,GE,38,51,13,38,2022-05-03_11-02-08,fp7d
2022-04-04,GL,6,5,0,5,2022-05-03_11-02-08,fp7d
2022-04-04,GR,16,16,0,16,2022-05-03_11-02-08,fp7d
2022-04-04,JU,6,6,0,6,2022-05-03_11-02-08,fp7d
2022-04-04,LU,59,46,0,46,2022-05-03_11-02-08,fp7d
2022-04-04,NE,10,10,0,10,2022-05-03_11-02-08,fp7d
2022-04-04,NW,6,6,0,6,2022-05-03_11-02-08,fp7d
2022-04-04,OW,0,0,0,0,2022-05-03_11-02-08,fp7d
2022-04-04,SG,54,40,1,39,2022-05-03_11-02-08,fp7d
2022-04-04,SH,8,6,0,6,2022-05-03_11-02-08,fp7d
2022-04-04,SO,17,16,0,16,2022-05-03_11-02-08,fp7d
2022-04-04,SZ,13,11,0,11,2022-05-03_11-02-08,fp7d
2022-04-04,TG,21,27,6,21,2022-05-03_11-02-08,fp7d
2022-04-04,TI,53,59,6,53,2022-05-03_11-02-08,fp7d
2022-04-04,UR,6,6,0,6,2022-05-03_11-02-08,fp7d
2022-04-04,VD,86,88,2,86,2022-05-03_11-02-08,fp7d
2022-04-04,VS,14,14,0,14,2022-05-03_11-02-08,fp7d
2022-04-04,ZG,8,8,0,8,2022-05-03_11-02-08,fp7d
2022-04-04,ZH,190,179,6,173,2022-05-03_11-02-08,fp7d
2022-04-05,AG,54,51,0,51,2022-05-03_11-02-08,fp7d
2022-04-05,AI,0,0,0,0,2022-05-03_11-02-08,fp7d
2022-04-05,AR,6,6,0,6,2022-05-03_11-02-08,fp7d
2022-04-05,BE,105,82,3,79,2022-05-03_11-02-08,fp7d
2022-04-05,BL,20,14,0,14,2022-05-03_11-02-08,fp7d
2022-04-05,BS,54,52,2,50,2022-05-03_11-02-08,fp7d
2022-04-05,FR,24,20,0,20,2022-05-03_11-02-08,fp7d
2022-04-05,GE,38,51,13,38,2022-05-03_11-02-08,fp7d
2022-04-05,GL,6,6,0,6,2022-05-03_11-02-08,fp7d
2022-04-05,GR,16,16,0,16,2022-05-03_11-02-08,fp7d
2022-04-05,JU,6,6,0,6,2022-05-03_11-02-08,fp7d
2022-04-05,LU,59,47,0,47,2022-05-03_11-02-08,fp7d
2022-04-05,NE,10,10,0,10,2022-05-03_11-02-08,fp7d
2022-04-05,NW,6,6,0,6,2022-05-03_11-02-08,fp7d
2022-04-05,OW,0,0,0,0,2022-05-03_11-02-08,fp7d
2022-04-05,SG,54,40,1,39,2022-05-03_11-02-08,fp7d
2022-04-05,SH,8,6,0,6,2022-05-03_11-02-08,fp7d
2022-04-05,SO,17,16,0,16,2022-05-03_11-02-08,fp7d
2022-04-05,SZ,13,11,0,11,2022-05-03_11-02-08,fp7d
2022-04-05,TG,21,27,6,21,2022-05-03_11-02-08,fp7d
2022-04-05,TI,61,67,6,61,2022-05-03_11-02-08,fp7d
2022-04-05,UR,6,6,0,6,2022-05-03_11-02-08,fp7d
2022-04-05,VD,86,88,2,86,2022-05-03_11-02-08,fp7d
2022-04-05,VS,14,14,0,14,2022-05-03_11-02-08,fp7d
2022-04-05,ZG,8,8,0,8,2022-05-03_11-02-08,fp7d
2022-04-05,ZH,188,183,8,175,2022-05-03_11-02-08,fp7d
2022-04-06,AG,54,51,0,51,2022-05-03_11-02-08,fp7d
2022-04-06,AI,0,0,0,0,2022-05-03_11-02-08,fp7d
2022-04-06,AR,6,6,0,6,2022-05-03_11-02-08,fp7d
2022-04-06,BE,105,84,3,81,2022-05-03_11-02-08,fp7d
2022-04-06,BL,20,15,0,15,2022-05-03_11-02-08,fp7d
2022-04-06,BS,54,52,2,50,2022-05-03_11-02-08,fp7d
2022-04-06,FR,24,20,0,20,2022-05-03_11-02-08,fp7d
2022-04-06,GE,38,51,13,38,2022-05-03_11-02-08,fp7d
2022-04-06,GL,6,6,0,6,2022-05-03_11-02-08,fp7d
2022-04-06,GR,16,16,0,16,2022-05-03_11-02-08,fp7d
2022-04-06,JU,6,6,0,6,2022-05-03_11-02-08,fp7d
2022-04-06,LU,59,47,0,47,2022-05-03_11-02-08,fp7d
2022-04-06,NE,10,10,0,10,2022-05-03_11-02-08,fp7d
2022-04-06,NW,6,6,0,6,2022-05-03_11-02-08,fp7d
2022-04-06,OW,0,0,0,0,2022-05-03_11-02-08,fp7d
2022-04-06,SG,54,40,1,39,2022-05-03_11-02-08,fp7d
2022-04-06,SH,8,6,0,6,2022-05-03_11-02-08,fp7d
2022-04-06,SO,17,16,0,16,2022-05-03_11-02-08,fp7d
2022-04-06,SZ,13,11,0,11,2022-05-03_11-02-08,fp7d
2022-04-06,TG,21,27,6,21,2022-05-03_11-02-08,fp7d
2022-04-06,TI,53,59,6,53,2022-05-03_11-02-08,fp7d
2022-04-06,UR,6,6,0,6,2022-05-03_11-02-08,fp7d
2022-04-06,VD,86,88,2,86,2022-05-03_11-02-08,fp7d
2022-04-06,VS,14,14,0,14,2022-05-03_11-02-08,fp7d
2022-04-06,ZG,8,8,0,8,2022-05-03_11-02-08,fp7d
2022-04-06,ZH,190,184,6,178,2022-05-03_11-02-08,fp7d
2022-04-07,AG,54,51,0,51,2022-05-03_11-02-08,fp7d
2022-04-07,AI,0,0,0,0,2022-05-03_11-02-08,fp7d
2022-04-07,AR,6,6,0,6,2022-05-03_11-02-08,fp7d
2022-04-07,BE,105,84,3,81,2022-05-03_11-02-08,fp7d
2022-04-07,BL,20,14,0,14,2022-05-03_11-02-08,fp7d
2022-04-07,BS,54,52,2,50,2022-05-03_11-02-08,fp7d
2022-04-07,FR,24,20,0,20,2022-05-03_11-02-08,fp7d
2022-04-07,GE,38,51,13,38,2022-05-03_11-02-08,fp7d
2022-04-07,GL,6,6,0,6,2022-05-03_11-02-08,fp7d
2022-04-07,GR,16,16,0,16,2022-05-03_11-02-08,fp7d
2022-04-07,JU,6,6,0,6,2022-05-03_11-02-08,fp7d
2022-04-07,LU,59,47,0,47,2022-05-03_11-02-08,fp7d
2022-04-07,NE,10,10,0,10,2022-05-03_11-02-08,fp7d
2022-04-07,NW,6,6,0,6,2022-05-03_11-02-08,fp7d
2022-04-07,OW,0,0,0,0,2022-05-03_11-02-08,fp7d
2022-04-07,SG,54,40,1,39,2022-05-03_11-02-08,fp7d
2022-04-07,SH,8,7,0,7,2022-05-03_11-02-08,fp7d
2022-04-07,SO,17,16,0,16,2022-05-03_11-02-08,fp7d
2022-04-07,SZ,13,11,0,11,2022-05-03_11-02-08,fp7d
2022-04-07,TG,21,27,6,21,2022-05-03_11-02-08,fp7d
2022-04-07,TI,53,59,6,53,2022-05-03_11-02-08,fp7d
2022-04-07,UR,6,6,0,6,2022-05-03_11-02-08,fp7d
2022-04-07,VD,86,88,2,86,2022-05-03_11-02-08,fp7d
2022-04-07,VS,14,14,0,14,2022-05-03_11-02-08,fp7d
2022-04-07,ZG,8,8,0,8,2022-05-03_11-02-08,fp7d
2022-04-07,ZH,190,183,6,177,2022-05-03_11-02-08,fp7d
2022-04-08,AG,54,51,0,51,2022-05-03_11-02-08,fp7d
2022-04-08,AI,0,0,0,0,2022-05-03_11-02-08,fp7d
2022-04-08,AR,6,6,0,6,2022-05-03_11-02-08,fp7d
2022-04-08,BE,105,81,3,78,2022-05-03_11-02-08,fp7d
2022-04-08,BL,20,14,0,14,2022-05-03_11-02-08,fp7d
2022-04-08,BS,54,52,2,50,2022-05-03_11-02-08,fp7d
2022-04-08,FR,24,20,0,20,2022-05-03_11-02-08,fp7d
2022-04-08,GE,38,51,13,38,2022-05-03_11-02-08,fp7d
2022-04-08,GL,6,6,0,6,2022-05-03_11-02-08,fp7d
2022-04-08,GR,16,16,0,16,2022-05-03_11-02-08,fp7d
2022-04-08,JU,6,6,0,6,2022-05-03_11-02-08,fp7d
2022-04-08,LU,59,46,0,46,2022-05-03_11-02-08,fp7d
2022-04-08,NE,10,10,0,10,2022-05-03_11-02-08,fp7d
2022-04-08,NW,6,6,0,6,2022-05-03_11-02-08,fp7d
2022-04-08,OW,0,0,0,0,2022-05-03_11-02-08,fp7d
2022-04-08,SG,54,40,1,39,2022-05-03_11-02-08,fp7d
2022-04-08,SH,8,6,0,6,2022-05-03_11-02-08,fp7d
2022-04-08,SO,17,16,0,16,2022-05-03_11-02-08,fp7d
2022-04-08,SZ,13,11,0,11,2022-05-03_11-02-08,fp7d
2022-04-08,TG,21,27,6,21,2022-05-03_11-02-08,fp7d
2022-04-08,TI,53,59,6,53,2022-05-03_11-02-08,fp7d
2022-04-08,UR,6,6,0,6,2022-05-03_11-02-08,fp7d
2022-04-08,VD,86,88,2,86,2022-05-03_11-02-08,fp7d
2022-04-08,VS,14,14,0,14,2022-05-03_11-02-08,fp7d
2022-04-08,ZG,8,8,0,8,2022-05-03_11-02-08,fp7d
2022-04-08,ZH,190,182,6,176,2022-05-03_11-02-08,fp7d
2022-04-09,AG,54,51,0,51,2022-05-03_11-02-08,fp7d
2022-04-09,AI,0,0,0,0,2022-05-03_11-02-08,fp7d
2022-04-09,AR,6,6,0,6,2022-05-03_11-02-08,fp7d
2022-04-09,BE,105,81,3,78,2022-05-03_11-02-08,fp7d
2022-04-09,BL,20,14,0,14,2022-05-03_11-02-08,fp7d
2022-04-09,BS,54,48,2,46,2022-05-03_11-02-08,fp7d
2022-04-09,FR,24,20,0,20,2022-05-03_11-02-08,fp7d
2022-04-09,GE,38,50,12,38,2022-05-03_11-02-08,fp7d
2022-04-09,GL,6,6,0,6,2022-05-03_11-02-08,fp7d
2022-04-09,GR,16,16,0,16,2022-05-03_11-02-08,fp7d
2022-04-09,JU,6,6,0,6,2022-05-03_11-02-08,fp7d
2022-04-09,LU,59,44,0,44,2022-05-03_11-02-08,fp7d
2022-04-09,NE,10,10,0,10,2022-05-03_11-02-08,fp7d
2022-04-09,NW,6,6,0,6,2022-05-03_11-02-08,fp7d
2022-04-09,OW,0,0,0,0,2022-05-03_11-02-08,fp7d
2022-04-09,SG,54,40,1,39,2022-05-03_11-02-08,fp7d
2022-04-09,SH,8,6,0,6,2022-05-03_11-02-08,fp7d
2022-04-09,SO,17,16,0,16,2022-05-03_11-02-08,fp7d
2022-04-09,SZ,13,11,0,11,2022-05-03_11-02-08,fp7d
2022-04-09,TG,21,27,6,21,2022-05-03_11-02-08,fp7d
2022-04-09,TI,53,59,6,53,2022-05-03_11-02-08,fp7d
2022-04-09,UR,6,6,0,6,2022-05-03_11-02-08,fp7d
2022-04-09,VD,86,88,2,86,2022-05-03_11-02-08,fp7d
2022-04-09,VS,14,14,0,14,2022-05-03_11-02-08,fp7d
2022-04-09,ZG,8,8,0,8,2022-05-03_11-02-08,fp7d
2022-04-09,ZH,190,178,6,172,2022-05-03_11-02-08,fp7d
2022-04-10,AG,54,51,0,51,2022-05-03_11-02-08,fp7d
2022-04-10,AI,0,0,0,0,2022-05-03_11-02-08,fp7d
2022-04-10,AR,6,6,0,6,2022-05-03_11-02-08,fp7d
2022-04-10,BE,105,81,3,78,2022-05-03_11-02-08,fp7d
2022-04-10,BL,20,14,0,14,2022-05-03_11-02-08,fp7d
2022-04-10,BS,54,48,2,46,2022-05-03_11-02-08,fp7d
2022-04-10,FR,24,20,0,20,2022-05-03_11-02-08,fp7d
2022-04-10,GE,38,51,13,38,2022-05-03_11-02-08,fp7d
2022-04-10,GL,6,6,0,6,2022-05-03_11-02-08,fp7d
2022-04-10,GR,16,16,0,16,2022-05-03_11-02-08,fp7d
2022-04-10,JU,6,6,0,6,2022-05-03_11-02-08,fp7d
2022-04-10,LU,59,44,0,44,2022-05-03_11-02-08,fp7d
2022-04-10,NE,10,10,0,10,2022-05-03_11-02-08,fp7d
2022-04-10,NW,6,6,0,6,2022-05-03_11-02-08,fp7d
2022-04-10,OW,0,0,0,0,2022-05-03_11-02-08,fp7d
2022-04-10,SG,54,40,1,39,2022-05-03_11-02-08,fp7d
2022-04-10,SH,8,6,0,6,2022-05-03_11-02-08,fp7d
2022-04-10,SO,17,16,0,16,2022-05-03_11-02-08,fp7d
2022-04-10,SZ,13,11,0,11,2022-05-03_11-02-08,fp7d
2022-04-10,TG,21,27,6,21,2022-05-03_11-02-08,fp7d
2022-04-10,TI,53,59,6,53,2022-05-03_11-02-08,fp7d
2022-04-10,UR,6,6,0,6,2022-05-03_11-02-08,fp7d
2022-04-10,VD,86,88,2,86,2022-05-03_11-02-08,fp7d
2022-04-10,VS,14,14,0,14,2022-05-03_11-02-08,fp7d
2022-04-10,ZG,8,8,0,8,2022-05-03_11-02-08,fp7d
2022-04-10,ZH,190,180,6,174,2022-05-03_11-02-08,fp7d
2022-04-11,AG,54,51,0,51,2022-05-03_11-02-08,fp7d
2022-04-11,AI,0,0,0,0,2022-05-03_11-02-08,fp7d
2022-04-11,AR,6,6,0,6,2022-05-03_11-02-08,fp7d
2022-04-11,BE,106,83,3,80,2022-05-03_11-02-08,fp7d
2022-04-11,BL,20,14,0,14,2022-05-03_11-02-08,fp7d
2022-04-11,BS,54,52,2,50,2022-05-03_11-02-08,fp7d
2022-04-11,FR,24,20,0,20,2022-05-03_11-02-08,fp7d
2022-04-11,GE,38,51,13,38,2022-05-03_11-02-08,fp7d
2022-04-11,GL,6,6,0,6,2022-05-03_11-02-08,fp7d
2022-04-11,GR,16,16,0,16,2022-05-03_11-02-08,fp7d
2022-04-11,JU,6,6,0,6,2022-05-03_11-02-08,fp7d
2022-04-11,LU,59,44,0,44,2022-05-03_11-02-08,fp7d
2022-04-11,NE,10,10,0,10,2022-05-03_11-02-08,fp7d
2022-04-11,NW,6,6,0,6,2022-05-03_11-02-08,fp7d
2022-04-11,OW,0,0,0,0,2022-05-03_11-02-08,fp7d
2022-04-11,SG,54,40,1,39,2022-05-03_11-02-08,fp7d
2022-04-11,SH,8,6,0,6,2022-05-03_11-02-08,fp7d
2022-04-11,SO,17,16,0,16,2022-05-03_11-02-08,fp7d
2022-04-11,SZ,13,11,0,11,2022-05-03_11-02-08,fp7d
2022-04-11,TG,21,27,6,21,2022-05-03_11-02-08,fp7d
2022-04-11,TI,53,59,6,53,2022-05-03_11-02-08,fp7d
2022-04-11,UR,6,6,0,6,2022-05-03_11-02-08,fp7d
2022-04-11,VD,86,88,2,86,2022-05-03_11-02-08,fp7d
2022-04-11,VS,14,14,0,14,2022-05-03_11-02-08,fp7d
2022-04-11,ZG,8,8,0,8,2022-05-03_11-02-08,fp7d
2022-04-11,ZH,190,182,6,176,2022-05-03_11-02-08,fp7d
2022-04-12,AG,54,51,0,51,2022-05-03_11-02-08,fp7d
2022-04-12,AI,0,0,0,0,2022-05-03_11-02-08,fp7d
2022-04-12,AR,6,6,0,6,2022-05-03_11-02-08,fp7d
2022-04-12,BE,106,84,3,81,2022-05-03_11-02-08,fp7d
2022-04-12,BL,20,14,0,14,2022-05-03_11-02-08,fp7d
2022-04-12,BS,54,52,2,50,2022-05-03_11-02-08,fp7d
2022-04-12,FR,24,20,0,20,2022-05-03_11-02-08,fp7d
2022-04-12,GE,38,51,13,38,2022-05-03_11-02-08,fp7d
2022-04-12,GL,6,6,0,6,2022-05-03_11-02-08,fp7d
2022-04-12,GR,16,16,0,16,2022-05-03_11-02-08,fp7d
2022-04-12,JU,6,6,0,6,2022-05-03_11-02-08,fp7d
2022-04-12,LU,59,44,0,44,2022-05-03_11-02-08,fp7d
2022-04-12,NE,10,10,0,10,2022-05-03_11-02-08,fp7d
2022-04-12,NW,6,6,0,6,2022-05-03_11-02-08,fp7d
2022-04-12,OW,0,0,0,0,2022-05-03_11-02-08,fp7d
2022-04-12,SG,54,40,1,39,2022-05-03_11-02-08,fp7d
2022-04-12,SH,8,7,0,7,2022-05-03_11-02-08,fp7d
2022-04-12,SO,17,16,0,16,2022-05-03_11-02-08,fp7d
2022-04-12,SZ,13,11,0,11,2022-05-03_11-02-08,fp7d
2022-04-12,TG,21,27,6,21,2022-05-03_11-02-08,fp7d
2022-04-12,TI,53,59,6,53,2022-05-03_11-02-08,fp7d
2022-04-12,UR,6,6,0,6,2022-05-03_11-02-08,fp7d
2022-04-12,VD,86,88,2,86,2022-05-03_11-02-08,fp7d
2022-04-12,VS,14,14,0,14,2022-05-03_11-02-08,fp7d
2022-04-12,ZG,8,8,0,8,2022-05-03_11-02-08,fp7d
2022-04-12,ZH,190,183,7,176,2022-05-03_11-02-08,fp7d
2022-04-13,AG,54,51,0,51,2022-05-03_11-02-08,fp7d
2022-04-13,AI,0,0,0,0,2022-05-03_11-02-08,fp7d
2022-04-13,AR,6,6,0,6,2022-05-03_11-02-08,fp7d
2022-04-13,BE,106,84,3,81,2022-05-03_11-02-08,fp7d
2022-04-13,BL,20,14,0,14,2022-05-03_11-02-08,fp7d
2022-04-13,BS,54,52,2,50,2022-05-03_11-02-08,fp7d
2022-04-13,FR,24,20,0,20,2022-05-03_11-02-08,fp7d
2022-04-13,GE,38,51,13,38,2022-05-03_11-02-08,fp7d
2022-04-13,GL,6,6,0,6,2022-05-03_11-02-08,fp7d
2022-04-13,GR,16,16,0,16,2022-05-03_11-02-08,fp7d
2022-04-13,JU,6,6,0,6,2022-05-03_11-02-08,fp7d
2022-04-13,LU,59,44,0,44,2022-05-03_11-02-08,fp7d
2022-04-13,NE,10,10,0,10,2022-05-03_11-02-08,fp7d
2022-04-13,NW,6,6,0,6,2022-05-03_11-02-08,fp7d
2022-04-13,OW,0,0,0,0,2022-05-03_11-02-08,fp7d
2022-04-13,SG,54,40,1,39,2022-05-03_11-02-08,fp7d
2022-04-13,SH,8,7,0,7,2022-05-03_11-02-08,fp7d
2022-04-13,SO,17,15,0,15,2022-05-03_11-02-08,fp7d
2022-04-13,SZ,13,11,0,11,2022-05-03_11-02-08,fp7d
2022-04-13,TG,21,27,6,21,2022-05-03_11-02-08,fp7d
2022-04-13,TI,53,59,6,53,2022-05-03_11-02-08,fp7d
2022-04-13,UR,6,6,0,6,2022-05-03_11-02-08,fp7d
2022-04-13,VD,86,88,2,86,2022-05-03_11-02-08,fp7d
2022-04-13,VS,14,14,0,14,2022-05-03_11-02-08,fp7d
2022-04-13,ZG,8,8,0,8,2022-05-03_11-02-08,fp7d
2022-04-13,ZH,190,182,7,175,2022-05-03_11-02-08,fp7d
2022-04-14,AG,54,51,0,51,2022-05-03_11-02-08,fp7d
2022-04-14,AI,0,0,0,0,2022-05-03_11-02-08,fp7d
2022-04-14,AR,6,6,0,6,2022-05-03_11-02-08,fp7d
2022-04-14,BE,106,82,3,79,2022-05-03_11-02-08,fp7d
2022-04-14,BL,20,14,0,14,2022-05-03_11-02-08,fp7d
2022-04-14,BS,54,52,2,50,2022-05-03_11-02-08,fp7d
2022-04-14,FR,24,20,0,20,2022-05-03_11-02-08,fp7d
2022-04-14,GE,38,51,13,38,2022-05-03_11-02-08,fp7d
2022-04-14,GL,6,6,0,6,2022-05-03_11-02-08,fp7d
2022-04-14,GR,16,16,0,16,2022-05-03_11-02-08,fp7d
2022-04-14,JU,6,6,0,6,2022-05-03_11-02-08,fp7d
2022-04-14,LU,59,44,0,44,2022-05-03_11-02-08,fp7d
2022-04-14,NE,10,10,0,10,2022-05-03_11-02-08,fp7d
2022-04-14,NW,6,6,0,6,2022-05-03_11-02-08,fp7d
2022-04-14,OW,0,0,0,0,2022-05-03_11-02-08,fp7d
2022-04-14,SG,54,40,1,39,2022-05-03_11-02-08,fp7d
2022-04-14,SH,8,7,0,7,2022-05-03_11-02-08,fp7d
2022-04-14,SO,17,16,0,16,2022-05-03_11-02-08,fp7d
2022-04-14,SZ,13,11,0,11,2022-05-03_11-02-08,fp7d
2022-04-14,TG,21,27,6,21,2022-05-03_11-02-08,fp7d
2022-04-14,TI,53,59,6,53,2022-05-03_11-02-08,fp7d
2022-04-14,UR,6,6,0,6,2022-05-03_11-02-08,fp7d
2022-04-14,VD,86,88,2,86,2022-05-03_11-02-08,fp7d
2022-04-14,VS,14,14,0,14,2022-05-03_11-02-08,fp7d
2022-04-14,ZG,8,8,0,8,2022-05-03_11-02-08,fp7d
2022-04-14,ZH,190,184,7,177,2022-05-03_11-02-08,fp7d
2022-04-15,AG,54,49,0,49,2022-05-03_11-02-08,fp7d
2022-04-15,AI,0,0,0,0,2022-05-03_11-02-08,fp7d
2022-04-15,AR,6,6,0,6,2022-05-03_11-02-08,fp7d
2022-04-15,BE,106,82,3,79,2022-05-03_11-02-08,fp7d
2022-04-15,BL,20,14,0,14,2022-05-03_11-02-08,fp7d
2022-04-15,BS,54,52,2,50,2022-05-03_11-02-08,fp7d
2022-04-15,FR,24,20,0,20,2022-05-03_11-02-08,fp7d
2022-04-15,GE,38,51,13,38,2022-05-03_11-02-08,fp7d
2022-04-15,GL,6,6,0,6,2022-05-03_11-02-08,fp7d
2022-04-15,GR,16,16,0,16,2022-05-03_11-02-08,fp7d
2022-04-15,JU,6,6,0,6,2022-05-03_11-02-08,fp7d
2022-04-15,LU,59,44,0,44,2022-05-03_11-02-08,fp7d
2022-04-15,NE,10,10,0,10,2022-05-03_11-02-08,fp7d
2022-04-15,NW,6,6,0,6,2022-05-03_11-02-08,fp7d
2022-04-15,OW,0,0,0,0,2022-05-03_11-02-08,fp7d
2022-04-15,SG,54,40,1,39,2022-05-03_11-02-08,fp7d
2022-04-15,SH,8,7,0,7,2022-05-03_11-02-08,fp7d
2022-04-15,SO,17,16,0,16,2022-05-03_11-02-08,fp7d
2022-04-15,SZ,13,11,0,11,2022-05-03_11-02-08,fp7d
2022-04-15,TG,21,27,6,21,2022-05-03_11-02-08,fp7d
2022-04-15,TI,53,59,6,53,2022-05-03_11-02-08,fp7d
2022-04-15,UR,6,6,0,6,2022-05-03_11-02-08,fp7d
2022-04-15,VD,86,88,2,86,2022-05-03_11-02-08,fp7d
2022-04-15,VS,14,14,0,14,2022-05-03_11-02-08,fp7d
2022-04-15,ZG,8,8,0,8,2022-05-03_11-02-08,fp7d
2022-04-15,ZH,190,183,7,176,2022-05-03_11-02-08,fp7d
2022-04-16,AG,54,49,0,49,2022-05-03_11-02-08,fp7d
2022-04-16,AI,0,0,0,0,2022-05-03_11-02-08,fp7d
2022-04-16,AR,6,6,0,6,2022-05-03_11-02-08,fp7d
2022-04-16,BE,105,81,3,78,2022-05-03_11-02-08,fp7d
2022-04-16,BL,20,14,0,14,2022-05-03_11-02-08,fp7d
2022-04-16,BS,54,48,2,46,2022-05-03_11-02-08,fp7d
2022-04-16,FR,24,20,0,20,2022-05-03_11-02-08,fp7d
2022-04-16,GE,38,51,13,38,2022-05-03_11-02-08,fp7d
2022-04-16,GL,6,6,0,6,2022-05-03_11-02-08,fp7d
2022-04-16,GR,16,16,0,16,2022-05-03_11-02-08,fp7d
2022-04-16,JU,6,6,0,6,2022-05-03_11-02-08,fp7d
2022-04-16,LU,59,44,0,44,2022-05-03_11-02-08,fp7d
2022-04-16,NE,10,10,0,10,2022-05-03_11-02-08,fp7d
2022-04-16,NW,6,6,0,6,2022-05-03_11-02-08,fp7d
2022-04-16,OW,0,0,0,0,2022-05-03_11-02-08,fp7d
2022-04-16,SG,54,40,1,39,2022-05-03_11-02-08,fp7d
2022-04-16,SH,8,7,0,7,2022-05-03_11-02-08,fp7d
2022-04-16,SO,17,16,0,16,2022-05-03_11-02-08,fp7d
2022-04-16,SZ,13,11,0,11,2022-05-03_11-02-08,fp7d
2022-04-16,TG,21,27,6,21,2022-05-03_11-02-08,fp7d
2022-04-16,TI,53,59,6,53,2022-05-03_11-02-08,fp7d
2022-04-16,UR,6,6,0,6,2022-05-03_11-02-08,fp7d
2022-04-16,VD,86,88,2,86,2022-05-03_11-02-08,fp7d
2022-04-16,VS,14,14,0,14,2022-05-03_11-02-08,fp7d
2022-04-16,ZG,8,8,0,8,2022-05-03_11-02-08,fp7d
2022-04-16,ZH,190,180,7,173,2022-05-03_11-02-08,fp7d
2022-04-17,AG,54,49,0,49,2022-05-03_11-02-08,fp7d
2022-04-17,AI,0,0,0,0,2022-05-03_11-02-08,fp7d
2022-04-17,AR,6,6,0,6,2022-05-03_11-02-08,fp7d
2022-04-17,BE,105,81,3,78,2022-05-03_11-02-08,fp7d
2022-04-17,BL,20,14,0,14,2022-05-03_11-02-08,fp7d
2022-04-17,BS,54,48,2,46,2022-05-03_11-02-08,fp7d
2022-04-17,FR,24,20,0,20,2022-05-03_11-02-08,fp7d
2022-04-17,GE,38,51,13,38,2022-05-03_11-02-08,fp7d
2022-04-17,GL,6,6,0,6,2022-05-03_11-02-08,fp7d
2022-04-17,GR,16,16,0,16,2022-05-03_11-02-08,fp7d
2022-04-17,JU,6,6,0,6,2022-05-03_11-02-08,fp7d
2022-04-17,LU,59,44,0,44,2022-05-03_11-02-08,fp7d
2022-04-17,NE,10,10,0,10,2022-05-03_11-02-08,fp7d
2022-04-17,NW,6,5,0,5,2022-05-03_11-02-08,fp7d
2022-04-17,OW,0,0,0,0,2022-05-03_11-02-08,fp7d
2022-04-17,SG,54,40,1,39,2022-05-03_11-02-08,fp7d
2022-04-17,SH,8,7,0,7,2022-05-03_11-02-08,fp7d
2022-04-17,SO,17,16,0,16,2022-05-03_11-02-08,fp7d
2022-04-17,SZ,13,11,0,11,2022-05-03_11-02-08,fp7d
2022-04-17,TG,21,27,6,21,2022-05-03_11-02-08,fp7d
2022-04-17,TI,53,59,6,53,2022-05-03_11-02-08,fp7d
2022-04-17,UR,6,6,0,6,2022-05-03_11-02-08,fp7d
2022-04-17,VD,86,88,2,86,2022-05-03_11-02-08,fp7d
2022-04-17,VS,14,14,0,14,2022-05-03_11-02-08,fp7d
2022-04-17,ZG,8,8,0,8,2022-05-03_11-02-08,fp7d
2022-04-17,ZH,190,178,6,172,2022-05-03_11-02-08,fp7d
2022-04-18,AG,54,49,0,49,2022-05-03_11-02-08,fp7d
2022-04-18,AI,0,0,0,0,2022-05-03_11-02-08,fp7d
2022-04-18,AR,6,6,0,6,2022-05-03_11-02-08,fp7d
2022-04-18,BE,106,82,3,79,2022-05-03_11-02-08,fp7d
2022-04-18,BL,20,14,0,14,2022-05-03_11-02-08,fp7d
2022-04-18,BS,54,52,2,50,2022-05-03_11-02-08,fp7d
2022-04-18,FR,24,20,0,20,2022-05-03_11-02-08,fp7d
2022-04-18,GE,38,51,13,38,2022-05-03_11-02-08,fp7d
2022-04-18,GL,6,6,0,6,2022-05-03_11-02-08,fp7d
2022-04-18,GR,16,16,0,16,2022-05-03_11-02-08,fp7d
2022-04-18,JU,6,6,0,6,2022-05-03_11-02-08,fp7d
2022-04-18,LU,59,44,0,44,2022-05-03_11-02-08,fp7d
2022-04-18,NE,10,10,0,10,2022-05-03_11-02-08,fp7d
2022-04-18,NW,6,5,0,5,2022-05-03_11-02-08,fp7d
2022-04-18,OW,0,0,0,0,2022-05-03_11-02-08,fp7d
2022-04-18,SG,54,40,1,39,2022-05-03_11-02-08,fp7d
2022-04-18,SH,8,7,0,7,2022-05-03_11-02-08,fp7d
2022-04-18,SO,17,14,0,14,2022-05-03_11-02-08,fp7d
2022-04-18,SZ,13,11,0,11,2022-05-03_11-02-08,fp7d
2022-04-18,TG,21,27,6,21,2022-05-03_11-02-08,fp7d
2022-04-18,TI,53,59,6,53,2022-05-03_11-02-08,fp7d
2022-04-18,UR,6,6,0,6,2022-05-03_11-02-08,fp7d
2022-04-18,VD,86,88,2,86,2022-05-03_11-02-08,fp7d
2022-04-18,VS,14,14,0,14,2022-05-03_11-02-08,fp7d
2022-04-18,ZG,8,8,0,8,2022-05-03_11-02-08,fp7d
2022-04-18,ZH,190,179,6,173,2022-05-03_11-02-08,fp7d
2022-04-19,AG,54,49,0,49,2022-05-03_11-02-08,fp7d
2022-04-19,AI,0,0,0,0,2022-05-03_11-02-08,fp7d
2022-04-19,AR,6,6,0,6,2022-05-03_11-02-08,fp7d
2022-04-19,BE,106,82,3,79,2022-05-03_11-02-08,fp7d
2022-04-19,BL,20,14,0,14,2022-05-03_11-02-08,fp7d
2022-04-19,BS,54,52,2,50,2022-05-03_11-02-08,fp7d
2022-04-19,FR,24,20,0,20,2022-05-03_11-02-08,fp7d
2022-04-19,GE,38,51,13,38,2022-05-03_11-02-08,fp7d
2022-04-19,GL,6,6,0,6,2022-05-03_11-02-08,fp7d
2022-04-19,GR,16,16,0,16,2022-05-03_11-02-08,fp7d
2022-04-19,JU,6,6,0,6,2022-05-03_11-02-08,fp7d
2022-04-19,LU,59,45,0,45,2022-05-03_11-02-08,fp7d
2022-04-19,NE,10,10,0,10,2022-05-03_11-02-08,fp7d
2022-04-19,NW,6,5,0,5,2022-05-03_11-02-08,fp7d
2022-04-19,OW,0,0,0,0,2022-05-03_11-02-08,fp7d
2022-04-19,SG,54,40,1,39,2022-05-03_11-02-08,fp7d
2022-04-19,SH,8,7,0,7,2022-05-03_11-02-08,fp7d
2022-04-19,SO,17,16,0,16,2022-05-03_11-02-08,fp7d
2022-04-19,SZ,13,11,0,11,2022-05-03_11-02-08,fp7d
2022-04-19,TG,21,27,6,21,2022-05-03_11-02-08,fp7d
2022-04-19,TI,53,59,6,53,2022-05-03_11-02-08,fp7d
2022-04-19,UR,6,6,0,6,2022-05-03_11-02-08,fp7d
2022-04-19,VD,86,88,2,86,2022-05-03_11-02-08,fp7d
2022-04-19,VS,14,14,0,14,2022-05-03_11-02-08,fp7d
2022-04-19,ZG,8,8,0,8,2022-05-03_11-02-08,fp7d
2022-04-19,ZH,190,182,6,176,2022-05-03_11-02-08,fp7d
2022-04-20,AG,54,49,0,49,2022-05-03_11-02-08,fp7d
2022-04-20,AI,0,0,0,0,2022-05-03_11-02-08,fp7d
2022-04-20,AR,6,6,0,6,2022-05-03_11-02-08,fp7d
2022-04-20,BE,106,82,3,79,2022-05-03_11-02-08,fp7d
2022-04-20,BL,20,14,0,14,2022-05-03_11-02-08,fp7d
2022-04-20,BS,54,52,2,50,2022-05-03_11-02-08,fp7d
2022-04-20,FR,24,20,0,20,2022-05-03_11-02-08,fp7d
2022-04-20,GE,38,51,13,38,2022-05-03_11-02-08,fp7d
2022-04-20,GL,6,6,0,6,2022-05-03_11-02-08,fp7d
2022-04-20,GR,16,16,0,16,2022-05-03_11-02-08,fp7d
2022-04-20,JU,6,6,0,6,2022-05-03_11-02-08,fp7d
2022-04-20,LU,59,48,0,48,2022-05-03_11-02-08,fp7d
2022-04-20,NE,10,10,0,10,2022-05-03_11-02-08,fp7d
2022-04-20,NW,6,5,0,5,2022-05-03_11-02-08,fp7d
2022-04-20,OW,0,0,0,0,2022-05-03_11-02-08,fp7d
2022-04-20,SG,54,40,1,39,2022-05-03_11-02-08,fp7d
2022-04-20,SH,8,7,0,7,2022-05-03_11-02-08,fp7d
2022-04-20,SO,17,16,0,16,2022-05-03_11-02-08,fp7d
2022-04-20,SZ,13,11,0,11,2022-05-03_11-02-08,fp7d
2022-04-20,TG,21,27,6,21,2022-05-03_11-02-08,fp7d
2022-04-20,TI,53,59,6,53,2022-05-03_11-02-08,fp7d
2022-04-20,UR,6,6,0,6,2022-05-03_11-02-08,fp7d
2022-04-20,VD,86,88,2,86,2022-05-03_11-02-08,fp7d
2022-04-20,VS,14,14,0,14,2022-05-03_11-02-08,fp7d
2022-04-20,ZG,8,8,0,8,2022-05-03_11-02-08,fp7d
2022-04-20,ZH,190,183,7,176,2022-05-03_11-02-08,fp7d
2022-04-21,AG,54,49,0,49,2022-05-03_11-02-08,fp7d
2022-04-21,AI,0,0,0,0,2022-05-03_11-02-08,fp7d
2022-04-21,AR,6,6,0,6,2022-05-03_11-02-08,fp7d
2022-04-21,BE,106,82,3,79,2022-05-03_11-02-08,fp7d
2022-04-21,BL,20,14,0,14,2022-05-03_11-02-08,fp7d
2022-04-21,BS,54,52,2,50,2022-05-03_11-02-08,fp7d
2022-04-21,FR,24,20,0,20,2022-05-03_11-02-08,fp7d
2022-04-21,GE,38,51,13,38,2022-05-03_11-02-08,fp7d
2022-04-21,GL,6,6,0,6,2022-05-03_11-02-08,fp7d
2022-04-21,GR,16,16,0,16,2022-05-03_11-02-08,fp7d
2022-04-21,JU,6,6,0,6,2022-05-03_11-02-08,fp7d
2022-04-21,LU,59,48,0,48,2022-05-03_11-02-08,fp7d
2022-04-21,NE,10,10,0,10,2022-05-03_11-02-08,fp7d
2022-04-21,NW,6,6,0,6,2022-05-03_11-02-08,fp7d
2022-04-21,OW,0,0,0,0,2022-05-03_11-02-08,fp7d
2022-04-21,SG,54,40,1,39,2022-05-03_11-02-08,fp7d
2022-04-21,SH,8,7,0,7,2022-05-03_11-02-08,fp7d
2022-04-21,SO,17,16,0,16,2022-05-03_11-02-08,fp7d
2022-04-21,SZ,13,11,0,11,2022-05-03_11-02-08,fp7d
2022-04-21,TG,21,27,6,21,2022-05-03_11-02-08,fp7d
2022-04-21,TI,53,59,6,53,2022-05-03_11-02-08,fp7d
2022-04-21,UR,6,6,0,6,2022-05-03_11-02-08,fp7d
2022-04-21,VD,86,88,2,86,2022-05-03_11-02-08,fp7d
2022-04-21,VS,14,14,0,14,2022-05-03_11-02-08,fp7d
2022-04-21,ZG,8,8,0,8,2022-05-03_11-02-08,fp7d
2022-04-21,ZH,190,180,7,173,2022-05-03_11-02-08,fp7d
2022-04-22,AG,54,49,0,49,2022-05-03_11-02-08,fp7d
2022-04-22,AI,0,0,0,0,2022-05-03_11-02-08,fp7d
2022-04-22,AR,6,6,0,6,2022-05-03_11-02-08,fp7d
2022-04-22,BE,106,82,3,79,2022-05-03_11-02-08,fp7d
2022-04-22,BL,20,14,0,14,2022-05-03_11-02-08,fp7d
2022-04-22,BS,54,52,2,50,2022-05-03_11-02-08,fp7d
2022-04-22,FR,24,20,0,20,2022-05-03_11-02-08,fp7d
2022-04-22,GE,38,51,13,38,2022-05-03_11-02-08,fp7d
2022-04-22,GL,6,6,0,6,2022-05-03_11-02-08,fp7d
2022-04-22,GR,16,16,0,16,2022-05-03_11-02-08,fp7d
2022-04-22,JU,6,6,0,6,2022-05-03_11-02-08,fp7d
2022-04-22,LU,59,48,0,48,2022-05-03_11-02-08,fp7d
2022-04-22,NE,10,10,0,10,2022-05-03_11-02-08,fp7d
2022-04-22,NW,6,6,0,6,2022-05-03_11-02-08,fp7d
2022-04-22,OW,0,0,0,0,2022-05-03_11-02-08,fp7d
2022-04-22,SG,54,40,1,39,2022-05-03_11-02-08,fp7d
2022-04-22,SH,8,7,0,7,2022-05-03_11-02-08,fp7d
2022-04-22,SO,17,16,0,16,2022-05-03_11-02-08,fp7d
2022-04-22,SZ,13,11,0,11,2022-05-03_11-02-08,fp7d
2022-04-22,TG,21,27,6,21,2022-05-03_11-02-08,fp7d
2022-04-22,TI,53,59,6,53,2022-05-03_11-02-08,fp7d
2022-04-22,UR,6,6,0,6,2022-05-03_11-02-08,fp7d
2022-04-22,VD,86,88,2,86,2022-05-03_11-02-08,fp7d
2022-04-22,VS,14,14,0,14,2022-05-03_11-02-08,fp7d
2022-04-22,ZG,8,8,0,8,2022-05-03_11-02-08,fp7d
2022-04-22,ZH,198,189,7,182,2022-05-03_11-02-08,fp7d
2022-04-23,AG,54,49,0,49,2022-05-03_11-02-08,fp7d
2022-04-23,AI,0,0,0,0,2022-05-03_11-02-08,fp7d
2022-04-23,AR,6,6,0,6,2022-05-03_11-02-08,fp7d
2022-04-23,BE,106,82,3,79,2022-05-03_11-02-08,fp7d
2022-04-23,BL,20,14,0,14,2022-05-03_11-02-08,fp7d
2022-04-23,BS,54,48,2,46,2022-05-03_11-02-08,fp7d
2022-04-23,FR,24,20,0,20,2022-05-03_11-02-08,fp7d
2022-04-23,GE,38,51,13,38,2022-05-03_11-02-08,fp7d
2022-04-23,GL,6,6,0,6,2022-05-03_11-02-08,fp7d
2022-04-23,GR,16,16,0,16,2022-05-03_11-02-08,fp7d
2022-04-23,JU,6,6,0,6,2022-05-03_11-02-08,fp7d
2022-04-23,LU,59,48,0,48,2022-05-03_11-02-08,fp7d
2022-04-23,NE,10,10,0,10,2022-05-03_11-02-08,fp7d
2022-04-23,NW,6,6,0,6,2022-05-03_11-02-08,fp7d
2022-04-23,OW,0,0,0,0,2022-05-03_11-02-08,fp7d
2022-04-23,SG,54,40,1,39,2022-05-03_11-02-08,fp7d
2022-04-23,SH,8,7,0,7,2022-05-03_11-02-08,fp7d
2022-04-23,SO,17,16,0,16,2022-05-03_11-02-08,fp7d
2022-04-23,SZ,13,11,0,11,2022-05-03_11-02-08,fp7d
2022-04-23,TG,21,27,6,21,2022-05-03_11-02-08,fp7d
2022-04-23,TI,53,59,6,53,2022-05-03_11-02-08,fp7d
2022-04-23,UR,6,6,0,6,2022-05-03_11-02-08,fp7d
2022-04-23,VD,86,88,2,86,2022-05-03_11-02-08,fp7d
2022-04-23,VS,14,14,0,14,2022-05-03_11-02-08,fp7d
2022-04-23,ZG,8,8,0,8,2022-05-03_11-02-08,fp7d
2022-04-23,ZH,190,183,7,176,2022-05-03_11-02-08,fp7d
2022-04-24,AG,54,49,0,49,2022-05-03_11-02-08,fp7d
2022-04-24,AI,0,0,0,0,2022-05-03_11-02-08,fp7d
2022-04-24,AR,6,6,0,6,2022-05-03_11-02-08,fp7d
2022-04-24,BE,106,82,3,79,2022-05-03_11-02-08,fp7d
2022-04-24,BL,20,14,0,14,2022-05-03_11-02-08,fp7d
2022-04-24,BS,54,48,2,46,2022-05-03_11-02-08,fp7d
2022-04-24,FR,24,20,0,20,2022-05-03_11-02-08,fp7d
2022-04-24,GE,38,51,13,38,2022-05-03_11-02-08,fp7d
2022-04-24,GL,6,6,0,6,2022-05-03_11-02-08,fp7d
2022-04-24,GR,16,16,0,16,2022-05-03_11-02-08,fp7d
2022-04-24,JU,6,6,0,6,2022-05-03_11-02-08,fp7d
2022-04-24,LU,59,48,0,48,2022-05-03_11-02-08,fp7d
2022-04-24,NE,10,10,0,10,2022-05-03_11-02-08,fp7d
2022-04-24,NW,6,4,0,4,2022-05-03_11-02-08,fp7d
2022-04-24,OW,0,0,0,0,2022-05-03_11-02-08,fp7d
2022-04-24,SG,54,40,1,39,2022-05-03_11-02-08,fp7d
2022-04-24,SH,8,7,0,7,2022-05-03_11-02-08,fp7d
2022-04-24,SO,17,16,0,16,2022-05-03_11-02-08,fp7d
2022-04-24,SZ,13,11,0,11,2022-05-03_11-02-08,fp7d
2022-04-24,TG,21,27,6,21,2022-05-03_11-02-08,fp7d
2022-04-24,TI,53,59,6,53,2022-05-03_11-02-08,fp7d
2022-04-24,UR,6,6,0,6,2022-05-03_11-02-08,fp7d
2022-04-24,VD,86,88,2,86,2022-05-03_11-02-08,fp7d
2022-04-24,VS,14,14,0,14,2022-05-03_11-02-08,fp7d
2022-04-24,ZG,8,8,0,8,2022-05-03_11-02-08,fp7d
2022-04-24,ZH,190,183,7,176,2022-05-03_11-02-08,fp7d
2022-04-25,AG,54,49,0,49,2022-05-03_11-02-08,fp7d
2022-04-25,AI,0,0,0,0,2022-05-03_11-02-08,fp7d
2022-04-25,AR,6,6,0,6,2022-05-03_11-02-08,fp7d
2022-04-25,BE,106,84,3,81,2022-05-03_11-02-08,fp7d
2022-04-25,BL,20,14,0,14,2022-05-03_11-02-08,fp7d
2022-04-25,BS,54,52,2,50,2022-05-03_11-02-08,fp7d
2022-04-25,FR,24,20,0,20,2022-05-03_11-02-08,fp7d
2022-04-25,GE,38,51,13,38,2022-05-03_11-02-08,fp7d
2022-04-25,GL,6,6,0,6,2022-05-03_11-02-08,fp7d
2022-04-25,GR,16,16,0,16,2022-05-03_11-02-08,fp7d
2022-04-25,JU,6,6,0,6,2022-05-03_11-02-08,fp7d
2022-04-25,LU,59,48,0,48,2022-05-03_11-02-08,fp7d
2022-04-25,NE,10,10,0,10,2022-05-03_11-02-08,fp7d
2022-04-25,NW,6,4,0,4,2022-05-03_11-02-08,fp7d
2022-04-25,OW,0,0,0,0,2022-05-03_11-02-08,fp7d
2022-04-25,SG,54,40,1,39,2022-05-03_11-02-08,fp7d
2022-04-25,SH,8,7,0,7,2022-05-03_11-02-08,fp7d
2022-04-25,SO,17,16,0,16,2022-05-03_11-02-08,fp7d
2022-04-25,SZ,13,11,0,11,2022-05-03_11-02-08,fp7d
2022-04-25,TG,21,27,6,21,2022-05-03_11-02-08,fp7d
2022-04-25,TI,53,59,6,53,2022-05-03_11-02-08,fp7d
2022-04-25,UR,6,6,0,6,2022-05-03_11-02-08,fp7d
2022-04-25,VD,86,88,2,86,2022-05-03_11-02-08,fp7d
2022-04-25,VS,14,14,0,14,2022-05-03_11-02-08,fp7d
2022-04-25,ZG,8,8,0,8,2022-05-03_11-02-08,fp7d
2022-04-25,ZH,190,181,6,175,2022-05-03_11-02-08,fp7d
2022-04-26,AG,54,49,0,49,2022-05-03_11-02-08,fp7d
2022-04-26,AI,0,0,0,0,2022-05-03_11-02-08,fp7d
2022-04-26,AR,6,6,0,6,2022-05-03_11-02-08,fp7d
2022-04-26,BE,106,84,3,81,2022-05-03_11-02-08,fp7d
2022-04-26,BL,20,14,0,14,2022-05-03_11-02-08,fp7d
2022-04-26,BS,54,52,2,50,2022-05-03_11-02-08,fp7d
2022-04-26,FR,24,20,0,20,2022-05-03_11-02-08,fp7d
2022-04-26,GE,38,51,13,38,2022-05-03_11-02-08,fp7d
2022-04-26,GL,6,6,0,6,2022-05-03_11-02-08,fp7d
2022-04-26,GR,16,16,0,16,2022-05-03_11-02-08,fp7d
2022-04-26,JU,6,6,0,6,2022-05-03_11-02-08,fp7d
2022-04-26,LU,59,48,0,48,2022-05-03_11-02-08,fp7d
2022-04-26,NE,10,10,0,10,2022-05-03_11-02-08,fp7d
2022-04-26,NW,6,4,0,4,2022-05-03_11-02-08,fp7d
2022-04-26,OW,0,0,0,0,2022-05-03_11-02-08,fp7d
2022-04-26,SG,54,40,1,39,2022-05-03_11-02-08,fp7d
2022-04-26,SH,8,7,0,7,2022-05-03_11-02-08,fp7d
2022-04-26,SO,17,16,0,16,2022-05-03_11-02-08,fp7d
2022-04-26,SZ,13,11,0,11,2022-05-03_11-02-08,fp7d
2022-04-26,TG,21,27,6,21,2022-05-03_11-02-08,fp7d
2022-04-26,TI,53,59,6,53,2022-05-03_11-02-08,fp7d
2022-04-26,UR,6,6,0,6,2022-05-03_11-02-08,fp7d
2022-04-26,VD,86,88,2,86,2022-05-03_11-02-08,fp7d
2022-04-26,VS,14,14,0,14,2022-05-03_11-02-08,fp7d
2022-04-26,ZG,8,8,0,8,2022-05-03_11-02-08,fp7d
2022-04-26,ZH,190,182,6,176,2022-05-03_11-02-08,fp7d
2022-04-27,AG,54,49,0,49,2022-05-03_11-02-08,fp7d
2022-04-27,AI,0,0,0,0,2022-05-03_11-02-08,fp7d
2022-04-27,AR,6,6,0,6,2022-05-03_11-02-08,fp7d
2022-04-27,BE,106,84,3,81,2022-05-03_11-02-08,fp7d
2022-04-27,BL,20,14,0,14,2022-05-03_11-02-08,fp7d
2022-04-27,BS,54,52,2,50,2022-05-03_11-02-08,fp7d
2022-04-27,FR,24,20,0,20,2022-05-03_11-02-08,fp7d
2022-04-27,GE,38,51,13,38,2022-05-03_11-02-08,fp7d
2022-04-27,GL,6,6,0,6,2022-05-03_11-02-08,fp7d
2022-04-27,GR,16,16,0,16,2022-05-03_11-02-08,fp7d
2022-04-27,JU,6,6,0,6,2022-05-03_11-02-08,fp7d
2022-04-27,LU,59,48,0,48,2022-05-03_11-02-08,fp7d
2022-04-27,NE,10,10,0,10,2022-05-03_11-02-08,fp7d
2022-04-27,NW,6,4,0,4,2022-05-03_11-02-08,fp7d
2022-04-27,OW,0,0,0,0,2022-05-03_11-02-08,fp7d
2022-04-27,SG,54,40,1,39,2022-05-03_11-02-08,fp7d
2022-04-27,SH,8,7,0,7,2022-05-03_11-02-08,fp7d
2022-04-27,SO,17,16,0,16,2022-05-03_11-02-08,fp7d
2022-04-27,SZ,13,11,0,11,2022-05-03_11-02-08,fp7d
2022-04-27,TG,21,27,6,21,2022-05-03_11-02-08,fp7d
2022-04-27,TI,53,59,6,53,2022-05-03_11-02-08,fp7d
2022-04-27,UR,6,6,0,6,2022-05-03_11-02-08,fp7d
2022-04-27,VD,86,88,2,86,2022-05-03_11-02-08,fp7d
2022-04-27,VS,14,14,0,14,2022-05-03_11-02-08,fp7d
2022-04-27,ZG,8,8,0,8,2022-05-03_11-02-08,fp7d
2022-04-27,ZH,190,184,6,178,2022-05-03_11-02-08,fp7d
2022-04-28,AG,54,51,0,51,2022-05-03_11-02-08,fp7d
2022-04-28,AI,0,0,0,0,2022-05-03_11-02-08,fp7d
2022-04-28,AR,6,6,0,6,2022-05-03_11-02-08,fp7d
2022-04-28,BE,106,84,3,81,2022-05-03_11-02-08,fp7d
2022-04-28,BL,20,14,0,14,2022-05-03_11-02-08,fp7d
2022-04-28,BS,54,52,2,50,2022-05-03_11-02-08,fp7d
2022-04-28,FR,24,20,0,20,2022-05-03_11-02-08,fp7d
2022-04-28,GE,38,51,13,38,2022-05-03_11-02-08,fp7d
2022-04-28,GL,6,6,0,6,2022-05-03_11-02-08,fp7d
2022-04-28,GR,16,16,0,16,2022-05-03_11-02-08,fp7d
2022-04-28,JU,6,6,0,6,2022-05-03_11-02-08,fp7d
2022-04-28,LU,59,48,0,48,2022-05-03_11-02-08,fp7d
2022-04-28,NE,10,10,0,10,2022-05-03_11-02-08,fp7d
2022-04-28,NW,6,4,0,4,2022-05-03_11-02-08,fp7d
2022-04-28,OW,0,0,0,0,2022-05-03_11-02-08,fp7d
2022-04-28,SG,54,40,1,39,2022-05-03_11-02-08,fp7d
2022-04-28,SH,8,7,0,7,2022-05-03_11-02-08,fp7d
2022-04-28,SO,17,16,0,16,2022-05-03_11-02-08,fp7d
2022-04-28,SZ,13,11,0,11,2022-05-03_11-02-08,fp7d
2022-04-28,TG,21,27,6,21,2022-05-03_11-02-08,fp7d
2022-04-28,TI,53,59,6,53,2022-05-03_11-02-08,fp7d
2022-04-28,UR,6,6,0,6,2022-05-03_11-02-08,fp7d
2022-04-28,VD,86,88,2,86,2022-05-03_11-02-08,fp7d
2022-04-28,VS,14,14,0,14,2022-05-03_11-02-08,fp7d
2022-04-28,ZG,8,8,0,8,2022-05-03_11-02-08,fp7d
2022-04-28,ZH,190,185,7,178,2022-05-03_11-02-08,fp7d
2022-04-29,AG,54,51,0,51,2022-05-03_11-02-08,fp7d
2022-04-29,AI,0,0,0,0,2022-05-03_11-02-08,fp7d
2022-04-29,AR,6,6,0,6,2022-05-03_11-02-08,fp7d
2022-04-29,BE,106,84,3,81,2022-05-03_11-02-08,fp7d
2022-04-29,BL,20,14,0,14,2022-05-03_11-02-08,fp7d
2022-04-29,BS,54,52,2,50,2022-05-03_11-02-08,fp7d
2022-04-29,FR,24,20,0,20,2022-05-03_11-02-08,fp7d
2022-04-29,GE,38,51,13,38,2022-05-03_11-02-08,fp7d
2022-04-29,GL,6,6,0,6,2022-05-03_11-02-08,fp7d
2022-04-29,GR,16,16,0,16,2022-05-03_11-02-08,fp7d
2022-04-29,JU,6,6,0,6,2022-05-03_11-02-08,fp7d
2022-04-29,LU,59,48,0,48,2022-05-03_11-02-08,fp7d
2022-04-29,NE,10,10,0,10,2022-05-03_11-02-08,fp7d
2022-04-29,NW,6,4,0,4,2022-05-03_11-02-08,fp7d
2022-04-29,OW,0,0,0,0,2022-05-03_11-02-08,fp7d
2022-04-29,SG,54,40,1,39,2022-05-03_11-02-08,fp7d
2022-04-29,SH,8,7,0,7,2022-05-03_11-02-08,fp7d
2022-04-29,SO,17,16,0,16,2022-05-03_11-02-08,fp7d
2022-04-29,SZ,13,11,0,11,2022-05-03_11-02-08,fp7d
2022-04-29,TG,21,27,6,21,2022-05-03_11-02-08,fp7d
2022-04-29,TI,53,59,6,53,2022-05-03_11-02-08,fp7d
2022-04-29,UR,6,6,0,6,2022-05-03_11-02-08,fp7d
2022-04-29,VD,86,88,2,86,2022-05-03_11-02-08,fp7d
2022-04-29,VS,14,14,0,14,2022-05-03_11-02-08,fp7d
2022-04-29,ZG,8,8,0,8,2022-05-03_11-02-08,fp7d
2022-04-29,ZH,190,185,7,178,2022-05-03_11-02-08,fp7d
2022-04-30,AG,54,51,0,51,2022-05-03_11-02-08,fp7d
2022-04-30,AI,0,0,0,0,2022-05-03_11-02-08,fp7d
2022-04-30,AR,6,6,0,6,2022-05-03_11-02-08,fp7d
2022-04-30,BE,106,84,3,81,2022-05-03_11-02-08,fp7d
2022-04-30,BL,20,14,0,14,2022-05-03_11-02-08,fp7d
2022-04-30,BS,54,48,2,46,2022-05-03_11-02-08,fp7d
2022-04-30,FR,24,20,0,20,2022-05-03_11-02-08,fp7d
2022-04-30,GE,38,51,13,38,2022-05-03_11-02-08,fp7d
2022-04-30,GL,6,6,0,6,2022-05-03_11-02-08,fp7d
2022-04-30,GR,16,16,0,16,2022-05-03_11-02-08,fp7d
2022-04-30,JU,6,6,0,6,2022-05-03_11-02-08,fp7d
2022-04-30,LU,59,48,0,48,2022-05-03_11-02-08,fp7d
2022-04-30,NE,10,10,0,10,2022-05-03_11-02-08,fp7d
2022-04-30,NW,6,6,0,6,2022-05-03_11-02-08,fp7d
2022-04-30,OW,0,0,0,0,2022-05-03_11-02-08,fp7d
2022-04-30,SG,54,40,1,39,2022-05-03_11-02-08,fp7d
2022-04-30,SH,8,7,0,7,2022-05-03_11-02-08,fp7d
2022-04-30,SO,17,16,0,16,2022-05-03_11-02-08,fp7d
2022-04-30,SZ,13,11,0,11,2022-05-03_11-02-08,fp7d
2022-04-30,TG,21,27,6,21,2022-05-03_11-02-08,fp7d
2022-04-30,TI,53,59,6,53,2022-05-03_11-02-08,fp7d
2022-04-30,UR,6,6,0,6,2022-05-03_11-02-08,fp7d
2022-04-30,VD,86,88,2,86,2022-05-03_11-02-08,fp7d
2022-04-30,VS,14,14,0,14,2022-05-03_11-02-08,fp7d
2022-04-30,ZG,8,8,0,8,2022-05-03_11-02-08,fp7d
2022-04-30,ZH,190,183,6,177,2022-05-03_11-02-08,fp7d
2022-05-01,AG,54,51,0,51,2022-05-03_11-02-08,fp7d
2022-05-01,AI,0,0,0,0,2022-05-03_11-02-08,fp7d
2022-05-01,AR,6,6,0,6,2022-05-03_11-02-08,fp7d
2022-05-01,BE,106,84,3,81,2022-05-03_11-02-08,fp7d
2022-05-01,BL,20,14,0,14,2022-05-03_11-02-08,fp7d
2022-05-01,BS,54,48,2,46,2022-05-03_11-02-08,fp7d
2022-05-01,FR,24,20,0,20,2022-05-03_11-02-08,fp7d
2022-05-01,GE,38,51,13,38,2022-05-03_11-02-08,fp7d
2022-05-01,GL,6,6,0,6,2022-05-03_11-02-08,fp7d
2022-05-01,GR,16,16,0,16,2022-05-03_11-02-08,fp7d
2022-05-01,JU,6,6,0,6,2022-05-03_11-02-08,fp7d
2022-05-01,LU,59,48,0,48,2022-05-03_11-02-08,fp7d
2022-05-01,NE,10,10,0,10,2022-05-03_11-02-08,fp7d
2022-05-01,NW,6,6,0,6,2022-05-03_11-02-08,fp7d
2022-05-01,OW,0,0,0,0,2022-05-03_11-02-08,fp7d
2022-05-01,SG,54,40,1,39,2022-05-03_11-02-08,fp7d
2022-05-01,SH,8,7,0,7,2022-05-03_11-02-08,fp7d
2022-05-01,SO,17,16,0,16,2022-05-03_11-02-08,fp7d
2022-05-01,SZ,13,11,0,11,2022-05-03_11-02-08,fp7d
2022-05-01,TG,21,27,6,21,2022-05-03_11-02-08,fp7d
2022-05-01,TI,53,59,6,53,2022-05-03_11-02-08,fp7d
2022-05-01,UR,6,6,0,6,2022-05-03_11-02-08,fp7d
2022-05-01,VD,86,88,2,86,2022-05-03_11-02-08,fp7d
2022-05-01,VS,14,14,0,14,2022-05-03_11-02-08,fp7d
2022-05-01,ZG,8,8,0,8,2022-05-03_11-02-08,fp7d
2022-05-01,ZH,190,182,6,176,2022-05-03_11-02-08,fp7d
2022-05-02,AG,54,51,0,51,2022-05-03_11-02-08,fp7d
2022-05-02,AI,0,0,0,0,2022-05-03_11-02-08,fp7d
2022-05-02,AR,6,6,0,6,2022-05-03_11-02-08,fp7d
2022-05-02,BE,106,86,3,83,2022-05-03_11-02-08,fp7d
2022-05-02,BL,20,14,0,14,2022-05-03_11-02-08,fp7d
2022-05-02,BS,54,52,2,50,2022-05-03_11-02-08,fp7d
2022-05-02,FR,24,20,0,20,2022-05-03_11-02-08,fp7d
2022-05-02,GE,38,51,13,38,2022-05-03_11-02-08,fp7d
2022-05-02,GL,6,6,0,6,2022-05-03_11-02-08,fp7d
2022-05-02,GR,16,17,1,16,2022-05-03_11-02-08,fp7d
2022-05-02,JU,6,6,0,6,2022-05-03_11-02-08,fp7d
2022-05-02,LU,59,45,0,45,2022-05-03_11-02-08,fp7d
2022-05-02,NE,10,10,0,10,2022-05-03_11-02-08,fp7d
2022-05-02,NW,6,6,0,6,2022-05-03_11-02-08,fp7d
2022-05-02,OW,0,0,0,0,2022-05-03_11-02-08,fp7d
2022-05-02,SG,54,40,1,39,2022-05-03_11-02-08,fp7d
2022-05-02,SH,8,7,0,7,2022-05-03_11-02-08,fp7d
2022-05-02,SO,17,16,0,16,2022-05-03_11-02-08,fp7d
2022-05-02,SZ,13,11,0,11,2022-05-03_11-02-08,fp7d
2022-05-02,TG,21,27,6,21,2022-05-03_11-02-08,fp7d
2022-05-02,TI,53,59,6,53,2022-05-03_11-02-08,fp7d
2022-05-02,UR,6,6,0,6,2022-05-03_11-02-08,fp7d
2022-05-02,VD,86,88,2,86,2022-05-03_11-02-08,fp7d
2022-05-02,VS,14,14,0,14,2022-05-03_11-02-08,fp7d
2022-05-02,ZG,8,8,0,8,2022-05-03_11-02-08,fp7d
2022-05-02,ZH,190,183,6,177,2022-05-03_11-02-08,fp7d
2020-03-30,CH,816,1129,385,744,2022-05-03_11-02-08,fp7d
2020-03-31,CH,834,1176,416,760,2022-05-03_11-02-08,fp7d
2020-04-01,CH,866,1257,455,802,2022-05-03_11-02-08,fp7d
2020-04-02,CH,933,1300,474,826,2022-05-03_11-02-08,fp7d
2020-04-03,CH,878,1307,518,789,2022-05-03_11-02-08,fp7d
2020-04-04,CH,878,1307,520,787,2022-05-03_11-02-08,fp7d
2020-04-05,CH,878,1305,518,787,2022-05-03_11-02-08,fp7d
2020-04-06,CH,937,1485,631,854,2022-05-03_11-02-08,fp7d
2020-04-07,CH,945,1525,659,866,2022-05-03_11-02-08,fp7d
2020-04-08,CH,908,1535,706,829,2022-05-03_11-02-08,fp7d
2020-04-09,CH,843,1556,732,824,2022-05-03_11-02-08,fp7d
2020-04-10,CH,843,1555,731,824,2022-05-03_11-02-08,fp7d
2020-04-11,CH,863,1558,714,844,2022-05-03_11-02-08,fp7d
2020-04-12,CH,863,1551,708,843,2022-05-03_11-02-08,fp7d
2020-04-13,CH,863,1531,687,844,2022-05-03_11-02-08,fp7d
2020-04-14,CH,863,1542,701,841,2022-05-03_11-02-08,fp7d
2020-04-15,CH,857,1519,684,835,2022-05-03_11-02-08,fp7d
2020-04-16,CH,857,1505,670,835,2022-05-03_11-02-08,fp7d
2020-04-17,CH,857,1517,682,835,2022-05-03_11-02-08,fp7d
2020-04-18,CH,877,1487,631,856,2022-05-03_11-02-08,fp7d
2020-04-19,CH,877,1481,626,855,2022-05-03_11-02-08,fp7d
2020-04-20,CH,877,1475,617,858,2022-05-03_11-02-08,fp7d
2020-04-21,CH,877,1460,602,858,2022-05-03_11-02-08,fp7d
2020-04-22,CH,877,1459,601,858,2022-05-03_11-02-08,fp7d
2020-04-23,CH,877,1437,583,854,2022-05-03_11-02-08,fp7d
2020-04-24,CH,877,1425,570,855,2022-05-03_11-02-08,fp7d
2020-04-25,CH,877,1390,536,854,2022-05-03_11-02-08,fp7d
2020-04-26,CH,873,1384,536,848,2022-05-03_11-02-08,fp7d
2020-04-27,CH,873,1361,512,849,2022-05-03_11-02-08,fp7d
2020-04-28,CH,873,1310,461,849,2022-05-03_11-02-08,fp7d
2020-04-29,CH,873,1281,441,840,2022-05-03_11-02-08,fp7d
2020-04-30,CH,873,1260,417,843,2022-05-03_11-02-08,fp7d
2020-05-01,CH,865,1198,368,830,2022-05-03_11-02-08,fp7d
2020-05-02,CH,865,1190,361,829,2022-05-03_11-02-08,fp7d
2020-05-03,CH,865,1190,361,829,2022-05-03_11-02-08,fp7d
2020-05-04,CH,865,1159,328,831,2022-05-03_11-02-08,fp7d
2020-05-05,CH,866,1136,304,832,2022-05-03_11-02-08,fp7d
2020-05-06,CH,866,1126,293,833,2022-05-03_11-02-08,fp7d
2020-05-07,CH,866,1124,291,833,2022-05-03_11-02-08,fp7d
2020-05-08,CH,866,1119,285,834,2022-05-03_11-02-08,fp7d
2020-05-09,CH,866,1116,285,831,2022-05-03_11-02-08,fp7d
2020-05-10,CH,866,1116,285,831,2022-05-03_11-02-08,fp7d
2020-05-11,CH,866,1113,283,830,2022-05-03_11-02-08,fp7d
2020-05-12,CH,866,1121,284,837,2022-05-03_11-02-08,fp7d
2020-05-13,CH,866,1112,275,837,2022-05-03_11-02-08,fp7d
2020-05-14,CH,866,1110,275,835,2022-05-03_11-02-08,fp7d
2020-05-15,CH,866,1106,269,837,2022-05-03_11-02-08,fp7d
2020-05-16,CH,866,1098,263,835,2022-05-03_11-02-08,fp7d
2020-05-17,CH,866,1099,264,835,2022-05-03_11-02-08,fp7d
2020-05-18,CH,864,1099,264,835,2022-05-03_11-02-08,fp7d
2020-05-19,CH,855,1095,260,835,2022-05-03_11-02-08,fp7d
2020-05-20,CH,843,1079,256,823,2022-05-03_11-02-08,fp7d
2020-05-21,CH,843,1075,252,823,2022-05-03_11-02-08,fp7d
2020-05-22,CH,843,1070,251,819,2022-05-03_11-02-08,fp7d
2020-05-23,CH,843,1069,251,818,2022-05-03_11-02-08,fp7d
2020-05-24,CH,843,1071,255,816,2022-05-03_11-02-08,fp7d
2020-05-25,CH,860,1083,257,826,2022-05-03_11-02-08,fp7d
2020-05-26,CH,846,1063,251,812,2022-05-03_11-02-08,fp7d
2020-05-27,CH,860,1079,251,828,2022-05-03_11-02-08,fp7d
2020-05-28,CH,872,1081,239,842,2022-05-03_11-02-08,fp7d
2020-05-29,CH,872,1086,243,843,2022-05-03_11-02-08,fp7d
2020-05-30,CH,872,1083,243,840,2022-05-03_11-02-08,fp7d
2020-05-31,CH,872,1083,243,840,2022-05-03_11-02-08,fp7d
2020-06-01,CH,855,1062,237,825,2022-05-03_11-02-08,fp7d
2020-06-02,CH,855,1059,232,827,2022-05-03_11-02-08,fp7d
2020-06-03,CH,855,1067,240,827,2022-05-03_11-02-08,fp7d
2020-06-04,CH,840,1038,226,812,2022-05-03_11-02-08,fp7d
2020-06-05,CH,834,1029,223,806,2022-05-03_11-02-08,fp7d
2020-06-06,CH,834,1031,223,808,2022-05-03_11-02-08,fp7d
2020-06-07,CH,834,1031,223,808,2022-05-03_11-02-08,fp7d
2020-06-08,CH,834,1037,223,814,2022-05-03_11-02-08,fp7d
2020-06-09,CH,834,1039,225,814,2022-05-03_11-02-08,fp7d
2020-06-10,CH,834,1045,230,815,2022-05-03_11-02-08,fp7d
2020-06-11,CH,812,1012,222,790,2022-05-03_11-02-08,fp7d
2020-06-12,CH,812,1013,223,790,2022-05-03_11-02-08,fp7d
2020-06-13,CH,812,1013,223,790,2022-05-03_11-02-08,fp7d
2020-06-14,CH,812,1013,223,790,2022-05-03_11-02-08,fp7d
2020-06-15,CH,806,1008,223,785,2022-05-03_11-02-08,fp7d
2020-06-16,CH,806,1004,220,784,2022-05-03_11-02-08,fp7d
2020-06-17,CH,806,1004,220,784,2022-05-03_11-02-08,fp7d
2020-06-18,CH,802,989,206,783,2022-05-03_11-02-08,fp7d
2020-06-19,CH,802,980,196,784,2022-05-03_11-02-08,fp7d
2020-06-20,CH,802,980,196,784,2022-05-03_11-02-08,fp7d
2020-06-21,CH,802,980,196,784,2022-05-03_11-02-08,fp7d
2020-06-22,CH,816,993,198,795,2022-05-03_11-02-08,fp7d
2020-06-23,CH,816,994,198,796,2022-05-03_11-02-08,fp7d
2020-06-24,CH,828,1006,198,808,2022-05-03_11-02-08,fp7d
2020-06-25,CH,828,1006,198,808,2022-05-03_11-02-08,fp7d
2020-06-26,CH,828,1006,198,808,2022-05-03_11-02-08,fp7d
2020-06-27,CH,828,1006,198,808,2022-05-03_11-02-08,fp7d
2020-06-28,CH,828,1006,198,808,2022-05-03_11-02-08,fp7d
2020-06-29,CH,828,1002,198,804,2022-05-03_11-02-08,fp7d
2020-06-30,CH,828,1002,198,804,2022-05-03_11-02-08,fp7d
2020-07-01,CH,828,1002,198,804,2022-05-03_11-02-08,fp7d
2020-07-02,CH,837,1002,196,806,2022-05-03_11-02-08,fp7d
2020-07-03,CH,828,993,196,797,2022-05-03_11-02-08,fp7d
2020-07-04,CH,828,993,196,797,2022-05-03_11-02-08,fp7d
2020-07-05,CH,828,993,196,797,2022-05-03_11-02-08,fp7d
2020-07-06,CH,825,987,195,792,2022-05-03_11-02-08,fp7d
2020-07-07,CH,825,987,195,792,2022-05-03_11-02-08,fp7d
2020-07-08,CH,811,967,193,774,2022-05-03_11-02-08,fp7d
2020-07-09,CH,819,972,189,783,2022-05-03_11-02-08,fp7d
2020-07-10,CH,822,982,190,792,2022-05-03_11-02-08,fp7d
2020-07-11,CH,822,984,190,794,2022-05-03_11-02-08,fp7d
2020-07-12,CH,822,984,190,794,2022-05-03_11-02-08,fp7d
2020-07-13,CH,829,994,191,803,2022-05-03_11-02-08,fp7d
2020-07-14,CH,829,992,191,801,2022-05-03_11-02-08,fp7d
2020-07-15,CH,837,1001,192,809,2022-05-03_11-02-08,fp7d
2020-07-16,CH,823,986,189,797,2022-05-03_11-02-08,fp7d
2020-07-17,CH,835,1002,190,812,2022-05-03_11-02-08,fp7d
2020-07-18,CH,835,997,188,809,2022-05-03_11-02-08,fp7d
2020-07-19,CH,835,996,188,808,2022-05-03_11-02-08,fp7d
2020-07-20,CH,849,1013,190,823,2022-05-03_11-02-08,fp7d
2020-07-21,CH,849,1017,190,827,2022-05-03_11-02-08,fp7d
2020-07-22,CH,841,1011,190,821,2022-05-03_11-02-08,fp7d
2020-07-23,CH,841,1008,190,818,2022-05-03_11-02-08,fp7d
2020-07-24,CH,828,998,196,802,2022-05-03_11-02-08,fp7d
2020-07-25,CH,828,998,196,802,2022-05-03_11-02-08,fp7d
2020-07-26,CH,828,998,196,802,2022-05-03_11-02-08,fp7d
2020-07-27,CH,823,996,194,802,2022-05-03_11-02-08,fp7d
2020-07-28,CH,823,996,194,802,2022-05-03_11-02-08,fp7d
2020-07-29,CH,835,1008,194,814,2022-05-03_11-02-08,fp7d
2020-07-30,CH,849,1022,196,826,2022-05-03_11-02-08,fp7d
2020-07-31,CH,849,1022,196,826,2022-05-03_11-02-08,fp7d
2020-08-01,CH,849,1022,196,826,2022-05-03_11-02-08,fp7d
2020-08-02,CH,849,1023,197,826,2022-05-03_11-02-08,fp7d
2020-08-03,CH,849,1025,196,829,2022-05-03_11-02-08,fp7d
2020-08-04,CH,849,1006,182,824,2022-05-03_11-02-08,fp7d
2020-08-05,CH,843,995,173,822,2022-05-03_11-02-08,fp7d
2020-08-06,CH,852,995,173,822,2022-05-03_11-02-08,fp7d
2020-08-07,CH,852,994,172,822,2022-05-03_11-02-08,fp7d
2020-08-08,CH,838,978,170,808,2022-05-03_11-02-08,fp7d
2020-08-09,CH,832,966,164,802,2022-05-03_11-02-08,fp7d
2020-08-10,CH,832,963,164,799,2022-05-03_11-02-08,fp7d
2020-08-11,CH,832,962,164,798,2022-05-03_11-02-08,fp7d
2020-08-12,CH,824,955,164,791,2022-05-03_11-02-08,fp7d
2020-08-13,CH,832,964,165,799,2022-05-03_11-02-08,fp7d
2020-08-14,CH,832,963,164,799,2022-05-03_11-02-08,fp7d
2020-08-15,CH,832,961,164,797,2022-05-03_11-02-08,fp7d
2020-08-16,CH,832,961,164,797,2022-05-03_11-02-08,fp7d
2020-08-17,CH,832,960,161,799,2022-05-03_11-02-08,fp7d
2020-08-18,CH,832,963,164,799,2022-05-03_11-02-08,fp7d
2020-08-19,CH,844,975,164,811,2022-05-03_11-02-08,fp7d
2020-08-20,CH,844,976,164,812,2022-05-03_11-02-08,fp7d
2020-08-21,CH,844,977,165,812,2022-05-03_11-02-08,fp7d
2020-08-22,CH,844,977,165,812,2022-05-03_11-02-08,fp7d
2020-08-23,CH,844,977,165,812,2022-05-03_11-02-08,fp7d
2020-08-24,CH,850,989,170,819,2022-05-03_11-02-08,fp7d
2020-08-25,CH,850,989,170,819,2022-05-03_11-02-08,fp7d
2020-08-26,CH,864,1009,176,833,2022-05-03_11-02-08,fp7d
2020-08-27,CH,864,1007,174,833,2022-05-03_11-02-08,fp7d
2020-08-28,CH,864,1011,177,834,2022-05-03_11-02-08,fp7d
2020-08-29,CH,864,1013,179,834,2022-05-03_11-02-08,fp7d
2020-08-30,CH,864,1013,179,834,2022-05-03_11-02-08,fp7d
2020-08-31,CH,858,992,163,829,2022-05-03_11-02-08,fp7d
2020-09-01,CH,863,998,166,832,2022-05-03_11-02-08,fp7d
2020-09-02,CH,851,986,166,820,2022-05-03_11-02-08,fp7d
2020-09-03,CH,863,1006,166,840,2022-05-03_11-02-08,fp7d
2020-09-04,CH,849,990,164,826,2022-05-03_11-02-08,fp7d
2020-09-05,CH,855,1002,170,832,2022-05-03_11-02-08,fp7d
2020-09-06,CH,855,1002,170,832,2022-05-03_11-02-08,fp7d
2020-09-07,CH,855,1002,170,832,2022-05-03_11-02-08,fp7d
2020-09-08,CH,855,1002,169,833,2022-05-03_11-02-08,fp7d
2020-09-09,CH,855,1003,170,833,2022-05-03_11-02-08,fp7d
2020-09-10,CH,860,1009,170,839,2022-05-03_11-02-08,fp7d
2020-09-11,CH,860,1009,171,838,2022-05-03_11-02-08,fp7d
2020-09-12,CH,854,997,165,832,2022-05-03_11-02-08,fp7d
2020-09-13,CH,854,997,165,832,2022-05-03_11-02-08,fp7d
2020-09-14,CH,848,989,163,826,2022-05-03_11-02-08,fp7d
2020-09-15,CH,854,1000,169,831,2022-05-03_11-02-08,fp7d
2020-09-16,CH,848,991,170,821,2022-05-03_11-02-08,fp7d
2020-09-17,CH,863,1002,169,833,2022-05-03_11-02-08,fp7d
2020-09-18,CH,863,999,169,830,2022-05-03_11-02-08,fp7d
2020-09-19,CH,854,990,169,821,2022-05-03_11-02-08,fp7d
2020-09-20,CH,854,990,169,821,2022-05-03_11-02-08,fp7d
2020-09-21,CH,857,994,165,829,2022-05-03_11-02-08,fp7d
2020-09-22,CH,857,991,159,832,2022-05-03_11-02-08,fp7d
2020-09-23,CH,857,997,165,832,2022-05-03_11-02-08,fp7d
2020-09-24,CH,845,987,164,823,2022-05-03_11-02-08,fp7d
2020-09-25,CH,845,985,164,821,2022-05-03_11-02-08,fp7d
2020-09-26,CH,845,985,164,821,2022-05-03_11-02-08,fp7d
2020-09-27,CH,831,969,162,807,2022-05-03_11-02-08,fp7d
2020-09-28,CH,831,969,162,807,2022-05-03_11-02-08,fp7d
2020-09-29,CH,831,975,167,808,2022-05-03_11-02-08,fp7d
2020-09-30,CH,825,970,168,802,2022-05-03_11-02-08,fp7d
2020-10-01,CH,845,981,161,820,2022-05-03_11-02-08,fp7d
2020-10-02,CH,845,981,161,820,2022-05-03_11-02-08,fp7d
2020-10-03,CH,845,981,161,820,2022-05-03_11-02-08,fp7d
2020-10-04,CH,845,981,161,820,2022-05-03_11-02-08,fp7d
2020-10-05,CH,845,979,159,820,2022-05-03_11-02-08,fp7d
2020-10-06,CH,845,979,159,820,2022-05-03_11-02-08,fp7d
2020-10-07,CH,845,980,159,821,2022-05-03_11-02-08,fp7d
2020-10-08,CH,848,980,159,821,2022-05-03_11-02-08,fp7d
2020-10-09,CH,840,970,157,813,2022-05-03_11-02-08,fp7d
2020-10-10,CH,840,970,157,813,2022-05-03_11-02-08,fp7d
2020-10-11,CH,840,976,163,813,2022-05-03_11-02-08,fp7d
2020-10-12,CH,848,990,169,821,2022-05-03_11-02-08,fp7d
2020-10-13,CH,848,992,169,823,2022-05-03_11-02-08,fp7d
2020-10-14,CH,863,1010,169,841,2022-05-03_11-02-08,fp7d
2020-10-15,CH,863,1007,167,840,2022-05-03_11-02-08,fp7d
2020-10-16,CH,854,998,167,831,2022-05-03_11-02-08,fp7d
2020-10-17,CH,854,999,167,832,2022-05-03_11-02-08,fp7d
2020-10-18,CH,863,1008,167,841,2022-05-03_11-02-08,fp7d
2020-10-19,CH,863,1006,165,841,2022-05-03_11-02-08,fp7d
2020-10-20,CH,863,1008,167,841,2022-05-03_11-02-08,fp7d
2020-10-21,CH,863,1007,166,841,2022-05-03_11-02-08,fp7d
2020-10-22,CH,863,1007,172,835,2022-05-03_11-02-08,fp7d
2020-10-23,CH,863,1019,185,834,2022-05-03_11-02-08,fp7d
2020-10-24,CH,863,1020,186,834,2022-05-03_11-02-08,fp7d
2020-10-25,CH,867,1021,183,838,2022-05-03_11-02-08,fp7d
2020-10-26,CH,863,1016,182,834,2022-05-03_11-02-08,fp7d
2020-10-27,CH,863,1016,184,832,2022-05-03_11-02-08,fp7d
2020-10-28,CH,863,1033,201,832,2022-05-03_11-02-08,fp7d
2020-10-29,CH,863,1037,205,832,2022-05-03_11-02-08,fp7d
2020-10-30,CH,849,1018,206,812,2022-05-03_11-02-08,fp7d
2020-10-31,CH,855,1027,209,818,2022-05-03_11-02-08,fp7d
2020-11-01,CH,855,1036,213,823,2022-05-03_11-02-08,fp7d
2020-11-02,CH,863,1054,223,831,2022-05-03_11-02-08,fp7d
2020-11-03,CH,883,1086,241,845,2022-05-03_11-02-08,fp7d
2020-11-04,CH,883,1005,177,828,2022-05-03_11-02-08,fp7d
2020-11-05,CH,875,1034,203,831,2022-05-03_11-02-08,fp7d
2020-11-06,CH,883,1051,208,843,2022-05-03_11-02-08,fp7d
2020-11-07,CH,883,1056,210,846,2022-05-03_11-02-08,fp7d
2020-11-08,CH,883,1058,212,846,2022-05-03_11-02-08,fp7d
2020-11-09,CH,875,1071,225,846,2022-05-03_11-02-08,fp7d
2020-11-10,CH,875,1090,245,845,2022-05-03_11-02-08,fp7d
2020-11-11,CH,874,1097,251,846,2022-05-03_11-02-08,fp7d
2020-11-12,CH,876,1103,255,848,2022-05-03_11-02-08,fp7d
2020-11-13,CH,876,1112,262,850,2022-05-03_11-02-08,fp7d
2020-11-14,CH,876,1125,271,854,2022-05-03_11-02-08,fp7d
2020-11-15,CH,876,1128,276,852,2022-05-03_11-02-08,fp7d
2020-11-16,CH,875,1139,284,855,2022-05-03_11-02-08,fp7d
2020-11-17,CH,875,1142,287,855,2022-05-03_11-02-08,fp7d
2020-11-18,CH,875,1142,287,855,2022-05-03_11-02-08,fp7d
2020-11-19,CH,873,1132,282,850,2022-05-03_11-02-08,fp7d
2020-11-20,CH,873,1132,282,850,2022-05-03_11-02-08,fp7d
2020-11-21,CH,873,1131,284,847,2022-05-03_11-02-08,fp7d
2020-11-22,CH,873,1136,289,847,2022-05-03_11-02-08,fp7d
2020-11-23,CH,873,1124,280,844,2022-05-03_11-02-08,fp7d
2020-11-24,CH,873,1126,282,844,2022-05-03_11-02-08,fp7d
2020-11-25,CH,873,1127,279,848,2022-05-03_11-02-08,fp7d
2020-11-26,CH,873,1125,279,846,2022-05-03_11-02-08,fp7d
2020-11-27,CH,870,1118,275,843,2022-05-03_11-02-08,fp7d
2020-11-28,CH,870,1115,271,844,2022-05-03_11-02-08,fp7d
2020-11-29,CH,870,1117,273,844,2022-05-03_11-02-08,fp7d
2020-11-30,CH,870,1114,272,842,2022-05-03_11-02-08,fp7d
2020-12-01,CH,870,1115,271,844,2022-05-03_11-02-08,fp7d
2020-12-02,CH,870,1113,269,844,2022-05-03_11-02-08,fp7d
2020-12-03,CH,870,1112,268,844,2022-05-03_11-02-08,fp7d
2020-12-04,CH,870,1110,263,847,2022-05-03_11-02-08,fp7d
2020-12-05,CH,870,1105,260,845,2022-05-03_11-02-08,fp7d
2020-12-06,CH,870,1102,257,845,2022-05-03_11-02-08,fp7d
2020-12-07,CH,870,1099,254,845,2022-05-03_11-02-08,fp7d
2020-12-08,CH,870,1097,251,846,2022-05-03_11-02-08,fp7d
2020-12-09,CH,870,1090,246,844,2022-05-03_11-02-08,fp7d
2020-12-10,CH,870,1087,245,842,2022-05-03_11-02-08,fp7d
2020-12-11,CH,864,1079,245,834,2022-05-03_11-02-08,fp7d
2020-12-12,CH,864,1082,244,838,2022-05-03_11-02-08,fp7d
2020-12-13,CH,864,1078,241,837,2022-05-03_11-02-08,fp7d
2020-12-14,CH,864,1070,234,836,2022-05-03_11-02-08,fp7d
2020-12-15,CH,870,1082,240,842,2022-05-03_11-02-08,fp7d
2020-12-16,CH,870,1084,240,844,2022-05-03_11-02-08,fp7d
2020-12-17,CH,870,1079,235,844,2022-05-03_11-02-08,fp7d
2020-12-18,CH,870,1071,234,837,2022-05-03_11-02-08,fp7d
2020-12-19,CH,870,1068,236,832,2022-05-03_11-02-08,fp7d
2020-12-20,CH,870,1066,236,830,2022-05-03_11-02-08,fp7d
2020-12-21,CH,870,1065,231,834,2022-05-03_11-02-08,fp7d
2020-12-22,CH,870,1048,217,831,2022-05-03_11-02-08,fp7d
2020-12-23,CH,870,1043,211,832,2022-05-03_11-02-08,fp7d
2020-12-24,CH,870,1041,211,830,2022-05-03_11-02-08,fp7d
2020-12-25,CH,856,1027,208,819,2022-05-03_11-02-08,fp7d
2020-12-26,CH,856,1025,208,817,2022-05-03_11-02-08,fp7d
2020-12-27,CH,856,1030,212,818,2022-05-03_11-02-08,fp7d
2020-12-28,CH,870,1041,204,837,2022-05-03_11-02-08,fp7d
2020-12-29,CH,870,1042,204,838,2022-05-03_11-02-08,fp7d
2020-12-30,CH,870,1035,198,837,2022-05-03_11-02-08,fp7d
2020-12-31,CH,870,1035,199,836,2022-05-03_11-02-08,fp7d
2021-01-01,CH,870,1032,198,834,2022-05-03_11-02-08,fp7d
2021-01-02,CH,870,1030,199,831,2022-05-03_11-02-08,fp7d
2021-01-03,CH,870,1032,199,833,2022-05-03_11-02-08,fp7d
2021-01-04,CH,870,1039,202,837,2022-05-03_11-02-08,fp7d
2021-01-05,CH,870,1042,205,837,2022-05-03_11-02-08,fp7d
2021-01-06,CH,870,1045,208,837,2022-05-03_11-02-08,fp7d
2021-01-07,CH,870,1035,203,832,2022-05-03_11-02-08,fp7d
2021-01-08,CH,870,1040,201,839,2022-05-03_11-02-08,fp7d
2021-01-09,CH,870,1038,199,839,2022-05-03_11-02-08,fp7d
2021-01-10,CH,870,1038,198,840,2022-05-03_11-02-08,fp7d
2021-01-11,CH,870,1037,198,839,2022-05-03_11-02-08,fp7d
2021-01-12,CH,870,1048,207,841,2022-05-03_11-02-08,fp7d
2021-01-13,CH,870,1045,206,839,2022-05-03_11-02-08,fp7d
2021-01-14,CH,870,1033,195,838,2022-05-03_11-02-08,fp7d
2021-01-15,CH,870,1026,188,838,2022-05-03_11-02-08,fp7d
2021-01-16,CH,870,1026,188,838,2022-05-03_11-02-08,fp7d
2021-01-17,CH,870,1026,188,838,2022-05-03_11-02-08,fp7d
2021-01-18,CH,870,1014,178,836,2022-05-03_11-02-08,fp7d
2021-01-19,CH,870,1015,178,837,2022-05-03_11-02-08,fp7d
2021-01-20,CH,870,1010,177,833,2022-05-03_11-02-08,fp7d
2021-01-21,CH,870,1008,175,833,2022-05-03_11-02-08,fp7d
2021-01-22,CH,870,1001,168,833,2022-05-03_11-02-08,fp7d
2021-01-23,CH,870,999,166,833,2022-05-03_11-02-08,fp7d
2021-01-24,CH,870,999,166,833,2022-05-03_11-02-08,fp7d
2021-01-25,CH,870,998,165,833,2022-05-03_11-02-08,fp7d
2021-01-26,CH,870,994,165,829,2022-05-03_11-02-08,fp7d
2021-01-27,CH,870,996,166,830,2022-05-03_11-02-08,fp7d
2021-01-28,CH,856,990,167,823,2022-05-03_11-02-08,fp7d
2021-01-29,CH,856,988,163,825,2022-05-03_11-02-08,fp7d
2021-01-30,CH,856,980,161,819,2022-05-03_11-02-08,fp7d
2021-01-31,CH,856,976,158,818,2022-05-03_11-02-08,fp7d
2021-02-01,CH,870,982,152,830,2022-05-03_11-02-08,fp7d
2021-02-02,CH,870,985,155,830,2022-05-03_11-02-08,fp7d
2021-02-03,CH,870,981,150,831,2022-05-03_11-02-08,fp7d
2021-02-04,CH,870,982,147,835,2022-05-03_11-02-08,fp7d
2021-02-05,CH,872,981,147,834,2022-05-03_11-02-08,fp7d
2021-02-06,CH,872,983,147,836,2022-05-03_11-02-08,fp7d
2021-02-07,CH,872,979,147,832,2022-05-03_11-02-08,fp7d
2021-02-08,CH,872,980,147,833,2022-05-03_11-02-08,fp7d
2021-02-09,CH,872,977,147,830,2022-05-03_11-02-08,fp7d
2021-02-10,CH,872,977,145,832,2022-05-03_11-02-08,fp7d
2021-02-11,CH,872,978,145,833,2022-05-03_11-02-08,fp7d
2021-02-12,CH,870,981,149,832,2022-05-03_11-02-08,fp7d
2021-02-13,CH,870,984,149,835,2022-05-03_11-02-08,fp7d
2021-02-14,CH,870,985,149,836,2022-05-03_11-02-08,fp7d
2021-02-15,CH,856,976,149,827,2022-05-03_11-02-08,fp7d
2021-02-16,CH,856,973,147,826,2022-05-03_11-02-08,fp7d
2021-02-17,CH,856,978,148,830,2022-05-03_11-02-08,fp7d
2021-02-18,CH,864,974,141,833,2022-05-03_11-02-08,fp7d
2021-02-19,CH,864,975,142,833,2022-05-03_11-02-08,fp7d
2021-02-20,CH,864,971,143,828,2022-05-03_11-02-08,fp7d
2021-02-21,CH,864,971,143,828,2022-05-03_11-02-08,fp7d
2021-02-22,CH,855,967,146,821,2022-05-03_11-02-08,fp7d
2021-02-23,CH,870,986,150,836,2022-05-03_11-02-08,fp7d
2021-02-24,CH,870,985,150,835,2022-05-03_11-02-08,fp7d
2021-02-25,CH,870,985,149,836,2022-05-03_11-02-08,fp7d
2021-02-26,CH,870,979,143,836,2022-05-03_11-02-08,fp7d
2021-02-27,CH,870,974,143,831,2022-05-03_11-02-08,fp7d
2021-02-28,CH,870,972,142,830,2022-05-03_11-02-08,fp7d
2021-03-01,CH,870,971,130,841,2022-05-03_11-02-08,fp7d
2021-03-02,CH,864,963,128,835,2022-05-03_11-02-08,fp7d
2021-03-03,CH,864,963,129,834,2022-05-03_11-02-08,fp7d
2021-03-04,CH,864,954,120,834,2022-05-03_11-02-08,fp7d
2021-03-05,CH,864,954,122,832,2022-05-03_11-02-08,fp7d
2021-03-06,CH,864,952,120,832,2022-05-03_11-02-08,fp7d
2021-03-07,CH,864,947,121,826,2022-05-03_11-02-08,fp7d
2021-03-08,CH,870,957,120,837,2022-05-03_11-02-08,fp7d
2021-03-09,CH,870,964,126,838,2022-05-03_11-02-08,fp7d
2021-03-10,CH,870,967,131,836,2022-05-03_11-02-08,fp7d
2021-03-11,CH,858,957,130,827,2022-05-03_11-02-08,fp7d
2021-03-12,CH,858,955,128,827,2022-05-03_11-02-08,fp7d
2021-03-13,CH,858,954,127,827,2022-05-03_11-02-08,fp7d
2021-03-14,CH,858,952,127,825,2022-05-03_11-02-08,fp7d
2021-03-15,CH,850,953,129,824,2022-05-03_11-02-08,fp7d
2021-03-16,CH,850,947,125,822,2022-05-03_11-02-08,fp7d
2021-03-17,CH,850,941,119,822,2022-05-03_11-02-08,fp7d
2021-03-18,CH,850,942,119,823,2022-05-03_11-02-08,fp7d
2021-03-19,CH,850,944,121,823,2022-05-03_11-02-08,fp7d
2021-03-20,CH,850,934,117,817,2022-05-03_11-02-08,fp7d
2021-03-21,CH,850,936,117,819,2022-05-03_11-02-08,fp7d
2021-03-22,CH,838,928,116,812,2022-05-03_11-02-08,fp7d
2021-03-23,CH,838,928,116,812,2022-05-03_11-02-08,fp7d
2021-03-24,CH,838,929,116,813,2022-05-03_11-02-08,fp7d
2021-03-25,CH,838,933,122,811,2022-05-03_11-02-08,fp7d
2021-03-26,CH,838,930,119,811,2022-05-03_11-02-08,fp7d
2021-03-27,CH,838,927,119,808,2022-05-03_11-02-08,fp7d
2021-03-28,CH,838,928,121,807,2022-05-03_11-02-08,fp7d
2021-03-29,CH,850,939,117,822,2022-05-03_11-02-08,fp7d
2021-03-30,CH,850,937,115,822,2022-05-03_11-02-08,fp7d
2021-03-31,CH,850,934,112,822,2022-05-03_11-02-08,fp7d
2021-04-01,CH,850,935,112,823,2022-05-03_11-02-08,fp7d
2021-04-02,CH,856,929,111,818,2022-05-03_11-02-08,fp7d
2021-04-03,CH,856,929,110,819,2022-05-03_11-02-08,fp7d
2021-04-04,CH,856,928,110,818,2022-05-03_11-02-08,fp7d
2021-04-05,CH,844,917,111,806,2022-05-03_11-02-08,fp7d
2021-04-06,CH,844,931,118,813,2022-05-03_11-02-08,fp7d
2021-04-07,CH,844,923,109,814,2022-05-03_11-02-08,fp7d
2021-04-08,CH,844,908,101,807,2022-05-03_11-02-08,fp7d
2021-04-09,CH,844,908,101,807,2022-05-03_11-02-08,fp7d
2021-04-10,CH,844,901,98,803,2022-05-03_11-02-08,fp7d
2021-04-11,CH,844,904,100,804,2022-05-03_11-02-08,fp7d
2021-04-12,CH,844,896,86,810,2022-05-03_11-02-08,fp7d
2021-04-13,CH,844,902,90,812,2022-05-03_11-02-08,fp7d
2021-04-14,CH,856,911,88,823,2022-05-03_11-02-08,fp7d
2021-04-15,CH,856,912,92,820,2022-05-03_11-02-08,fp7d
2021-04-16,CH,856,912,93,819,2022-05-03_11-02-08,fp7d
2021-04-17,CH,856,907,90,817,2022-05-03_11-02-08,fp7d
2021-04-18,CH,856,906,89,817,2022-05-03_11-02-08,fp7d
2021-04-19,CH,856,912,92,820,2022-05-03_11-02-08,fp7d
2021-04-20,CH,856,920,96,824,2022-05-03_11-02-08,fp7d
2021-04-21,CH,844,909,95,814,2022-05-03_11-02-08,fp7d
2021-04-22,CH,844,908,96,812,2022-05-03_11-02-08,fp7d
2021-04-23,CH,844,907,98,809,2022-05-03_11-02-08,fp7d
2021-04-24,CH,844,902,100,802,2022-05-03_11-02-08,fp7d
2021-04-25,CH,844,900,98,802,2022-05-03_11-02-08,fp7d
2021-04-26,CH,844,912,100,812,2022-05-03_11-02-08,fp7d
2021-04-27,CH,844,908,97,811,2022-05-03_11-02-08,fp7d
2021-04-28,CH,844,905,96,809,2022-05-03_11-02-08,fp7d
2021-04-29,CH,844,905,96,809,2022-05-03_11-02-08,fp7d
2021-04-30,CH,844,906,97,809,2022-05-03_11-02-08,fp7d
2021-05-01,CH,844,898,95,803,2022-05-03_11-02-08,fp7d
2021-05-02,CH,844,896,95,801,2022-05-03_11-02-08,fp7d
2021-05-03,CH,844,896,95,801,2022-05-03_11-02-08,fp7d
2021-05-04,CH,844,895,88,807,2022-05-03_11-02-08,fp7d
2021-05-05,CH,851,899,85,814,2022-05-03_11-02-08,fp7d
2021-05-06,CH,858,906,85,821,2022-05-03_11-02-08,fp7d
2021-05-07,CH,858,896,74,822,2022-05-03_11-02-08,fp7d
2021-05-08,CH,858,898,75,823,2022-05-03_11-02-08,fp7d
2021-05-09,CH,858,895,76,819,2022-05-03_11-02-08,fp7d
2021-05-10,CH,858,904,81,823,2022-05-03_11-02-08,fp7d
2021-05-11,CH,857,902,80,822,2022-05-03_11-02-08,fp7d
2021-05-12,CH,857,899,78,821,2022-05-03_11-02-08,fp7d
2021-05-13,CH,850,884,74,810,2022-05-03_11-02-08,fp7d
2021-05-14,CH,850,886,74,812,2022-05-03_11-02-08,fp7d
2021-05-15,CH,850,879,74,805,2022-05-03_11-02-08,fp7d
2021-05-16,CH,850,878,74,804,2022-05-03_11-02-08,fp7d
2021-05-17,CH,857,892,74,818,2022-05-03_11-02-08,fp7d
2021-05-18,CH,857,893,74,819,2022-05-03_11-02-08,fp7d
2021-05-19,CH,857,895,76,819,2022-05-03_11-02-08,fp7d
2021-05-20,CH,857,888,68,820,2022-05-03_11-02-08,fp7d
2021-05-21,CH,857,885,68,817,2022-05-03_11-02-08,fp7d
2021-05-22,CH,857,874,63,811,2022-05-03_11-02-08,fp7d
2021-05-23,CH,857,873,62,811,2022-05-03_11-02-08,fp7d
2021-05-24,CH,857,873,62,811,2022-05-03_11-02-08,fp7d
2021-05-25,CH,857,885,67,818,2022-05-03_11-02-08,fp7d
2021-05-26,CH,848,876,64,812,2022-05-03_11-02-08,fp7d
2021-05-27,CH,848,877,65,812,2022-05-03_11-02-08,fp7d
2021-05-28,CH,857,883,64,819,2022-05-03_11-02-08,fp7d
2021-05-29,CH,857,874,63,811,2022-05-03_11-02-08,fp7d
2021-05-30,CH,857,873,63,810,2022-05-03_11-02-08,fp7d
2021-05-31,CH,857,875,63,812,2022-05-03_11-02-08,fp7d
2021-06-01,CH,858,878,62,816,2022-05-03_11-02-08,fp7d
2021-06-02,CH,870,884,62,822,2022-05-03_11-02-08,fp7d
2021-06-03,CH,864,878,60,818,2022-05-03_11-02-08,fp7d
2021-06-04,CH,870,886,62,824,2022-05-03_11-02-08,fp7d
2021-06-05,CH,870,882,62,820,2022-05-03_11-02-08,fp7d
2021-06-06,CH,870,881,62,819,2022-05-03_11-02-08,fp7d
2021-06-07,CH,870,880,59,821,2022-05-03_11-02-08,fp7d
2021-06-08,CH,870,885,58,827,2022-05-03_11-02-08,fp7d
2021-06-09,CH,870,885,59,826,2022-05-03_11-02-08,fp7d
2021-06-10,CH,870,886,59,827,2022-05-03_11-02-08,fp7d
2021-06-11,CH,870,883,58,825,2022-05-03_11-02-08,fp7d
2021-06-12,CH,870,878,59,819,2022-05-03_11-02-08,fp7d
2021-06-13,CH,870,876,59,817,2022-05-03_11-02-08,fp7d
2021-06-14,CH,870,886,63,823,2022-05-03_11-02-08,fp7d
2021-06-15,CH,869,884,61,823,2022-05-03_11-02-08,fp7d
2021-06-16,CH,862,879,63,816,2022-05-03_11-02-08,fp7d
2021-06-17,CH,869,886,63,823,2022-05-03_11-02-08,fp7d
2021-06-18,CH,869,890,64,826,2022-05-03_11-02-08,fp7d
2021-06-19,CH,869,885,62,823,2022-05-03_11-02-08,fp7d
2021-06-20,CH,869,885,63,822,2022-05-03_11-02-08,fp7d
2021-06-21,CH,869,883,62,821,2022-05-03_11-02-08,fp7d
2021-06-22,CH,869,888,64,824,2022-05-03_11-02-08,fp7d
2021-06-23,CH,869,889,63,826,2022-05-03_11-02-08,fp7d
2021-06-24,CH,863,881,62,819,2022-05-03_11-02-08,fp7d
2021-06-25,CH,863,876,57,819,2022-05-03_11-02-08,fp7d
2021-06-26,CH,863,868,55,813,2022-05-03_11-02-08,fp7d
2021-06-27,CH,863,868,55,813,2022-05-03_11-02-08,fp7d
2021-06-28,CH,863,870,53,817,2022-05-03_11-02-08,fp7d
2021-06-29,CH,863,870,53,817,2022-05-03_11-02-08,fp7d
2021-06-30,CH,851,864,54,810,2022-05-03_11-02-08,fp7d
2021-07-01,CH,852,866,54,812,2022-05-03_11-02-08,fp7d
2021-07-02,CH,852,866,54,812,2022-05-03_11-02-08,fp7d
2021-07-03,CH,852,866,56,810,2022-05-03_11-02-08,fp7d
2021-07-04,CH,852,867,56,811,2022-05-03_11-02-08,fp7d
2021-07-05,CH,852,859,46,813,2022-05-03_11-02-08,fp7d
2021-07-06,CH,852,861,48,813,2022-05-03_11-02-08,fp7d
2021-07-07,CH,852,861,49,812,2022-05-03_11-02-08,fp7d
2021-07-08,CH,852,865,50,815,2022-05-03_11-02-08,fp7d
2021-07-09,CH,852,864,50,814,2022-05-03_11-02-08,fp7d
2021-07-10,CH,852,861,49,812,2022-05-03_11-02-08,fp7d
2021-07-11,CH,852,859,47,812,2022-05-03_11-02-08,fp7d
2021-07-12,CH,852,869,53,816,2022-05-03_11-02-08,fp7d
2021-07-13,CH,852,869,53,816,2022-05-03_11-02-08,fp7d
2021-07-14,CH,852,868,56,812,2022-05-03_11-02-08,fp7d
2021-07-15,CH,852,865,55,810,2022-05-03_11-02-08,fp7d
2021-07-16,CH,851,862,54,808,2022-05-03_11-02-08,fp7d
2021-07-17,CH,851,866,56,810,2022-05-03_11-02-08,fp7d
2021-07-18,CH,851,863,55,808,2022-05-03_11-02-08,fp7d
2021-07-19,CH,852,862,55,807,2022-05-03_11-02-08,fp7d
2021-07-20,CH,852,864,55,809,2022-05-03_11-02-08,fp7d
2021-07-21,CH,852,862,55,807,2022-05-03_11-02-08,fp7d
2021-07-22,CH,852,864,57,807,2022-05-03_11-02-08,fp7d
2021-07-23,CH,858,868,55,813,2022-05-03_11-02-08,fp7d
2021-07-24,CH,858,866,53,813,2022-05-03_11-02-08,fp7d
2021-07-25,CH,858,866,53,813,2022-05-03_11-02-08,fp7d
2021-07-26,CH,858,868,54,814,2022-05-03_11-02-08,fp7d
2021-07-27,CH,858,868,56,812,2022-05-03_11-02-08,fp7d
2021-07-28,CH,858,866,54,812,2022-05-03_11-02-08,fp7d
2021-07-29,CH,858,867,54,813,2022-05-03_11-02-08,fp7d
2021-07-30,CH,858,871,56,815,2022-05-03_11-02-08,fp7d
2021-07-31,CH,858,869,54,815,2022-05-03_11-02-08,fp7d
2021-08-01,CH,858,868,53,815,2022-05-03_11-02-08,fp7d
2021-08-02,CH,858,865,53,812,2022-05-03_11-02-08,fp7d
2021-08-03,CH,858,864,53,811,2022-05-03_11-02-08,fp7d
2021-08-04,CH,858,866,55,811,2022-05-03_11-02-08,fp7d
2021-08-05,CH,858,864,55,809,2022-05-03_11-02-08,fp7d
2021-08-06,CH,858,862,57,805,2022-05-03_11-02-08,fp7d
2021-08-07,CH,858,864,57,807,2022-05-03_11-02-08,fp7d
2021-08-08,CH,858,864,57,807,2022-05-03_11-02-08,fp7d
2021-08-09,CH,858,873,61,812,2022-05-03_11-02-08,fp7d
2021-08-10,CH,858,873,61,812,2022-05-03_11-02-08,fp7d
2021-08-11,CH,858,875,61,814,2022-05-03_11-02-08,fp7d
2021-08-12,CH,858,875,61,814,2022-05-03_11-02-08,fp7d
2021-08-13,CH,858,875,61,814,2022-05-03_11-02-08,fp7d
2021-08-14,CH,858,870,56,814,2022-05-03_11-02-08,fp7d
2021-08-15,CH,858,869,56,813,2022-05-03_11-02-08,fp7d
2021-08-16,CH,858,870,56,814,2022-05-03_11-02-08,fp7d
2021-08-17,CH,858,870,56,814,2022-05-03_11-02-08,fp7d
2021-08-18,CH,858,856,56,800,2022-05-03_11-02-08,fp7d
2021-08-19,CH,858,852,55,797,2022-05-03_11-02-08,fp7d
2021-08-20,CH,858,851,53,798,2022-05-03_11-02-08,fp7d
2021-08-21,CH,858,845,54,791,2022-05-03_11-02-08,fp7d
2021-08-22,CH,858,839,52,787,2022-05-03_11-02-08,fp7d
2021-08-23,CH,858,841,52,789,2022-05-03_11-02-08,fp7d
2021-08-24,CH,858,849,54,795,2022-05-03_11-02-08,fp7d
2021-08-25,CH,858,847,55,792,2022-05-03_11-02-08,fp7d
2021-08-26,CH,858,850,55,795,2022-05-03_11-02-08,fp7d
2021-08-27,CH,858,856,60,796,2022-05-03_11-02-08,fp7d
2021-08-28,CH,859,853,60,793,2022-05-03_11-02-08,fp7d
2021-08-29,CH,859,855,60,795,2022-05-03_11-02-08,fp7d
2021-08-30,CH,859,852,58,794,2022-05-03_11-02-08,fp7d
2021-08-31,CH,859,850,58,792,2022-05-03_11-02-08,fp7d
2021-09-01,CH,859,851,57,794,2022-05-03_11-02-08,fp7d
2021-09-02,CH,859,849,57,792,2022-05-03_11-02-08,fp7d
2021-09-03,CH,859,853,59,794,2022-05-03_11-02-08,fp7d
2021-09-04,CH,859,839,51,788,2022-05-03_11-02-08,fp7d
2021-09-05,CH,871,844,51,793,2022-05-03_11-02-08,fp7d
2021-09-06,CH,870,854,50,804,2022-05-03_11-02-08,fp7d
2021-09-07,CH,870,856,50,806,2022-05-03_11-02-08,fp7d
2021-09-08,CH,871,857,50,807,2022-05-03_11-02-08,fp7d
2021-09-09,CH,870,844,41,803,2022-05-03_11-02-08,fp7d
2021-09-10,CH,870,839,36,803,2022-05-03_11-02-08,fp7d
2021-09-11,CH,870,834,36,798,2022-05-03_11-02-08,fp7d
2021-09-12,CH,870,828,36,792,2022-05-03_11-02-08,fp7d
2021-09-13,CH,870,844,41,803,2022-05-03_11-02-08,fp7d
2021-09-14,CH,870,844,43,801,2022-05-03_11-02-08,fp7d
2021-09-15,CH,870,844,42,802,2022-05-03_11-02-08,fp7d
2021-09-16,CH,870,846,42,804,2022-05-03_11-02-08,fp7d
2021-09-17,CH,870,844,43,801,2022-05-03_11-02-08,fp7d
2021-09-18,CH,870,843,48,795,2022-05-03_11-02-08,fp7d
2021-09-19,CH,870,832,40,792,2022-05-03_11-02-08,fp7d
2021-09-20,CH,870,848,47,801,2022-05-03_11-02-08,fp7d
2021-09-21,CH,870,848,45,803,2022-05-03_11-02-08,fp7d
2021-09-22,CH,870,843,46,797,2022-05-03_11-02-08,fp7d
2021-09-23,CH,870,841,43,798,2022-05-03_11-02-08,fp7d
2021-09-24,CH,870,842,45,797,2022-05-03_11-02-08,fp7d
2021-09-25,CH,870,831,45,786,2022-05-03_11-02-08,fp7d
2021-09-26,CH,870,831,43,788,2022-05-03_11-02-08,fp7d
2021-09-27,CH,870,842,43,799,2022-05-03_11-02-08,fp7d
2021-09-28,CH,871,844,44,800,2022-05-03_11-02-08,fp7d
2021-09-29,CH,871,846,43,803,2022-05-03_11-02-08,fp7d
2021-09-30,CH,871,845,42,803,2022-05-03_11-02-08,fp7d
2021-10-01,CH,871,847,44,803,2022-05-03_11-02-08,fp7d
2021-10-02,CH,871,828,40,788,2022-05-03_11-02-08,fp7d
2021-10-03,CH,871,825,40,785,2022-05-03_11-02-08,fp7d
2021-10-04,CH,871,835,44,791,2022-05-03_11-02-08,fp7d
2021-10-05,CH,871,839,45,794,2022-05-03_11-02-08,fp7d
2021-10-06,CH,871,833,43,790,2022-05-03_11-02-08,fp7d
2021-10-07,CH,871,836,43,793,2022-05-03_11-02-08,fp7d
2021-10-08,CH,871,832,43,789,2022-05-03_11-02-08,fp7d
2021-10-09,CH,871,826,41,785,2022-05-03_11-02-08,fp7d
2021-10-10,CH,871,824,41,783,2022-05-03_11-02-08,fp7d
2021-10-11,CH,871,836,41,795,2022-05-03_11-02-08,fp7d
2021-10-12,CH,871,833,43,790,2022-05-03_11-02-08,fp7d
2021-10-13,CH,871,832,44,788,2022-05-03_11-02-08,fp7d
2021-10-14,CH,865,822,40,782,2022-05-03_11-02-08,fp7d
2021-10-15,CH,871,832,42,790,2022-05-03_11-02-08,fp7d
2021-10-16,CH,871,831,43,788,2022-05-03_11-02-08,fp7d
2021-10-17,CH,871,825,41,784,2022-05-03_11-02-08,fp7d
2021-10-18,CH,871,838,44,794,2022-05-03_11-02-08,fp7d
2021-10-19,CH,871,838,45,793,2022-05-03_11-02-08,fp7d
2021-10-20,CH,871,837,45,792,2022-05-03_11-02-08,fp7d
2021-10-21,CH,871,840,45,795,2022-05-03_11-02-08,fp7d
2021-10-22,CH,871,838,46,792,2022-05-03_11-02-08,fp7d
2021-10-23,CH,871,828,43,785,2022-05-03_11-02-08,fp7d
2021-10-24,CH,871,831,43,788,2022-05-03_11-02-08,fp7d
2021-10-25,CH,871,834,45,789,2022-05-03_11-02-08,fp7d
2021-10-26,CH,871,834,45,789,2022-05-03_11-02-08,fp7d
2021-10-27,CH,871,836,45,791,2022-05-03_11-02-08,fp7d
2021-10-28,CH,871,839,45,794,2022-05-03_11-02-08,fp7d
2021-10-29,CH,871,838,44,794,2022-05-03_11-02-08,fp7d
2021-10-30,CH,871,829,43,786,2022-05-03_11-02-08,fp7d
2021-10-31,CH,871,829,43,786,2022-05-03_11-02-08,fp7d
2021-11-01,CH,871,838,44,794,2022-05-03_11-02-08,fp7d
2021-11-02,CH,871,837,44,793,2022-05-03_11-02-08,fp7d
2021-11-03,CH,871,839,44,795,2022-05-03_11-02-08,fp7d
2021-11-04,CH,871,840,44,796,2022-05-03_11-02-08,fp7d
2021-11-05,CH,871,843,44,799,2022-05-03_11-02-08,fp7d
2021-11-06,CH,871,834,42,792,2022-05-03_11-02-08,fp7d
2021-11-07,CH,871,832,42,790,2022-05-03_11-02-08,fp7d
2021-11-08,CH,871,845,45,800,2022-05-03_11-02-08,fp7d
2021-11-09,CH,871,846,45,801,2022-05-03_11-02-08,fp7d
2021-11-10,CH,871,844,45,799,2022-05-03_11-02-08,fp7d
2021-11-11,CH,871,843,45,798,2022-05-03_11-02-08,fp7d
2021-11-12,CH,871,845,46,799,2022-05-03_11-02-08,fp7d
2021-11-13,CH,871,837,46,791,2022-05-03_11-02-08,fp7d
2021-11-14,CH,871,837,46,791,2022-05-03_11-02-08,fp7d
2021-11-15,CH,871,845,46,799,2022-05-03_11-02-08,fp7d
2021-11-16,CH,871,847,46,801,2022-05-03_11-02-08,fp7d
2021-11-17,CH,871,848,46,802,2022-05-03_11-02-08,fp7d
2021-11-18,CH,872,849,45,804,2022-05-03_11-02-08,fp7d
2021-11-19,CH,872,845,45,800,2022-05-03_11-02-08,fp7d
2021-11-20,CH,872,836,43,793,2022-05-03_11-02-08,fp7d
2021-11-21,CH,872,837,42,795,2022-05-03_11-02-08,fp7d
2021-11-22,CH,872,845,43,802,2022-05-03_11-02-08,fp7d
2021-11-23,CH,874,849,46,803,2022-05-03_11-02-08,fp7d
2021-11-24,CH,874,850,44,806,2022-05-03_11-02-08,fp7d
2021-11-25,CH,874,846,42,804,2022-05-03_11-02-08,fp7d
2021-11-26,CH,874,842,42,800,2022-05-03_11-02-08,fp7d
2021-11-27,CH,874,835,43,792,2022-05-03_11-02-08,fp7d
2021-11-28,CH,874,832,40,792,2022-05-03_11-02-08,fp7d
2021-11-29,CH,874,836,40,796,2022-05-03_11-02-08,fp7d
2021-11-30,CH,874,847,43,804,2022-05-03_11-02-08,fp7d
2021-12-01,CH,874,843,43,800,2022-05-03_11-02-08,fp7d
2021-12-02,CH,874,844,43,801,2022-05-03_11-02-08,fp7d
2021-12-03,CH,872,844,44,800,2022-05-03_11-02-08,fp7d
2021-12-04,CH,872,837,44,793,2022-05-03_11-02-08,fp7d
2021-12-05,CH,872,837,42,795,2022-05-03_11-02-08,fp7d
2021-12-06,CH,872,844,42,802,2022-05-03_11-02-08,fp7d
2021-12-07,CH,872,844,42,802,2022-05-03_11-02-08,fp7d
2021-12-08,CH,873,841,43,798,2022-05-03_11-02-08,fp7d
2021-12-09,CH,874,843,43,800,2022-05-03_11-02-08,fp7d
2021-12-10,CH,871,843,47,796,2022-05-03_11-02-08,fp7d
2021-12-11,CH,871,838,46,792,2022-05-03_11-02-08,fp7d
2021-12-12,CH,878,838,48,790,2022-05-03_11-02-08,fp7d
2021-12-13,CH,886,859,51,808,2022-05-03_11-02-08,fp7d
2021-12-14,CH,886,863,55,808,2022-05-03_11-02-08,fp7d
2021-12-15,CH,879,857,54,803,2022-05-03_11-02-08,fp7d
2021-12-16,CH,877,859,60,799,2022-05-03_11-02-08,fp7d
2021-12-17,CH,879,857,58,799,2022-05-03_11-02-08,fp7d
2021-12-18,CH,879,853,59,794,2022-05-03_11-02-08,fp7d
2021-12-19,CH,879,854,59,795,2022-05-03_11-02-08,fp7d
2021-12-20,CH,879,858,61,797,2022-05-03_11-02-08,fp7d
2021-12-21,CH,879,865,65,800,2022-05-03_11-02-08,fp7d
2021-12-22,CH,879,866,65,801,2022-05-03_11-02-08,fp7d
2021-12-23,CH,879,862,64,798,2022-05-03_11-02-08,fp7d
2021-12-24,CH,880,852,62,790,2022-05-03_11-02-08,fp7d
2021-12-25,CH,875,846,67,779,2022-05-03_11-02-08,fp7d
2021-12-26,CH,876,853,69,784,2022-05-03_11-02-08,fp7d
2021-12-27,CH,876,858,71,787,2022-05-03_11-02-08,fp7d
2021-12-28,CH,873,864,74,790,2022-05-03_11-02-08,fp7d
2021-12-29,CH,873,862,74,788,2022-05-03_11-02-08,fp7d
2021-12-30,CH,873,860,74,786,2022-05-03_11-02-08,fp7d
2021-12-31,CH,873,860,75,785,2022-05-03_11-02-08,fp7d
2022-01-01,CH,873,854,73,781,2022-05-03_11-02-08,fp7d
2022-01-02,CH,873,852,74,778,2022-05-03_11-02-08,fp7d
2022-01-03,CH,875,866,74,792,2022-05-03_11-02-08,fp7d
2022-01-04,CH,877,867,74,793,2022-05-03_11-02-08,fp7d
2022-01-05,CH,877,882,76,806,2022-05-03_11-02-08,fp7d
2022-01-06,CH,877,876,73,803,2022-05-03_11-02-08,fp7d
2022-01-07,CH,878,872,73,799,2022-05-03_11-02-08,fp7d
2022-01-08,CH,878,875,75,800,2022-05-03_11-02-08,fp7d
2022-01-09,CH,878,881,79,802,2022-05-03_11-02-08,fp7d
2022-01-10,CH,878,895,89,806,2022-05-03_11-02-08,fp7d
2022-01-11,CH,878,898,92,806,2022-05-03_11-02-08,fp7d
2022-01-12,CH,878,898,92,806,2022-05-03_11-02-08,fp7d
2022-01-13,CH,880,883,75,808,2022-05-03_11-02-08,fp7d
2022-01-14,CH,880,880,73,807,2022-05-03_11-02-08,fp7d
2022-01-15,CH,880,871,72,799,2022-05-03_11-02-08,fp7d
2022-01-16,CH,880,866,70,796,2022-05-03_11-02-08,fp7d
2022-01-17,CH,881,880,75,805,2022-05-03_11-02-08,fp7d
2022-01-18,CH,881,874,66,808,2022-05-03_11-02-08,fp7d
2022-01-19,CH,881,870,65,805,2022-05-03_11-02-08,fp7d
2022-01-20,CH,881,872,65,807,2022-05-03_11-02-08,fp7d
2022-01-21,CH,881,873,64,809,2022-05-03_11-02-08,fp7d
2022-01-22,CH,881,860,59,801,2022-05-03_11-02-08,fp7d
2022-01-23,CH,881,862,59,803,2022-05-03_11-02-08,fp7d
2022-01-24,CH,882,866,61,805,2022-05-03_11-02-08,fp7d
2022-01-25,CH,879,864,60,804,2022-05-03_11-02-08,fp7d
2022-01-26,CH,880,864,61,803,2022-05-03_11-02-08,fp7d
2022-01-27,CH,880,864,62,802,2022-05-03_11-02-08,fp7d
2022-01-28,CH,878,863,62,801,2022-05-03_11-02-08,fp7d
2022-01-29,CH,879,856,61,795,2022-05-03_11-02-08,fp7d
2022-01-30,CH,879,854,59,795,2022-05-03_11-02-08,fp7d
2022-01-31,CH,887,864,55,809,2022-05-03_11-02-08,fp7d
2022-02-01,CH,879,856,56,800,2022-05-03_11-02-08,fp7d
2022-02-02,CH,879,863,57,806,2022-05-03_11-02-08,fp7d
2022-02-03,CH,879,867,59,808,2022-05-03_11-02-08,fp7d
2022-02-04,CH,877,866,58,808,2022-05-03_11-02-08,fp7d
2022-02-05,CH,876,852,60,792,2022-05-03_11-02-08,fp7d
2022-02-06,CH,876,850,59,791,2022-05-03_11-02-08,fp7d
2022-02-07,CH,878,864,60,804,2022-05-03_11-02-08,fp7d
2022-02-08,CH,878,869,59,810,2022-05-03_11-02-08,fp7d
2022-02-09,CH,878,865,60,805,2022-05-03_11-02-08,fp7d
2022-02-10,CH,878,864,60,804,2022-05-03_11-02-08,fp7d
2022-02-11,CH,878,862,57,805,2022-05-03_11-02-08,fp7d
2022-02-12,CH,878,856,58,798,2022-05-03_11-02-08,fp7d
2022-02-13,CH,878,856,58,798,2022-05-03_11-02-08,fp7d
2022-02-14,CH,879,856,55,801,2022-05-03_11-02-08,fp7d
2022-02-15,CH,879,857,55,802,2022-05-03_11-02-08,fp7d
2022-02-16,CH,878,858,55,803,2022-05-03_11-02-08,fp7d
2022-02-17,CH,878,856,55,801,2022-05-03_11-02-08,fp7d
2022-02-18,CH,878,852,50,802,2022-05-03_11-02-08,fp7d
2022-02-19,CH,878,847,53,794,2022-05-03_11-02-08,fp7d
2022-02-20,CH,878,843,51,792,2022-05-03_11-02-08,fp7d
2022-02-21,CH,871,842,49,793,2022-05-03_11-02-08,fp7d
2022-02-22,CH,871,844,48,796,2022-05-03_11-02-08,fp7d
2022-02-23,CH,871,851,55,796,2022-05-03_11-02-08,fp7d
2022-02-24,CH,877,860,55,805,2022-05-03_11-02-08,fp7d
2022-02-25,CH,877,856,54,802,2022-05-03_11-02-08,fp7d
2022-02-26,CH,877,849,54,795,2022-05-03_11-02-08,fp7d
2022-02-27,CH,877,840,51,789,2022-05-03_11-02-08,fp7d
2022-02-28,CH,874,852,53,799,2022-05-03_11-02-08,fp7d
2022-03-01,CH,874,850,54,796,2022-05-03_11-02-08,fp7d
2022-03-02,CH,879,853,50,803,2022-05-03_11-02-08,fp7d
2022-03-03,CH,875,855,53,802,2022-05-03_11-02-08,fp7d
2022-03-04,CH,875,847,46,801,2022-05-03_11-02-08,fp7d
2022-03-05,CH,875,841,46,795,2022-05-03_11-02-08,fp7d
2022-03-06,CH,875,840,46,794,2022-05-03_11-02-08,fp7d
2022-03-07,CH,875,846,48,798,2022-05-03_11-02-08,fp7d
2022-03-08,CH,869,843,49,794,2022-05-03_11-02-08,fp7d
2022-03-09,CH,869,839,47,792,2022-05-03_11-02-08,fp7d
2022-03-10,CH,870,841,48,793,2022-05-03_11-02-08,fp7d
2022-03-11,CH,873,836,43,793,2022-05-03_11-02-08,fp7d
2022-03-12,CH,873,830,43,787,2022-05-03_11-02-08,fp7d
2022-03-13,CH,873,830,44,786,2022-05-03_11-02-08,fp7d
2022-03-14,CH,873,838,46,792,2022-05-03_11-02-08,fp7d
2022-03-15,CH,875,842,46,796,2022-05-03_11-02-08,fp7d
2022-03-16,CH,874,835,41,794,2022-05-03_11-02-08,fp7d
2022-03-17,CH,873,841,41,800,2022-05-03_11-02-08,fp7d
2022-03-18,CH,876,839,40,799,2022-05-03_11-02-08,fp7d
2022-03-19,CH,876,836,40,796,2022-05-03_11-02-08,fp7d
2022-03-20,CH,874,832,39,793,2022-05-03_11-02-08,fp7d
2022-03-21,CH,872,837,44,793,2022-05-03_11-02-08,fp7d
2022-03-22,CH,876,835,40,795,2022-05-03_11-02-08,fp7d
2022-03-23,CH,876,833,40,793,2022-05-03_11-02-08,fp7d
2022-03-24,CH,874,821,37,784,2022-05-03_11-02-08,fp7d
2022-03-25,CH,874,827,41,786,2022-05-03_11-02-08,fp7d
2022-03-26,CH,874,821,41,780,2022-05-03_11-02-08,fp7d
2022-03-27,CH,875,823,41,782,2022-05-03_11-02-08,fp7d
2022-03-28,CH,874,830,41,789,2022-05-03_11-02-08,fp7d
2022-03-29,CH,874,832,41,791,2022-05-03_11-02-08,fp7d
2022-03-30,CH,875,835,41,794,2022-05-03_11-02-08,fp7d
2022-03-31,CH,875,831,41,790,2022-05-03_11-02-08,fp7d
2022-04-01,CH,875,825,39,786,2022-05-03_11-02-08,fp7d
2022-04-02,CH,875,817,39,778,2022-05-03_11-02-08,fp7d
2022-04-03,CH,874,815,39,776,2022-05-03_11-02-08,fp7d
2022-04-04,CH,874,819,39,780,2022-05-03_11-02-08,fp7d
2022-04-05,CH,880,833,41,792,2022-05-03_11-02-08,fp7d
2022-04-06,CH,874,829,39,790,2022-05-03_11-02-08,fp7d
2022-04-07,CH,874,828,39,789,2022-05-03_11-02-08,fp7d
2022-04-08,CH,874,822,39,783,2022-05-03_11-02-08,fp7d
2022-04-09,CH,874,811,38,773,2022-05-03_11-02-08,fp7d
2022-04-10,CH,874,814,39,775,2022-05-03_11-02-08,fp7d
2022-04-11,CH,875,822,39,783,2022-05-03_11-02-08,fp7d
2022-04-12,CH,875,825,40,785,2022-05-03_11-02-08,fp7d
2022-04-13,CH,875,823,40,783,2022-05-03_11-02-08,fp7d
2022-04-14,CH,875,824,40,784,2022-05-03_11-02-08,fp7d
2022-04-15,CH,875,821,40,781,2022-05-03_11-02-08,fp7d
2022-04-16,CH,874,813,40,773,2022-05-03_11-02-08,fp7d
2022-04-17,CH,874,810,39,771,2022-05-03_11-02-08,fp7d
2022-04-18,CH,875,814,39,775,2022-05-03_11-02-08,fp7d
2022-04-19,CH,875,820,39,781,2022-05-03_11-02-08,fp7d
2022-04-20,CH,875,824,40,784,2022-05-03_11-02-08,fp7d
2022-04-21,CH,875,822,40,782,2022-05-03_11-02-08,fp7d
2022-04-22,CH,883,831,40,791,2022-05-03_11-02-08,fp7d
2022-04-23,CH,875,821,40,781,2022-05-03_11-02-08,fp7d
2022-04-24,CH,875,819,40,779,2022-05-03_11-02-08,fp7d
2022-04-25,CH,875,823,39,784,2022-05-03_11-02-08,fp7d
2022-04-26,CH,875,824,39,785,2022-05-03_11-02-08,fp7d
2022-04-27,CH,875,826,39,787,2022-05-03_11-02-08,fp7d
2022-04-28,CH,875,829,40,789,2022-05-03_11-02-08,fp7d
2022-04-29,CH,875,829,40,789,2022-05-03_11-02-08,fp7d
2022-04-30,CH,875,825,39,786,2022-05-03_11-02-08,fp7d
2022-05-01,CH,875,824,39,785,2022-05-03_11-02-08,fp7d
2022-05-02,CH,875,829,40,789,2022-05-03_11-02-08,fp7d